,full_text,favorite_count,retweet_count,created_at,user.followers_count,engagement,performance
0,"¡Campeonísimo por siempre!
🇱🇺🇱🇺🇱🇺🇱🇺

1982🏆
1984🏆
1992🏆
2019🏆

#ElMásGrandeDeCa https://t.co/H6AoS2Ipkx",151,38,2019,196452,189,0.1
1,"El dia de ayer recibimos la visita de ""La Academia"" escuela de futbol desde Guatemala visitando el entrenamiento del Campeonísimo. 3️⃣1️⃣🏆 https://t.co/vnN8vdj9bw",152,20,2019,196452,172,0.09
2,"¡Vamos Campeón! 💪😥🏆3️⃣1️⃣

#YoSoyOlimpia 🔴⚪🔵 https://t.co/YbXx8TbH3i",333,35,2019,196452,368,0.19
3,"¡Feliz inicio de semana Campeones! ☝️💪🏆

Les dejamos este Pedro Troglio para que sea una semana cargada de éxitos. 3️⃣1️⃣

#SomosOlimpia 🔴⚪🔵 https://t.co/BBsMXgs1sv",464,49,2019,196452,513,0.26
4,"Hace una semana ⏮️⏮️🏆

¡Campeonisimos! 3️⃣1️⃣🔴⚪🔵 https://t.co/amq6W84INi",484,100,2019,196452,584,0.3
5,"El Campeonísimo no descansa.
🔥💪3️⃣1️⃣ https://t.co/J2WLkURU5V",353,39,2019,196452,392,0.2
6,"Firma de autografos.✍️

Olimpia-Umbro Diunsa Miraflores, Tegucigalpa.3️⃣1️⃣ @umbro

#SomosOlimpia 🔴⚪🔵
#SomosFamilia 👨‍👩‍👧‍👦 https://t.co/8FwcPfCJsY",211,18,2019,196452,229,0.12
7,¡Feliz domingo Campeonísimos! 3️⃣1️⃣🏆 https://t.co/JMaZLcPWZz,843,85,2019,196452,928,0.47
8,"Declaraciones de nuestro DT. Pedro Troglio en donde habla de varios temas, entre ellos su permanencia y la situación del Estadio Nacional de Tegucigalpa.

#SomosOlimpia https://t.co/1m5kRoE0G8",340,51,2019,196452,391,0.2
9,"Carta del presidente de @FIFAcom Gianni Infantino, felicitando al Club Olimpia por la obtención de la 3️⃣1️⃣.

#SomosOlimpia
#SomosFamilia https://t.co/RhvqwUE2MR",639,149,2019,196452,788,0.4
10,"Jose Rafael Ferrari Eterno 🙏

3️⃣1️⃣🏆🦁🎖️🔴⚪🔵 https://t.co/BFAXc56QUe",572,89,2019,196452,661,0.34
11,"¡Olimpista! 🦁 El Campeonísimo mañana estará firmando autografos✍️en Diunsa Miraflores.

3️⃣1️⃣ https://t.co/TKcSLeLqlI",296,37,2019,196452,333,0.17
12,"🏆🏆🏆🏆🏆🏆🏆🏆🏆🏆🏆🏆🏆🏆🏆🏆🏆🏆🏆🏆🏆🏆🏆🏆🏆🏆🏆🏆🏆🏆3️⃣1️⃣

#ElMásGrandeDeCa https://t.co/DkLtzo2Pa8",698,141,2019,196452,839,0.43
13,El brindis de la 31.🥂🍷🍾 https://t.co/qNWJuS7DTU,498,63,2019,196452,561,0.29
14,"1- El Domingo:🎉📷🏆🥇
2- Hoy:😑😥😓😵💪

#SomosOlimpia 3️⃣1️⃣ https://t.co/E7Q7IhOozb",582,57,2019,196452,639,0.33
15,"La galería 📷 del Campeón🏆 encontrala completa en la Web oficial. 3️⃣1️⃣

https://t.co/b3QAzgz84x https://t.co/yE8fl3crsM",382,63,2019,196452,445,0.23
16,Ponele titulo a la postal. ✍️3️⃣1️⃣ https://t.co/rXRHzynXoF,612,44,2019,196452,656,0.33
17,"🎥La historia de la 31🏆 ya esta en el canal de Youtube del Club Olimpia.🦁

Entra y suscribite.🔔

https://t.co/xBrMvm0Hod",310,76,2019,196452,386,0.2
18,"El reconocimiento a Jorge el ""Indio"" Urquia. 9️⃣

Leyenda histórica de nuestro Club.

#SomosOlimpia 🇱🇺3️⃣1️⃣ https://t.co/dOTabNdsmL",527,70,2019,196452,597,0.3
19,"¡Somos Olimpia! 3️⃣1️⃣🇱🇺

@TheChampions https://t.co/7nnKiZk6Rs",605,85,2019,196452,690,0.35
20,"Olimpia enfrentará a Seattle Sounders FC en la próxima edición de la Scotiabank Concacaf Champions League. 💪

#SomosOlimpia #SCCL2020 

¿Qué te parece el rival? https://t.co/6bm6Ne5Ggw",809,160,2019,196452,969,0.49
21,¡La mejor afición de Centroamérica! 3️⃣1️⃣🎉👏🎖️ https://t.co/EDn8wFsLeH,555,92,2019,196452,647,0.33
22,"La Copa volvió a casa. 🏆👏🔴🔵⚪

#SomosOlimpia
#SomosFamilia https://t.co/OPDGmcETDn",1132,223,2019,196452,1355,0.69
23,"¡Buenos dias Campeonisimos!

🏆🏆🏆🏆🏆🏆🏆🏆🏆🏆🏆🏆🏆🏆🏆🏆🏆🏆🏆🏆🏆🏆🏆🏆🏆🏆🏆🏆🏆🏆3️⃣1️⃣

¡Juntos, siempre juntos! 🇱🇺🦁🥇 https://t.co/wjXVVNsH4X",990,172,2019,196452,1162,0.59
24,"....y ahora, ¡a celebrar! 🎉

#bai https://t.co/S9zSrfpLsO",679,100,2019,196452,779,0.4
25,"Unas cuantas imágenes de esta merecida celebración, 🎉 ¡somos CAMPEONES!

🔴🔵⚪ #SomosOlimpia https://t.co/620QohQPhO",679,107,2019,196452,786,0.4
26,👏🏼 ¡Muchas gracias! https://t.co/sjA6pd7DJa,964,81,2019,196452,1045,0.53
27,✌🏼👍🏼 https://t.co/V28lSNPepd,1009,129,2019,196452,1138,0.58
28,¡Campeonisimos! 🏆 https://t.co/bBsLjTLxHd,2169,692,2019,196452,2861,1.46
29,"¡Rey por siempre! 🏆🎖️🥇🏆🎉

#ElMásGrandeDeCa https://t.co/qhR7vEU7wR",1468,386,2019,196452,1854,0.94
30,"!Somos CAMPEONES! 

⚪🔵🔴🏆🎉

#Campeones #SomosOlimpia #ElMásGrandeDeCA https://t.co/QVC5bVoqEQ",1821,761,2019,196452,2582,1.31
31,"¡Finaliza el partido en Tegucigalpa con el gane para Olimpia!🦁

Olimpia 4 - 0 Marathon🦖
Goles de:

Jerry Bengston
Jorge Bengúche
Matías Garrido
Eddie Hernández

#SomosOlimpia 🔴⚪🔵
#LigaSalvaVida https://t.co/VW42INocj2",514,151,2019,196452,665,0.34
32,"⏰89” GOOOOOOOOOOOOL
¡Goooooooooooooooooooool!
 
¡Hernández mete el cuarto para el león!

🦁Olimpia 4 - 0 Marathon🦖

#SomosOlimpia 🔴⚪🔵
#LigaSalvaVida https://t.co/VburT0bmrR",258,61,2019,196452,319,0.16
33,"⏰84” Cambio en el Olimpia:
______
☑ Entra:  E. Hernández
❎Sale:   J. Bengúche
______

#SomosOlimpia 🔴⚪🔵
#LigaSalvaVida https://t.co/XLYpwSnjkd",56,2,2019,196452,58,0.03
34,"⏰76” GOOOOOOOOOOOOL
¡Goooooooooooooooooooool!
 
¡Matías Garrido mete el tercero de penal!

🦁Olimpia 3 - 0 Marathon🦖 https://t.co/FHmA9iVYKL",389,80,2019,196452,469,0.24
35,"⏰74”¡Penal para el Olimpia contra Junior Lacayo!

Tarjeta amarilla para Solani Solano.

🦁Olimpia 2 - 0 Marathon🦖

#SomosOlimpia
#LigaSalvaVida",77,5,2019,196452,82,0.04
36,"¡Termina el primer tiempo en Tegucigalpa!

🦁Olimpia 2 - 0 Marathon🦖

#SomosOlimpia
#LigaSalvaVida https://t.co/dEboh4HEsM",190,19,2019,196452,209,0.11
37,"⏰44” GOOOOOOOOOOOOL
¡Goooooooooooooooooooool!
 
¡El Toro Bengúche mete el segundo!

🦁Olimpia 2 - 0 Marathon🦖

#SomosOlimpia
#LigaSalvaVida https://t.co/rNBIQlMv3G",303,58,2019,196452,361,0.18
38,"⏰31” GOOOOOOOOOOOOL
¡Goooooooooooooooooooool!
 
¡Jerry bengston mete el penal!

🦁Olimpia 1 - 0 Marathon🦖

#SomosOlimpia
#LigaSalvaVida https://t.co/m7YfYuACML",335,79,2019,196452,414,0.21
39,"¡Penaaaal para el Olimpia contra Jerry Bengston!

#SomosOlimpia
#LigaSalvaVida",86,7,2019,196452,93,0.05
40,"🕐Inicia el partido en el Nacional 🏟️:

🦁Olimpia  -  Marathon🦖

#SomosOlimpia
#LigaSalvaVida https://t.co/Hfp0ACOxUH",105,6,2019,196452,111,0.06
41,"Así sale hoy el león🦁 esta tarde ante @CDMarathon

#SomosOlimpia
#LigaSalvaVida https://t.co/RJY9vAnSh2",246,46,2019,196452,292,0.15
42,¡Hoy juega Olimpia! 🇱🇺 https://t.co/DTrVYQdoaz,653,129,2019,196452,782,0.4
43,"📢¡Aficionado Olimpista! 🇱🇺

Tomá nota de todas estas recomendaciones para el juego del dia de mañana.✍️

Olimpia necesita tu apoyo responsable. 👏👏

#OlimpiaResponsable
#SomosFamilia https://t.co/V1UG4pLJY5",365,52,2019,196452,417,0.21
44,"Este equipo tiene historia, ...y este domingo queremos seguir construyéndola.

Apoyemos al león en esta fiesta tricolor. 🔴⚪🔵

#HastaElÚltimoMinuto https://t.co/Z8ysPzmq4J",1586,586,2019,196452,2172,1.11
45,"El reconocimiento al 9️⃣ original. 

Domingo 3:00 pm todos temprano para reconocer la carrera de una de las leyendas mas grandes de nuestra historia... Jorge ""Indio"" Urquia.🇱🇺 

#SomosOlimpia
#ElMásGrandeDeCa https://t.co/RkA5e8kaWZ",276,39,2019,196452,315,0.16
46,"¡De blanco sagrado! ⚪⚪⚪⚪⚪

¡La mejor afición de Centroamérica! 👋

#SomosOlimpia 🇱🇺 https://t.co/jx7xq2h7Cq",578,106,2019,196452,684,0.35
47,"¡Las Leonas🦁 juegan el clásico esta noche! 🥇
🇳🇱🇳🇱🇳🇱🇳🇱

¡Apoyemos al fútbol femenino! 

💵 25 Lps
🏟Estadio Birichiche 
🗓️6/12/19
⏲6:00 pm
🏆Liga Mayor de Fútbol Femenino https://t.co/K5MjkXCleQ",111,12,2019,196452,123,0.06
48,"¡Falta menos! 💪💪

¡Vamos Olimpia! 🇱🇺🇱🇺 https://t.co/qs67DXmm7B",214,25,2019,196452,239,0.12
49,"🎵Vamos mi león, queremos la copa🎵

No te quedes sin tu entrada 🎫 para el domingo y se parte de la fiesta tricolor. 🔴⚪🔵

#HastaElÚltimoMinuto https://t.co/vB8uHST1ZX https://t.co/Wy7BDAltUj",395,69,2019,196452,464,0.24
50,"¡Silla agotado! 👋👋

Adquirí tu boleto lo más pronto en cualquier punto Tengo a nivel nacional y se parte de la fiesta del más popular.🇱🇺🇱🇺🇱🇺🇱🇺

#SomosOlimpia https://t.co/ClLiDrip9O",270,36,2019,196452,306,0.16
51,"¡Sombra Sur agotado! 👋👋

Adquirí tu boleto lo más pronto en cualquier punto Tengo a nivel nacional y se parte de la fiesta del más popular.,, 🇱🇺🇱🇺🇱🇺🇱🇺

#SomosOlimpia https://t.co/Zlp0O0ntXK",348,57,2019,196452,405,0.21
52,¡Goleador! 🔝🦁⚽ https://t.co/ozPRmW8vKx,475,60,2019,196452,535,0.27
53,"¡Por la 31! 🇳🇱🇳🇱🇳🇱🇳🇱

💵Sol L.80 | Sombra L.150 | Silla L.300 | 
🏟Estadio Nacional
🗓️8/12/19
⏲4:00 pm
🏆Liga SalvaVida

Boletos en todos los puntos Tengo.

Niños menores de 12 años entran gratis a sector de Sol acompañados de un adulto. https://t.co/ERLhC5ES2Q",525,111,2019,196452,636,0.32
54,"Cerca... Mas cerca 🇱🇺

¡Vamos Olimpia!

#HastaElÚltimoMinuto https://t.co/3YV0EgTa0j",996,173,2019,196452,1169,0.6
55,"Finaliza el partido. Importante paso en el Nacional. Olimpia derrotó 3-0 a los Lobos de la UPNFM.

🔴🔵⚪ #SomosOlimpia https://t.co/j4VQl2YU9L",360,73,2019,196452,433,0.22
56,"Tercer cambio en Olimpia 🔄 a los 71 minutos:

Sale:Cristhian Maidana 
Entra: Matías Garrido

#SomosOlimpia",40,0,2019,196452,40,0.02
57,"Segundo cambio en Olimpia 🔄 a los 65 minutos:

Sale:Germán Mejia
Entra: Maylor Núñez

#SomosOlimpia",42,1,2019,196452,43,0.02
58,"🕛Inicia el segundo tiempo en el Nacional. 🏟️

Lobos Upn 0 🐶 - Olimpia 3 🦁

#SomosOlimpia
#LigaSalvaVida",65,5,2019,196452,70,0.04
59,"Medio tiempo en el Nacional 🕘

Lobos Upn 🐶 0 - Olimpia 3 🦁

Jerry Bengtson ⚽
Bryan Beckeles⚽
Jorge Bengúche ⚽

#SomosOlimpia 🔴⚪🔵
#LigaSalvaVida https://t.co/IJJq6M4f7K",48,5,2019,196452,53,0.03
60,"Goooooooooooooooool
Goooooooooooooooool

Jorge Bengúche a los 34' ⚽

Lobos Upn 🐶 0 - Olimpia 3

#SomosOlimpia
#LigaSalvaVida https://t.co/ZiKm4Cpin8",215,31,2019,196452,246,0.13
61,"Cambio en Olimpia 🔄 a los 32' minutos:

Sale:Jhonny Leveron
Entra: Jonathan Paz",47,4,2019,196452,51,0.03
62,"Goooooooooooooooooool
Goooooooooooooooooool

Bryan Beckeles a los 23' minutos ⚽

Lobos Upn 0 🐶 - Olimpia 2 🇱🇺

#SomosOlimpia
#LigaSalvaVida https://t.co/tp51J3wt4d",178,27,2019,196452,205,0.1
63,"Gooooooooooooool
Gooooooooooooool

Jerry Bengtson a los 10' minutos ⚽

Lobos Upn 0 - Olimpia 1 https://t.co/DMYhFN4uNN",266,38,2019,196452,304,0.15
64,"🕛¡Inicia el partido en el Nacional!

Lobos Upn 🐶 - Olimpia 🇱🇺

#SomosOlimpia
#LigaSalvaVida https://t.co/pPQyovzDlk",59,9,2019,196452,68,0.03
65,"Así sale el León🦁 esta noche ante @LobosUpnfm :

#SomosOlimpia
#LigaSalvaVida https://t.co/pT3uGWxcxU",134,28,2019,196452,162,0.08
66,Comunicado Club Olimpia Deportivo. https://t.co/JdJAz2kHWn,415,132,2019,196452,547,0.28
67,¡Hasta el último minuto! 🔴⚪🔵 https://t.co/Aa7Vts2E5k,656,120,2019,196452,776,0.4
68,¡Hoy juega Olimpia! 🇱🇺 https://t.co/dRVXdXCKUg,491,68,2019,196452,559,0.28
69,Un hermoso atardecer con estos colores. 🇱🇺 https://t.co/8npAenIDn0,573,81,2019,196452,654,0.33
70,"Por un mundo sin barreras y más inclusivo para todos 🙌

🔴⚪🔵 ¡Juntos, siempre juntos!

 #SomosOlimpia https://t.co/Rv1DRZGG8W",329,57,2019,196452,386,0.2
71,"¡El León por el liderato de la Pentagonal! 🇳🇱🇳🇱🇳🇱🇳🇱

🏟Estadio Nacional
🗓️04/12/19
⏲7:00 pm
🏆Liga SalvaVida
🐶 @LobosUpnfm

¡Juntos, siempre juntos!

#SomosOlimpia https://t.co/IgrqleRoeH",284,39,2019,196452,323,0.16
72,"La galería del Superclásico 📷

¡Juntos, siempre juntos!
🔴⚪🔵🔴⚪🔵🔴⚪🔵 https://t.co/QVHqo63hWj",255,23,2019,196452,278,0.14
73,"¡Las Leonas continúan su paso arrollador! 👋👋

Lideres e invictas 🔴⚪🔵

Yendy Martinez ⚽⚽⚽
Yeimy Estrada ⚽
Noelia Hernandez ⚽

#OlimpiaDeCorazón https://t.co/gFodhLop5D",129,10,2019,196452,139,0.07
74,"Conferencia de prensa Prof. Pedro Troglio 🎙️

#SomosOlimpia https://t.co/pS1D1Jl5HQ",474,58,2019,196452,532,0.27
75,Comunicado Club Olimpia Deportivo https://t.co/l8pl9G8JjL,162,17,2019,196452,179,0.09
76,En este perfil nos gustan los Tweets de ⬇️⬇️⬇️⬇️⬇️ https://t.co/CbOfWkC3LD,378,33,2019,196452,411,0.21
77,"Olimpia 0501🇱🇺
*3 Superclasicos consecutivos. 
*7 triunfos (3 Liga Concacaf, 3 vueltas, 1 Pentagonal) consecutivos en el Metropolitano. 

#SomosOlimpia https://t.co/ISrJmenYK4",802,150,2019,196452,952,0.48
78,"Finalizan los 90 minutos en San Pedro Sula.

¡Nos vamos con la victoria en el clásico! 

🦁Olimpia 2 - 0 Motagua 🦅

#SomosOlimpia
#LigaSalvaVida https://t.co/zQDNzh6J5W",668,182,2019,196452,850,0.43
79,"⏰3 minutos adicionales dicta el arbitro. 

#SomosOlimpia
#LigaSalvaVida",42,1,2019,196452,43,0.02
80,"⏰83” Cambio en el Olimpia:
________________
☑️ Entra:  J. Lacayo 
❎Sale:   E. Rodriguez
__________________

#SomosOlimpia 🔴⚪🔵
#LigaSalvaVida https://t.co/eB4VStqgxI",26,0,2019,196452,26,0.01
81,"⏰76” Cambio en el Olimpia:

☑️ Entra:  M. Garrido
❎Sale:   C. Maidana

#SomosOlimpia 🔴⚪🔵
#LigaSalvaVida https://t.co/y8qaQ7ktNe",37,1,2019,196452,38,0.02
82,"⏰63” Cambio en el Olimpia:

☑️ Entra:  M. Nuñez 
❎Sale:   G. Mejía 

#SomosOlimpia 🔴⚪🔵
#LigaSalvaVida https://t.co/HoU374HPlz",31,1,2019,196452,32,0.02
83,"⏰52” GOOOOOOOOOOOOOOL
¡Goooooooooooooooooooool!
 Jerry bengston a los  52' minutos
🦁Olimpia  2 - 0 Motagua 🦅

#SomosOlimpia
#LigaSalvaVida https://t.co/xW8c2sz3B2",239,28,2019,196452,267,0.14
84,"⏰52” GOOOOOOOOOOOOOOL
¡Goooooooooooooooooooool!
 Jerry bengston a los  52' minutos
🦁Olimpia  2 - 0 Motagua 🦅

#SomosOlimpia
#LigaSalvaVida https://t.co/W1kJPozjgo",102,19,2019,196452,121,0.06
85,"Arranca el segundo tiempo ⏳ en el Olímpico de San Pedro Sula.

🦁Olimpia 1 - 0 Motagua 🦅",77,7,2019,196452,84,0.04
86,"Termina el primer tiempo en San Pedro Sula.

¡Vamos león!

🦁Olimpia 1 - 0 Motagua 🦅

#SomosOlimpia https://t.co/Fghxf0y1FB",116,14,2019,196452,130,0.07
87,"⏰3” GOOOOOOOOOOOOOOL
¡Goooooooooooooooooooool!
 Jorge Benguche a los 3' minutos
🦁Olimpia  1 - 0 Motagua 🦅

#SomosOlimpia
#LigaSalvaVida https://t.co/T4AZkfGiJf",420,67,2019,196452,487,0.25
88,"🕐Inicia el partido en el Olímpico 🏟️:

🦁Olimpia  -  Motagua🦅

#SomosOlimpia
#LigaSalvaVida https://t.co/DJ0ZyOVfiQ",71,7,2019,196452,78,0.04
89,¡Vamos Olimpistas! ¡Los necesitamos a todos hoy en el Olímpico! ¡Pintemos tricolor el Metropolitano!! #SomosOlimpia #SomosFamilia #SuperClasico ⚪🔵🔴 https://t.co/wTSmVfj13c,267,28,2019,196452,295,0.15
90,Rivales en la cancha... No enemigos... ¡Vamos Olimpia! 🔴🔵⚪ #SomosOlimpia #SuperClasico https://t.co/4PLL9g6Ajk,312,30,2019,196452,342,0.17
91,"¡Movete.. Olimpista... Movete!
¿Ya tenes tus boletos para el SuperClasico?
¡Recarga tu Billetera Móvil en los puntos autorizados y acompañemos al Leon hoy!
Sol L. 100.00
Preferencia L. 200.00
Silla L. 300.00
Palcos L. 500.00 https://t.co/skRbqz2NZH",91,12,2019,196452,103,0.05
92,"¡El León ya descansa en San Pedro Sula! 💪🎉

Levanten la mano 🙌 quienes al estadio mañana 🏟️

¡Vamos Olimpia! 🇱🇺🇱🇺🇱🇺🇱🇺

#SomosOlimpia https://t.co/WCZLao62e5",518,50,2019,196452,568,0.29
93,"📷 Junior Lacayo en el entrenamiento previo al Superclásico.

#SomosOlimpia https://t.co/vpatQS6962",186,9,2019,196452,195,0.1
94,"La Sub11 de las FBO viajan hacia Colombia 🇨🇴 el próximo sábado a jugar la Copa Internacional ""Ciudad de Cali Hero 2019""🏆

Nuestras reservas jugarán contra los principales Clubes y academias del continente. 💪👋

¡Buen viaje y éxitos a las FBO!
🔴⚪🔵

https://t.co/9TIPupSQn0",160,23,2019,196452,183,0.09
95,"¡Hola San Pedro! 👋

Ponete mas hermosa que el más popular llega el sábado. 🇱🇺💪

#SomosOlimpia https://t.co/IqXyoB5u81",714,107,2019,196452,821,0.42
96,"¡Solo afición local! 🇳🇱🇳🇱🇳🇱🇳🇱

💵Sol L.100 | Sombra L.200 | Silla L.300 | Palco este L.500 | Palco oeste L.500
🏟Estadio Olímpico Metropolitano
🗓️30/11/19
⏲5:00 pm
🏆Liga SalvaVida

Boletos en todos los puntos Tengo.

Niños menores de 12 años entran gratis a sector de Sol. https://t.co/xKQRB0Qtw1",297,67,2019,196452,364,0.19
97,"Con el optimismo a tope 🔝

¡Vamos Olimpia! 🇳🇱

#SomosOlimpia https://t.co/WWpWgSqhDE",452,55,2019,196452,507,0.26
98,Comunicado oficial. Club Olimpia Deportivo. https://t.co/Y7OtwDO460,256,57,2019,196452,313,0.16
99,"A los medios de comunicación se les informa que la plataforma para acreditación ya está disponible en la Web oficial del Club.

La asignación de las credenciales solicitadas queda sujeta a aprobación del Departamento de Marketing y Comunicación.

https://t.co/uQ4vN6xa81 https://t.co/PVdkWmppBh",67,4,2019,196452,71,0.04
100,Comunicado Club Olimpia Deportivo https://t.co/0ReTZKNV2a,305,67,2019,196452,372,0.19
101,"Las FBO se coronaron campeones  del torneo categoría Sub12 Liga ""Jorge Andrade"". 🏆🥇🇱🇺

FBO 2 - Conapid 1

¡Felicidades Campeones! 
, 🔴⚪🔵🔴⚪🔵🔴⚪🔵🔴⚪🔵

#SomosOlimpia
#LaReserva
#OlimpiaDeCorazón https://t.co/xzbPvy1ybr",170,13,2019,196452,183,0.09
102,"El Club Olimpia Deportivo felicita a @CDMarathon por sus 94 años de fundación. 🎉9️⃣4️⃣

#ClásicoNacional
#FútbolEnPaz https://t.co/KBuAFcI5NN",645,81,2019,196452,726,0.37
103,"Creemos en ustedes siempre 🙏💪

#SomosOlimpia
#SomosFamilia
#OlimpiaPositivo https://t.co/NHdj6NnFrR",498,63,2019,196452,561,0.29
104,"Finaliza el partido en La Ceiba. Perdimos el primer partido de la Pentagonal.

Vida 2-1 Olimpia

#SomosOlimpia https://t.co/bQinVUHhea",157,35,2019,196452,192,0.1
105,"Goooooooooooooooooooooooool
Goooooooooooooooooooooooool

German Mejia a los 80 minutos

Vida 🇦🇹 2- Olimpia 🇱🇺 1

#SomosOlimpia https://t.co/g8UUiXryek",151,14,2019,196452,165,0.08
106,"🕐77 minutos del segundo tiempo :

Vida 🇦🇹 2 - Olimpia 🇱🇺 0 

#SomosOlimpia",22,0,2019,196452,22,0.01
107,"Segundo cambio en Olimpia a los 70 minutos:

Sale: Edwin Rodriguez
Entra: Eddie Hernandez https://t.co/hm9e6Kw2R8",18,0,2019,196452,18,0.01
108,"Primer cambio en  Olimpia a los 59:

sale :Jorge Alvarez
Entra: Elmer Guity",19,1,2019,196452,20,0.01
109,"Gol del Vida a los 49 minutos.

Vida 🇦🇹 2- Olimpia 🇱🇺 0 

#SomosOlimpia",41,4,2019,196452,45,0.02
110,"🕐Arranca el segundo tiempo en el Ceibeño:

Vida 🇦🇹 1 - Olimpia 🇱🇺 0 

#SomosOlimpia",13,1,2019,196452,14,0.01
111,"🕐Finaliza el primer tiempo en el Ceibeño:

Vida 🇦🇹 1 - Olimpia 🇱🇺 0 

#SomosOlimpia https://t.co/PtwPLI9ZNn",28,2,2019,196452,30,0.02
112,"🕐36 minutos del primer tiempo :

Vida 🇦🇹 1 - Olimpia 🇱🇺 0 

#SomosOlimpia",15,0,2019,196452,15,0.01
113,"Gol del Vida a los 21 minutos del primer tiempo :

Vida 🇦🇹 1 - Olimpia 🇱🇺 0 

#SomosOlimpia",46,3,2019,196452,49,0.02
114,"🕐15 minutos del primer tiempo :

Vida 🇦🇹 0 - Olimpia 🇱🇺 0 

#SomosOlimpia",13,0,2019,196452,13,0.01
115,"🕐 10 minutos del primer tiempo :

Vida 🇦🇹 0 - Olimpia 🇱🇺 0 

#SomosOlimpia",13,0,2019,196452,13,0.01
116,"🕐5 minutos del primer tiempo :

Vida 🇦🇹 0 - Olimpia 🇱🇺 0 

#SomosOlimpia",19,0,2019,196452,19,0.01
117,"🕐Inicia el partido en el Ceibeño 🏟️:

Vida 🇦🇹 0 - Olimpia 🇱🇺 0 

#SomosOlimpia https://t.co/e1sMxaGnRl",67,10,2019,196452,77,0.04
118,"Así sale el 🦁 esta noche ante el @cdsvida 🥥🏝️

#SomosOlimpia https://t.co/1YZvTMMYpw",217,51,2019,196452,268,0.14
119,"¡Juntos, siempre juntos!
🔴⚪🔵🔴⚪🔵🔴⚪🔵 https://t.co/vTYBJ0PUaa",752,141,2019,196452,893,0.45
120,¡Hoy juega Olimpia! 🇱🇺 https://t.co/Lqs58iruTy,362,54,2019,196452,416,0.21
121,"En el día de la música nos acordamos de los que cantan mejor. 🎵🎶🎤

#DiadelaMusica
#DiaDelMusico
#SomosOlimpia https://t.co/KdGm2Kfoss",276,42,2019,196452,318,0.16
122,Declaraciones Prof. Pedro Troglio (2) previo a primer juego del Pentagonal Vrs @cdsvida. 🎥🎙️🇱🇺🇦🇹 https://t.co/qDOLC5tfSB,125,22,2019,196452,147,0.07
123,Declaraciones Prof. Pedro Troglio previo a primer juego del Pentagonal Vrs @cdsvida. 🎥🎙️ https://t.co/qNeo7nKHZ7,264,33,2019,196452,297,0.15
124,"¡Arranca la Pentagonal! 🎉🎉

🏟 Estadio Ceibeño
🗓️ 23/11/19
⏲ 7:15 pm
📺 Canal 11
🏆Liga SalvaVida

🇳🇱🇳🇱🇳🇱🇳🇱🇳🇱🇳🇱🇳🇱 https://t.co/romzoUU5Rk",280,43,2019,196452,323,0.16
125,🔴⚪🔵🥇 https://t.co/gJCjiNMx8I,169,14,2019,196452,183,0.09
126,"En este perfil tenemos el récord de puntos.

#SomosOlimpia 🇱🇺 https://t.co/bIUFzHxeGW",1071,172,2019,196452,1243,0.63
127,"¡Felicidades a todo el Olimpismo en cada rincón del mundo! 🎉🌍

¡El más Superlíder de la historia de los torneos cortos! 💪

Este es el Olimpia de Pedro Troglio... El Olimpia de los 44 puntos. 4️⃣4️⃣

🇱🇺🇱🇺🇱🇺🇱🇺🇱🇺🇱🇺🇱🇺🇱🇺🇱🇺🇱🇺 https://t.co/VBVdgIBAv4",1048,250,2019,196452,1298,0.66
128,"🕛¡Final del partido en el Ceibeño!

Vida 2 - 3 Olimpia 

Jonathan Ferrari (16)
Bryan Beckeles (20)
Jorge Bengúche (57)

#SomosOlimpia 🔴⚪🔵
#LigaSalvaVida https://t.co/0IZlSClyFJ",223,50,2019,196452,273,0.14
129,"⏰91”  Segundo gol del vida.

Vida 2 - 3 Olimpia

#SomosOlimpia 🔴⚪🔵
#LigaSalvaVida",31,2,2019,196452,33,0.02
130,"⏰75” Cambio en el Olimpia:

✔ Entra:    Jafeth Canales
❎Sale:   Elmer Güity

#SomosOlimpia 🔴⚪🔵
#LigaSalvaVida https://t.co/TL16aBQMvC",24,3,2019,196452,27,0.01
131,"⏰75”Gol del vida.

Vida 1 - 3 Olimpia",18,0,2019,196452,18,0.01
132,"⏰68” Cambio en el Olimpia:

✔ Entra:    A. Reyes
❎Sale:   J. Lacayo

#SomosOlimpia 🔴⚪🔵
#LigaSalvaVida https://t.co/OKtEKagePH",34,1,2019,196452,35,0.02
133,"⏰60” Cambio en el Olimpia:

✔ Entra:   7  O. Lanza
❎Sale:  9 J. Bengúche

#SomosOlimpia 🔴⚪🔵
#LigaSalvaVida https://t.co/K7aDlQbp5B",28,0,2019,196452,28,0.01
134,"Goooooooooooooooooool
Goooooooooooooooooool

Jorge Bengúche a los 57’ minutos 

Vida 0 - 3 Olimpia 

#SomosOlimpia 🔴⚪🔵
#LigaSalvaVida https://t.co/q1Qfr6thDU",147,14,2019,196452,161,0.08
135,"¡Arranca el segundo tiempo en Ceiba!

#SomosOlimpia
#LigaSalvaVida",40,1,2019,196452,41,0.02
136,"🕛¡Final del primer tiempo en el Ceibeño!

Vida 0 - Olimpia 2

Jonathan Ferrari (16)
Bryan Beckeles (20)

#SomosOlimpia 🔴⚪🔵
#LigaSalvaVida https://t.co/Hk4I3h2dyS",69,8,2019,196452,77,0.04
137,"Goooooooooooooooooool
Goooooooooooooooooool

Bryan Beckeles a los 20' minutos

Vida 0 - Olimpia 2

#SomosOlimpia 🔴⚪🔵
#LigaSalvaVida https://t.co/57Sg4gV9q2",284,34,2019,196452,318,0.16
138,"Gooooooooooooooool
Gooooooooooooooool

Jonathan Ferrari a los 16' minutos!

Vida 0 - Olimpia 1 

#SomosOlimpia 🔴⚪🔵
#LigaSalvaVida https://t.co/AZpFbs82BX",142,17,2019,196452,159,0.08
139,"🕛 15 minutos del primer tiempo 

Vida 0 - Olimpia 0

#SomosOlimpia 🔴⚪🔵
#LigaSalvaVida",20,1,2019,196452,21,0.01
140,"🕛¡Arranca el partido en el Ceibeño!

Vida 0 - Olimpia 0

#SomosOlimpia 🔴⚪🔵
#LigaSalvaVida https://t.co/l7xU0X9IrK",52,6,2019,196452,58,0.03
141,"Así sale el Superlider esta noche en el Municipal Ceibeño🏟️:

#SomosOlimpia
#LigaSalvaVida https://t.co/glchjxXSZ8",232,34,2019,196452,266,0.14
142,¡Hoy juega Olimpia! 🇱🇺 https://t.co/ibCsg8OelV,391,58,2019,196452,449,0.23
143,"Declaraciones Prof. Pedro Troglio previo al juego Vrs @cdsvida 🎥🎙️

#LigaSalvaVida https://t.co/iVewIQfBAD",228,31,2019,196452,259,0.13
144,"¡Tan felices como el Profe @pjmsports!

#SomosOlimpia
#SomosAlegria https://t.co/7EUYIurs5d",251,18,2019,196452,269,0.14
145,"¡El Superlíder motivado! 🕺🕺

El León ya va en camino hacia La Ceiba. ⛱️🌞

#SomosOlimpia 🔴⚪🔵 https://t.co/jRgdi1TD2n",398,39,2019,196452,437,0.22
146,"¿Cruzas los dedos 🤞 para que tu crush comente tus fotos así como @carlocostly31 los cruza para que no anote el superlider?  😍🤳🏼

🔴⚪🔵🔴⚪🔵🔴⚪🔵 https://t.co/yt4Ei3cQXY",617,103,2019,196452,720,0.37
147,"¡ Gritalo siempre como Jerry Ricardo! 🥒🥒🥒🥒🥒🥒

¡ Juntos,siempre juntos! 🇱🇺🇱🇺🇱🇺🇱🇺

#SomosOlimpia https://t.co/SH4IBhUzMd",199,15,2019,196452,214,0.11
148,"¿Cuál celebración 🎉 de Bengu te gusta más? ⚽

🐂😁🤪🕺🙏 https://t.co/8c9cHhUwkU",230,9,2019,196452,239,0.12
149,"¡El Superlíder llega a la Novia de Honduras!

🏟 Estadio Ceibeño
🗓️ 20/11/19
⏲ 7:00 pm
📺 Canal 11
🏆Liga SalvaVida

🇳🇱🇳🇱🇳🇱🇳🇱🇳🇱🇳🇱🇳🇱 https://t.co/7HF38mujXG",342,56,2019,196452,398,0.2
150,"Cuando te das cuenta que Olimpia no juega este fin de semana. 😢🌧️☔

#SomosOlimpia
🔴⚪🔵 https://t.co/iXXl4PYGRr",414,50,2019,196452,464,0.24
151,"¡Olimpista! Ya podes encontrar los Stories Stickes del León 🦁 en Instagram. 🤳☝️

Buscalas como ""Olimpia Honduras"" y disfruta de las herramientas que el Social Media del Club Olimpia te ofrece.

#SomosOlimpia 🔴⚪🔵 https://t.co/1O1m9DYdoJ",277,44,2019,196452,321,0.16
152,"👇🏿👇🏿👇🏿👇🏿👇🏿👇🏿👇🏿👇🏿👇🏿👇🏿👇🏿👇🏿
👉🏿👇🏾👇🏾👇🏾👇🏾👇🏾👇🏾👇🏾👇🏾👇🏾👈🏿👈🏿
👉🏿👉🏾👇🏽👇🏽👇🏽👇🏽👇🏽👇🏽👇🏽👈🏾👈🏿👈🏿
👉🏿👉🏾👉🏽👇🏼👇🏼👇🏼👇🏼👇🏼👈🏽👈🏾👈🏿👈🏿
👉🏿👉🏾👉🏽👉🏼👇🏻👇🏻👇🏻👈🏼👈🏽👈🏾👈🏿👈🏿
👉🏿👉🏾👉🏽👉🏼🏆🏆🏆🏆👈🏼👈🏽👈🏾👈🏿
👉🏿👉🏾👉🏽👉🏼👆🏻👆🏻👆🏻👈🏼👈🏽👈🏾👈🏿👈🏿
👉🏿👉🏾👉🏽👆🏼👆🏼👆🏼👆🏼👆🏼👈🏽👈🏾👈🏿👈🏿
👉🏿👉🏾👆🏽👆🏽👆🏽👆🏽👆🏽👆🏽👆🏽👈🏾👈🏿👈🏿
👉🏿👆🏾👆🏾👆🏾👆🏾👆🏾👆🏾👆🏾👆🏾👆🏾👈🏿👈🏿
👆🏿👆🏿👆🏿👆🏿👆🏿👆🏿👆🏿👆🏿👆🏿👆🏿👆🏿👆🏿",1052,193,2019,196452,1245,0.63
153,El capitán del barco 🔴⚪🔵 https://t.co/mVsxqxcPPL,743,61,2019,196452,804,0.41
154,"¡Juntos, siempre juntos!

🔴⚪🔵🔴⚪🔵🔴⚪🔵

#SomosOlimpia
#SomosFamilia
#CopaPremierCA https://t.co/uxW1risJLQ",250,21,2019,196452,271,0.14
155,"¡Termina el partido en el Nacional de Tegucigalpa y nos vamos con el gane!

#SomosOlimpia
#CopaPremier
@CopaPremierCA https://t.co/BPqaMiX8Rf",292,53,2019,196452,345,0.18
156,"⏰89” Cambio en el Olimpia:
______________________
✅ Entra:   7   O. Lanza
❎Sale:  30   E. Hernández
_______________________

#SomosOlimpia
#CopaPremier https://t.co/T9GgxwWQzk",14,2,2019,196452,16,0.01
157,"⏰70” Cambio en el Olimpia:
______________________
✅ Entra:   19 J. Rochez
❎Sale:  27   J. Bengston
_______________________

#SomosOlimpia
#CopaPremier https://t.co/kNvDYxStWI",11,0,2019,196452,11,0.01
158,"⏰67” Cambio en el Olimpia:

✔ Entra:   24  R. Flores
❎Sale:  14    J. Lacayo

#SomosOlimpia
#CopaPremier https://t.co/1klE5Iwyzm",18,0,2019,196452,18,0.01
159,"⏰58” Olimpia cerca del segundo  gol con un pase de Bengston para Lacayo pero se la rechaza el arquero.

🇳🇱Olimpia  1 - 0 Alianza

#SomosOlimpia
#CopaPremier
@CopaPremierCA",20,0,2019,196452,20,0.01
160,"⏰55” Cambio en el Olimpia:

❎Sale:  12. C. Maidana
✔ Entra:   8  A. Reyes

#SomosOlimpia
#CopaPremier https://t.co/H2ncxy0jfH",18,1,2019,196452,19,0.01
161,"Arranca el 2 tiempo en Tegucigalpa.

🇳🇱Olimpia  1 - 0 Alianza

#SomosOlimpia
#CopaPremier
@CopaPremierCA",50,3,2019,196452,53,0.03
162,"¡Nos vamos al descanso arriba en el marcador!

🇳🇱Olimpia  1 - 0 Alianza

#SomosOlimpia
#CopaPremier
@CopaPremierCA https://t.co/z1JHXT75uB",85,19,2019,196452,104,0.05
163,"⏰43” GOOOOOOOOOOOL
¡Goooooooooooooooooooool!

¡Eddy Hernánde anota el primero en el Nacional!

🇳🇱Olimpia  1 - 0 Alianza

#SomosOlimpia
#CopaPremier
@CopaPremierCA https://t.co/pwwfy2zq7m",126,25,2019,196452,151,0.08
164,"¡Inicia el partido en el Nacional!

Olimpia 0 - Alianza 0

@CopaPremierCA

#SomosOlimpia https://t.co/2J1wUWFyCy",48,8,2019,196452,56,0.03
165,"Así sale el León esta noche:

Edrick Menjivar, Maylor Núñez,Elvin Casildo, Jhonny Leveron , Axel Gomez, Bryan Beckeles, Matías Garrido, Cristian Maidana,Junior Lacayo, Jerry Bengtson, Eddie Hernández.

#SomosOlimpia https://t.co/AYmn8eqjOu",155,24,2019,196452,179,0.09
166,"¡Hoy hay que ganar!🎉🏆

🔴⚪🔵 https://t.co/Tcj1H7AzJe",429,53,2019,196452,482,0.25
167,¡Hoy juega Olimpia! 🇳🇱🦁 https://t.co/sqZr8XBfYr,396,56,2019,196452,452,0.23
168,"¡Olimpia premia tu fidelidad! 🎉

El domingo pasado sorteamos pases de Sombra Sur para asistir al Olimpia Vrs @AlianzaFC_sv 🎫🎫 por Copa Premier.

Los ganadores reclamar su ticket en punto Tengo de Mall Multiplaza Tegucigalpa con su respectiva identificación.

#SomosOlimpia 🇳🇱 https://t.co/x1ZI4ucKbr",115,13,2019,196452,128,0.07
169,"No somos 11 dentro de la cancha.. Somos MILLONES.El más laureado, el más amado, somos locales en todos lados.
Ser Olimpia no se hace, se nace.
Nuestra afición nos hace Grandes! #ElMasGrandeDeCA
¡Nos vemos el miércoles en el Naciónal! Juntos...¡Siempre Juntos! 🔴🔵⚪ #SomosOlimpia https://t.co/rxMCFhRpc2",422,59,2019,196452,481,0.24
170,"¡El más popular! ⬆️⬆️⬆️⬆️⬆️

#SomosOlimpia 🇳🇱 https://t.co/CQrdCulUPV",846,199,2019,196452,1045,0.53
171,"El Nacional vuelve a recibir torneos internacionales.🏆

💵 Sol L.70 | Sombra L.150 | Silla 300 L.| 
🏟 Estadio Nacional
🗓️ 13/11/19
⏲ 6:00 pm
📺 Tigo Sport
🏆Copa Premier 

Boletos en puntos Tengo.

Niños menores de 12 años entran gratis a sector de Sol.

🇳🇱🇳🇱🇳🇱🇳🇱🇳🇱🇳🇱🇳🇱 https://t.co/S6GQ5uLxUx",302,58,2019,196452,360,0.18
172,"Palabras del DT Pedro Troglio después del partido donde Olimpia derrotó 1-0 al Marathón. 

#SomosOlimpia https://t.co/hMmvtzYIJJ",444,77,2019,196452,521,0.27
173,"Olimpia te invita a que seas parte de este gran movimiento ""Que cada partido nos una"" plasmando tu firma de manera electronica para formar el balon conmemorativo por un futbol en paz. 

https://t.co/7gdFo2iWZx https://t.co/pxbQc90x9y",146,24,2019,196452,170,0.09
174,"¡Gracias a la mejor afición! 🙏🙌

#SomosFamilia https://t.co/sT2XDLQPAl",504,67,2019,196452,571,0.29
175,"¡Buenas noches Olimpistas! 🌜💤

¡Juntos, siempre juntos! 🔴⚪🔵

#SomosOlimpia
#SomosFamilia https://t.co/M2UeEuPBUU",441,70,2019,196452,511,0.26
176,"Resumen medico: El Club Olimpia Deportivo mediante el Doctor Elmer López informa que el jugador Germán Mejía sufrio una contusión al nivel de la tibia por lo cual se descarta fractura.
El tiempo de recuperación estipulado es de dos semanas. https://t.co/ftARKoSvRM",412,72,2019,196452,484,0.25
177,"¡Saluden al líder! 🥇

🔴⚪🔵 https://t.co/sv8Heb6M0O",1642,403,2019,196452,2045,1.04
178,"¡Nos vamos CAMPEONES DE LAS VUELTAS desde Tegucigalpa!

🦁Olimpia  1 - 0 Marathon 🦖
Gol de: Jerry Bengston

#SomosOlimpia
#LigaSalvaVida https://t.co/qZdyjk2fDa",619,154,2019,196452,773,0.39
179,"⏰98” 🛑 Tarjeta roja para Carlos Costly.

🦁Olimpia  1 - 0 Marathon 🦖",78,6,2019,196452,84,0.04
180,"⏰95” Cambio en el Olimpia:

❎Sale:  15 E. Rodríguez
✔ Entra:   10 M. Garrido

Se agregan 2 minutos más al descuento. https://t.co/RatUxzPcyV",28,1,2019,196452,29,0.01
181,"⏰91” Cambio en el Olimpia:

❎Sale:  27 J. Bengston
✔ Entra:   30 E. Hernández

Se agregan 5 minutos al descuento.

#SomosOlimpia
#LigaSalvaVida https://t.co/G93QxMdM8r",23,0,2019,196452,23,0.01
182,⏰77” 🔶 Tarjeta amarilla para Carlitos Pineda.,21,0,2019,196452,21,0.01
183,"⏰71” GOOOOOOOOOOOOOOL
¡Goooooooooooooooooooool!

Jerry Bengston mete el primero

🦁Olimpia  1 - 0 Marathon 🦖

#SomosOlimpia
#LigaSalvaVida https://t.co/A1FjoeqzQu",452,84,2019,196452,536,0.27
184,"⏰66” 🔶 Tarjeta amarilla para German Mejía.

#SomosOlimpia
#LigaSalvaVida",21,0,2019,196452,21,0.01
185,"⏰58”¡¡Chaco Maidana cerca de meter el primeroo!!

🦁Olimpia  0 - 0 Marathon 🦖",40,0,2019,196452,40,0.02
186,"¡Arranca el 2 tiempo en Tegucigalpa!

🦁Olimpia  0 - 0 Marathon 🦖

#SomosOlimpia
#LigaSalvaVida",29,0,2019,196452,29,0.01
187,"Nos vamos al descanso empatando en casa.

🦁Olimpia  0 - 0 Marathon 🦖

#SomosOlimpia
#LigaSalvaVida https://t.co/9ofme8jpO6",61,3,2019,196452,64,0.03
188,"⏰42” Cambio en el Olimpia:

🦁Olimpia  0 - 0 Marathon 🦖

❎Sale:  17 J. Paz
✔ Entra:   6 B. Beckeles

#SomosOlimpia
#LigaSalvaVida https://t.co/pgHEGxa9yp",23,1,2019,196452,24,0.01
189,"¡Arranca el partido contra Marathon por el liderato!

🦁Olimpia  0 - 0 Marathon 🦖

#SomosOlimpia
#LigaSalvaVida
🇳🇱🇳🇱🇳🇱🇳🇱🇳🇱🇳🇱🇳🇱 https://t.co/RnXJegjAoR",77,6,2019,196452,83,0.04
190,"¡El 11 inicial para el león en Tegucigalpa!💪⚽️🇳🇱

🦁 #SomosOlimpia https://t.co/0JL46rCVie",154,33,2019,196452,187,0.1
191,"¡Olimpista! Te invitamos a que te acerques a los puntos Tengo mas cercanos para que adquieras tu entrada al Clásico. 🎫🎫

Todavía hay boletos para que puedas disfrutar de la fiesta del fútbol en familia. 🔴⚪🔵

#SomosOlimpia
#SomosFamilia https://t.co/9K0CvLbNQI",236,28,2019,196452,264,0.13
192,¡Hoy juega Olimpia! 🇳🇱 https://t.co/U1KiVgwDbr,471,82,2019,196452,553,0.28
193,"¡Olimpista! El León necesita tu apoyo responsable. 🙌👍

Se habilitará el sector de Sol Norte para mayor comodidad.

Llegá temprano al estadio y evitá las grandes filas. 💪

#SomosOlimpia
#SomosFamilia https://t.co/9AxDt1gjUU",221,39,2019,196452,260,0.13
194,"¡Somos Olimpia! 🏆🏆🏆🏆

""El Más Popular"" ""El Único Tetracampeón"" ""El Rey de Copas"" ""El Femoneno Social""

#ElMásGrandeDeCa 🇳🇱 https://t.co/boyUuOMSlW",753,190,2019,196452,943,0.48
195,"Un día como hoy hace 31 años Olimpia realizaba una hazaña única e impensada para los equipos del área.🔴⚪🔵

Triunfo 2-1 sobre @CruzAzulCD en el Estadio Azteca. 🏆

Nuestra historia es única e inigualable en CA. 💪

#SomosOlimpia
#ElMásGrandeDeCa

https://t.co/h5xik1NPc6",290,59,2019,196452,349,0.18
196,¡Con todo Mati! 💪⚽️🇳🇱 https://t.co/DY7JhmJeiE,419,29,2019,196452,448,0.23
197,"Unidos y listos para el clásico 💪🇳🇱

¡Juntos, siempre juntos!

#SomosOlimpia
🔴⚪🔵🔴⚪🔵🔴⚪🔵 https://t.co/tNuyQWi6tH",328,40,2019,196452,368,0.19
198,"Olimpia femenino a consolidar el liderato 🦁🥇
 
🏟 Estadio El Tizatillo
🗓️ 10/11/19
⏲ 8:00 am
🏆Liga Mayor de Fútbol Femenino

#OlimpiaDeCorazón 

🇳🇱🇳🇱🇳🇱🇳🇱🇳🇱🇳🇱🇳🇱 https://t.co/QnL8ibPleL",88,7,2019,196452,95,0.05
199,¡Vamos Olimpia! 🇳🇱💪 https://t.co/bxXk7Hgs4S,593,52,2019,196452,645,0.33
200,"¿Ya fuiste por tu boleto a los puntos Tengo? 🎫 🎫

El León te espera para que juntos aseguremos el pase a la final. 🏆🥇

#SomosOlimpia
🇳🇱🇳🇱🇳🇱🇳🇱🇳🇱🇳🇱🇳🇱🇳🇱🇳🇱🇳🇱🇳🇱 https://t.co/SJQI41Ve4O",272,20,2019,196452,292,0.15
201,"¡Nuestro Capitán y Goleador para la H! ¡Con todo a representar a Honduras!
⚪🔵🔴 #SomosOlimpia
¡Juntos, siempre juntos!
#ElMasGrandeDeCA https://t.co/rUjbwyumyF",172,13,2019,196452,185,0.09
202,"Medio Campo de Lujo convocado para la H... ¡Con todo a representar a Honduras!
⚪🔵🔴 #SomosOlimpia
¡Juntos, siempre juntos!
#ElMasGrandeDeCA https://t.co/GYLfbbL0je",110,19,2019,196452,129,0.07
203,"Porteros Albos para la H... ¡Con todo a representar a Honduras!
⚪🔵🔴 #SomosOlimpia
¡Juntos, siempre juntos!
#ElMasGrandeDeCA https://t.co/nRITyvJzk9",149,21,2019,196452,170,0.09
204,"Nuestros convocados a la H... ¡Con todo a representar a Honduras!
⚪🔵🔴 #SomosOlimpia
¡Juntos, siempre juntos!
#ElMasGrandeDeCA
Harold Fonseca, Alex Guity, Ever Alvarado, Carlos Pineda, Edwin Rodriguez y Jorge Benguche. https://t.co/Y5rI3MLEGJ",209,22,2019,196452,231,0.12
205,En este perfil Él nos guía ⬆️ 👉 https://t.co/0rFiIMlCHO,445,48,2019,196452,493,0.25
206,"¡Juntos, siempre juntos! 🔴⚪🔵

#SomosOlimpia
#SomosFamilia https://t.co/sip1x63HIT",249,30,2019,196452,279,0.14
207,"¡Feliz Cumpleaños a Alejandro Reyes! 🍰🍰🍰🍰

 ¡Que se vengan muchos mas!
🎈🎉🎈🎉🎈🎉

#CumpleañosAlbo 🔴⚪🔵 https://t.co/yTO8jX3Oik",269,15,2019,196452,284,0.14
208,"¡El Rey está de Cumpleaños!
🎉🎉🎉🎉 

Felicidades a David Suazo
🎂🇳🇱🎂🦁🎂🏆 

#CumpleañosAlbo https://t.co/xfXJb3rNw1",462,41,2019,196452,503,0.26
209,"¡El domingo a pintar de blanco el Nacional! 🦁💪

💵 Sol L.80 | Sombra L.150 | Silla 300 L.| 
🏟 Estadio Nacional
🗓️ 10/11/19
⏲ 4:00 pm
📺 Canal 5
🏆Liga SalvaVida

Boletos en todos los puntos Tengo.

Niños menores de 12 años entran gratis a sector de Sol.

🇳🇱🇳🇱🇳🇱🇳🇱🇳🇱🇳🇱🇳🇱 https://t.co/wZsCsP94Zw",368,45,2019,196452,413,0.21
210,"Así se vivió el recibimiento al más popular el domingo en el Superclasico.🇳🇱🇳🇱🇳🇱🇳🇱

Nuestro portero @AlexGuity36 🧤
captó el momento.

#SomosOlimpia
#LaAficiónMásGrandeDeCa https://t.co/XcPTWfXBUI",249,30,2019,196452,279,0.14
211,🎶Vamos mi león... Queremos la copa🎶 🇳🇱👊👊🎩 https://t.co/K47VUkpYMa,571,67,2019,196452,638,0.32
212,"Te dejamos el enlace para que revises la tabla de posiciones con Olimpia en el liderato absoluto.
🆙🆙🆙🆙
 https://t.co/KZQ3J7r1Cr",137,11,2019,196452,148,0.08
213,"Conceptos 🧢⚽👨‍🏫

🔴⚪🔵 https://t.co/30h3h6ggDM",686,118,2019,196452,804,0.41
214,"Conferencia de prensa DT Pedro Troglio después de la victoria en el clásico ante Motagua en San Pedro Sula.
🎥📺 https://t.co/VtO7yu9Dxw",287,27,2019,196452,314,0.16
215,"¡El líder está acá! ⬆️⬆️⬆️⬆️

Feliz semana a todo el pueblo Olimpista. ☀️☀️☀️☀️

#SomosOlimpia
#SomosFamilia https://t.co/PSwkbg4xLu",445,63,2019,196452,508,0.26
216,"Muchas gracias a toda la noble y gran afición olimpista que nos acompañó esta tarde en el Olímpico de San Pedro Sula.

¡Juntos, siempre juntos!

🔴🔵⚪ #SomosOlimpia

#ElMasGrandeDeCA https://t.co/mKDVFNjzAY",329,43,2019,196452,372,0.19
217,"¡Líderes! 

💪🏼🦁 | #SomosOlimpia #ElMásGrandeDeCA  #LigaSalvaVida https://t.co/BcCSQ8cnez",603,107,2019,196452,710,0.36
218,"¡Finaliza el partido! Derrotamos a Motagua y alcanzamos el liderato de la tabla.

💪🦁 #SomosOlimpia 

#ElMasGrandeDeCA https://t.co/lWWgxHy4Jf",705,156,2019,196452,861,0.44
219,"Min. 75 | Continuamos arriba en el marcador.

Olimpia 2-0 Motagua

#SomosOlimpia",90,4,2019,196452,94,0.05
220,"¡Goooool del león! ⚽️🦁  ...Bengúche al minuto 54.

Olimpia 2-0 Motagua

#SomosOlimpia",312,54,2019,196452,366,0.19
221,"¡Goooool del león! ⚽️🦁  ...Bengúche al minuto 46.

Olimpia 1-0 Motagua

#SomosOlimpia",216,39,2019,196452,255,0.13
222,"Ya se inició la segunda parte el en Olímpico de San Pedro Sula.

Olimpia 0-0 Motagua

💪¡ vamos leones!",59,2,2019,196452,61,0.03
223,"Nos vamos al descanso con el marcador empatado.

Olimpia 0-0 Motagua

#SomosOlimpia https://t.co/Q8WfbHFuQv",48,2,2019,196452,50,0.03
224,"Cambio en Olimpia

Sale: J. Álvarez
Entra: D. Flores https://t.co/V4cJSQh3CI",40,2,2019,196452,42,0.02
225,"Min.17 |  El marcador continúa empatado en el Olímpico de San Pedro Sula. 

¡Vamos Olimpia!",45,1,2019,196452,46,0.02
226,"Arranca el clásico en el Olímpico... vamos leones!! 🦁💪🏼🇳🇱

#SomosOlimpia 
#ElMásGrandeDeCA https://t.co/ZFk8I6sRkP",62,3,2019,196452,65,0.03
227,"Así sale el león para enfrentar el clásico 🇳🇱💪🏼 ...vamos con todo.

#SomosOlimpia 
#ElMásGrandeDeCA https://t.co/5K1haGKoFq",185,39,2019,196452,224,0.11
228,"Nadie nos dijo que sería fácil.🏆

Nuestra historia se forjó con historias únicas e irrepetibles.💪

Acá estamos y siempre estaremos... Hasta el final 🇳🇱🇳🇱🇳🇱

¡Juntos, siempre juntos!
🔴⚪🔵🔴⚪🔵🔴⚪🔵

#ElMásGrandeDeCa
#SomosOlimpia
#SomosFamilia https://t.co/SQIylRJDWl",593,111,2019,196452,704,0.36
229,¡Hoy juega Olimpia! 🇳🇱 https://t.co/JHy3luUTK1,317,58,2019,196452,375,0.19
230,"El Tetracampeón ya está en San Pedro Sula. 💪🏼

¡Olimpista tu cita es mañana en el Metropolitano!

El clásico se juega solo con olimpistas🔴⚪🔵 https://t.co/mjLSfb0uJR",402,32,2019,196452,434,0.22
231,"¡Esto somos! 🇳🇱

La inmenso de Olimpia es su gente 🔴⚪🔵🔴⚪🔵🔴⚪🔵

Mañana nos jugamos la primera final y tenés que estar allí 💪💪

!Juntos, siempre juntos! 🦁🦁🦁🦁

#Confiá 
#SomosOlimpia
#SomosFamilia
#LigaSalvaVida https://t.co/uNPrdT2rfy",390,60,2019,196452,450,0.23
232,"Ahora a poner la mirada en el torneo local, ¡vamos por el liderato! 🦁💪

🏟 Estadio Olímpico Metropolitano
🗓️ 03/11/19
⏲ 5:00 pm
🏆Liga SalvaVida

Boletos en todos los puntos Tengo.

Niños menores de 12 años entran gratis a sector de Sol.

🇳🇱🇳🇱🇳🇱🇳🇱🇳🇱🇳🇱🇳🇱 https://t.co/loBdJnPgAu",274,30,2019,196452,304,0.15
233,"!Levantamos la cara siempre! 🦁🦁

Nuestra mística siempre nos enseñó a ser orgullosos de nuestra historia 🇳🇱🇳🇱🇳🇱

¡Juntos, siempre juntos! 🔴⚪🔵

#SomosOlimpia
#SomosFamilia https://t.co/ibQ5kKLKGC",482,77,2019,196452,559,0.28
234,"Pitazo final en Costa Rica.

Saprissa 🇱🇻 4 - Olimpia 1 🇳🇱

#LigaConcacaf
#StateOfGoal
#SomosOlimpia https://t.co/4v5q2MplGp",207,47,2019,196452,254,0.13
235,"⏰95”  Gol para Saprissa.

Saprissa 🇱🇻 4 - Olimpia 1 🇳🇱

#LigaConcacaf
#StateOfGoal
#SomosOlimpia",49,14,2019,196452,63,0.03
236,"90” Cambio en el Olimpia:

Saprissa 🇱🇻 3 - Olimpia 1 🇳🇱

❎Sale:  10 M. Garrido
✔ Entra:   26 J. Ferrari

#LigaConcacaf
#StateOfGoal
#SomosOlimpia https://t.co/F0fqbQ4wRO",18,0,2019,196452,18,0.01
237,"⏰88”  Gol para Saprissa.

Saprissa 🇱🇻 3 - Olimpia 1 🇳🇱

#LigaConcacaf
#StateOfGoal
#SomosOlimpia",11,3,2019,196452,14,0.01
238,"⏰83”  Tiro libre para Saprissa.

Saprissa 🇱🇻 2 - Olimpia 1 🇳🇱

#LigaConcacaf
#StateOfGoal
#SomosOlimpia",15,1,2019,196452,16,0.01
239,"73” Cambio en el Olimpia:

❎Sale:  9 J. Bengúche
✔ Entra:   20 D. Flores

#LigaConcacaf
#StateOfGoal
#SomosOlimpia https://t.co/DNwl9sYqBp",18,3,2019,196452,21,0.01
240,"⏰69” Gol del Saprissa.

Saprissa 🇱🇻 2 - Olimpia 1 🇳🇱

#LigaConcacaf
#StateOfGoal
#SomosOlimpia",15,1,2019,196452,16,0.01
241,"⏰62” ¡Goooooooool del Olimpiaaaaaa🦁!

¡Alvarezzz mete el primero para el Olimpia! 

Saprissa 🇱🇻 1 - Olimpia 1 🇳🇱

#LigaConcacaf
#StateOfGoal
#SomosOlimpia https://t.co/DI3EUGAZeJ",204,52,2019,196452,256,0.13
242,"55” Cambio en el Olimpia:

❎Sale:  15 E. Rodriguez
✔ Entra:   14 J. Lacayo

#LigaConcacaf
#StateOfGoal
#SomosOlimpia https://t.co/y9ySAE2kH0",15,3,2019,196452,18,0.01
243,"Arranca el segundo tiempo en Costa Rica.

Saprissa 🇱🇻 1 - Olimpia 0 🇳🇱

#LigaConcacaf
#StateOfGoal
#SomosOlimpia",19,2,2019,196452,21,0.01
244,"Nos vamos al descanso perdiendo por 1 gol.

Saprissa 🇱🇻 1 - Olimpia 0 🇳🇱

#LigaConcacaf
#StateOfGoal
#SomosOlimpia https://t.co/KoKRIRnQq0",35,1,2019,196452,36,0.02
245,"Gol de Saprissa a los 32' minutos:

Manfred Ugalde

Saprissa 🇱🇻 1 - Olimpia 0 🇳🇱

#LigaConcacaf
#StateOfGoal
#SomosOlimpia",22,3,2019,196452,25,0.01
246,"🕛 30' minutos en el Ricardo Saprissa! 

Saprissa 🇱🇻 0 - Olimpia 0 🇳🇱

#LigaConcacaf
#StateOfGoal
#SomosOlimpia",22,2,2019,196452,24,0.01
247,"🕛 22' minutos en el Ricardo Saprissa! 

Saprissa 🇱🇻 0 - Olimpia 0 🇳🇱

#LigaConcacaf
#StateOfGoal
#SomosOlimpia",28,1,2019,196452,29,0.01
248,"🕛 12' minutos en el Ricardo Saprissa! 🦁💪

Saprissa 🇱🇻 0 - Olimpia 0 🇳🇱

#LigaConcacaf
#StateOfGoal
#SomosOlimpia",27,2,2019,196452,29,0.01
249,"🕛¡Inicia el partido en el Ricardo Saprissa! 🦁💪

Saprissa 🇱🇻 0 - Olimpia 0 🇳🇱

#LigaConcacaf
#StateOfGoal
#SomosOlimpia https://t.co/auEsYENFZq",64,14,2019,196452,78,0.04
250,"Calentamiento previo al clásico Centroamericano. 🏋️‍♂️💪

¡Dale León! 🦁 https://t.co/ATGCatYp7B",193,37,2019,196452,230,0.12
251,"Así sale el León esta noche 🇳🇱 Vrs @SaprissaOficial : 

#LigaConcacaf
#StateOfGoal
#SomosOlimpia https://t.co/GyrFbg76BJ",253,72,2019,196452,325,0.17
252,¡Hoy juega Olimpia! 🇳🇱 https://t.co/OBGfq3Km17,527,113,2019,196452,640,0.33
253,"En estos momentos Olimpia realiza reconomiento de cancha previo al juego de vuelta de semifinales Liga Concacaf.💪

#LigaConcacaf
#StateOfGoal
#SomosOlimpia https://t.co/T3zrKVO0aO",355,52,2019,196452,407,0.21
254,"📋 Lista de concentrados para enfrentar a @SaprissaOficial

#SomosOlimpia 🇳🇱 https://t.co/UbwJvbzKRS",288,34,2019,196452,322,0.16
255,"El Club Olimpia Deportivo a medios de comunicación y prensa de la zona norte.

Realizar acreditación en el enlace de la página oficial del Club:
https://t.co/uQ4vN6xa81

La plataforma estará  disponible hasta día jueves 31 de octubre a las 11:00 pm https://t.co/YOTZsqBVoU",68,7,2019,196452,75,0.04
256,"¡Unidos por el mismo objetivo! 🙌

¡Juntos, siempre juntos! 🔴⚪🔵

#LigaConcacaf
#StateOfGoal
#SomosOlimpia https://t.co/9NKpJr3nky",255,33,2019,196452,288,0.15
257,"El León por el liderato 🦁

💵 Sol 100 Lps Sombra 200 Silla 300 Palco este 400 Palco oeste 500
🏟 Estadio Metropolitano de Sula
🗓️ 03/11/19
⏲ 5:00 pm 
🏆Liga SalvaVida

Boletos en todos los puntos Tengo.

Niños menores de 12 años entran gratis a sector de Sol. 

🇳🇱🇳🇱🇳🇱🇳🇱🇳🇱🇳🇱🇳🇱 https://t.co/AsmahxH5KX",335,70,2019,196452,405,0.21
258,"Fechas para los partidos reprogramados.

Olimpia 🇳🇱 Vrs Marathon 🇮🇪
📅 10/11/19
🏟️ Estadio Nacional
🏢 Tegucigalpa
🕔 4:00 pm

#SomosOlimpia https://t.co/cTIfv5Bzin",304,54,2019,196452,358,0.18
259,"¡Triunfazo del femenino! 🦁🦁

Olimpia derrotó 11-0 a Juventus en la continuación de la Liga Mayor.

Mirian Martinez  ⚽
Lisbeth Bonilla ⚽⚽
Yeimy Estrafa ⚽⚽
Truimali Ramirez ⚽
Yendy Martinez ⚽⚽⚽⚽⚽

#OlimpiaDeCorazón https://t.co/M1qmR3lgF7",112,16,2019,196452,128,0.07
260,"Feliz inicio de semana Olimpista 💪

Con la mirada puesta en las semifinales de #LigaConcacaf 🔍

¡Juntos, siempre juntos! 🔴⚪🔵

#SomosOlimpia https://t.co/luh4CAVn8r",268,34,2019,196452,302,0.15
261,"Finaliza el partido en Tocoa. 

Real Sociedad 1- 2 Olimpia 

#SomosOlimpia
🇳🇱🇳🇱🇳🇱🇳🇱🇳🇱🇳🇱🇳🇱🇳🇱

¡El más grande de Centroamérica!
🔴⚪🔵🔴⚪🔵🔴⚪🔵🔴 https://t.co/y5Chyb1427",314,71,2019,196452,385,0.2
262,"⏰86” ¡Goooooooool del Olimpia🦁!

¡Ever Alvarado mete el segundooo para el Olimpia! 

Real Sociedad 1- 2 Olimpia 

🦁🦁👏👏🇱🇺🇱🇺🤩
#ElMasGrandeDeCA #HastaElÚltimoMinuto https://t.co/NAYSS5JSds",377,47,2019,196452,424,0.22
263,"⏰74” Gol del Real Sociedad.

Real Sociedad 1 - 1 Olimpia🦁 

#HastaElÚltimoMinuto",21,0,2019,196452,21,0.01
264,"69” Cambio en el Olimpia:

❎Sale:  E.Hernández
✔ Entra:   J. Rochez

#HastaElÚltimoMinuto
#ElMasGrandeDeCA https://t.co/NeKdT8lzPr",18,0,2019,196452,18,0.01
265,"⏰65” ¡Goooooooool del Olimpia🦁!

¡Eddy Hernández mete el primero para el Olimpia! 

Real Sociedad 0 - 1 Olimpia 

🦁🦁👏👏🇱🇺🇱🇺🤩
#ElMasGrandeDeCA #HastaElÚltimoMinuto https://t.co/q4vgd0JzGO",205,29,2019,196452,234,0.12
266,"⏱58” Cambio en el Olimpia:

❎Sale: 31 M. Morales
✔ Entra: 15  E. Rodriguez

#HastaElÚltimoMinuto
#ElMasGrandeDeCA https://t.co/FNCtYqbceH",16,1,2019,196452,17,0.01
267,⏱️49’ 🙋🏽‍♂🔶 Tarjeta amarilla para Deiby Flores.,17,0,2019,196452,17,0.01
268,"¡Arranca el segundo partido en Tocoa!

Real Sociedad 0 - 0 Olimpia 🦁

#SomosOlimpia
#ElMasGrandeDeCA
🇳🇱🇳🇱🇳🇱🇳🇱🇳🇱🇳🇱🇳🇱",45,3,2019,196452,48,0.02
269,"¡Cerramos el primer tiempo empatados en Colón!

🦁Olimpia 0 - 0 Real Sociedad

#SomosOlimpia
#ElMasGrandeDeCA
🇳🇱🇳🇱🇳🇱🇳🇱🇳🇱🇳🇱🇳🇱 https://t.co/vGCZEpccxN",55,2,2019,196452,57,0.03
270,"Así salió el león hoy en Tocoa.

#SomosOlimpia
#ElMasGrandeDeCA
🇳🇱🇳🇱🇳🇱🇳🇱🇳🇱🇳🇱🇳🇱 https://t.co/fxXRAIXmEP",88,10,2019,196452,98,0.05
271,"Se mueve el balón en el estadio Francisco Martinez

Real Sociedad - Olimpia

#SomosOlimpia
#ElMasGrandeDeCA
🇳🇱🇳🇱🇳🇱🇳🇱🇳🇱🇳🇱🇳🇱 https://t.co/D9EnTf2uND",50,2,2019,196452,52,0.03
272,¡Hoy juega Olimpia 🇳🇱! https://t.co/gRmis9keJ8,259,43,2019,196452,302,0.15
273,"El León a la caza 🦁🇳🇱

🏟 Francisco Martínez Durón
🏢 Tocoa
👕 Real Sociedad 
🗓️ 27/10/19
⏲ 3:00 pm 
🏆Liga SalvaVida 

#SomosOlimpia
#LigaSalvaVida https://t.co/z4eXpuIiQ3",229,21,2019,196452,250,0.13
274,"La secuencia 🎬

Describilo con emojis.

Nosotros:🕺🤳🐂🌋🚀📻⬆️ https://t.co/p5jzuWZnXw",276,28,2019,196452,304,0.15
275,"Las postales del triunfo en el clásico Centroamericano 📷

#SomosOlimpia 🔴⚪🔵 https://t.co/nAbbUEIY1f",231,24,2019,196452,255,0.13
276,"Palabras de Pedro Troglio después del partido de anoche donde Olimpia derrotó 2-0 al Saprissa por la Concacaf League. 

#SomosOlimpia https://t.co/lMCOjXlGas",246,26,2019,196452,272,0.14
277,"Fechas para los partidos reprogramados. Estadios y sedes aún por confirmar.

#SomosOlimpia https://t.co/25rl0fFltv",178,30,2019,196452,208,0.11
278,Olimpia 0501 🇳🇱 https://t.co/pCMfOMQr7i,467,48,2019,196452,515,0.26
279,"¡Finalizó el partido en el Olímpico Metropolitano de San Pedro Sula! ⚽🏟️

💪🏼Importante triunfo del león en la Concacaf League🦁

Olimpia 2-0 Saprissa

#ConcacafLeague
#StateOfGoal
#SomosOlimpia https://t.co/6aYFOQAAX6",807,191,2019,196452,998,0.51
280,"⏰80”
Goooooooooooooooooooool
Goooooooooooooooooooool

Jorge Bengúche mete el segundoooo

Olimpia 2 🇳🇱 - 0 Saprissa 

#ConcacafLeague
#StateOfGoal
#SomosOlimpia https://t.co/iSNXz0TaVA",470,98,2019,196452,568,0.29
281,"⏱64” Cambio en el Olimpia:

❎Sale: 27 J. Bengston
✔ Entra: 20  D. Flores

#HastaElÚltimoMinuto
#ElMasGrandeDeCA https://t.co/0mMnFcsWZi",29,2,2019,196452,31,0.02
282,🕛 61' 🛑 Tarjeta roja para paton Mejía y para el auxiliar de Troglio.,29,4,2019,196452,33,0.02
283,"Falta para el Saprissa cerca del área.

Olimpia 1 🇳🇱 - Saprissa 0",28,4,2019,196452,32,0.02
284,"Cambio en Olimpia:

Sale:Matías Garrido
Entra:Junior Lacayo

#ConcacafLeague
#StateOfGoal
#SomosOlimpia",40,5,2019,196452,45,0.02
285,"Inicia el segundo tiempo en el Metropolitano 🕛

Olimpia 1 🇳🇱 - Saprissa 0 🇱🇻

Jorge Bengúche (24)

#ConcacafLeague
#StateOfGoal
#SomosOlimpia",54,6,2019,196452,60,0.03
286,"Medio tiempo en el Metropolitano 🕛

Olimpia 1 🇳🇱 - Saprissa 0 🇱🇻

Jorge Bengúche (24)

#ConcacafLeague
#StateOfGoal
#SomosOlimpia https://t.co/84LLHWhbg4",103,11,2019,196452,114,0.06
287,"35' minutos en el Metropolitano 🕛

Olimpia 1 🇳🇱 - Saprissa 0 🇱🇻

Jorge Bengúche (24)

#ConcacafLeague
#StateOfGoal
#SomosOlimpia",60,6,2019,196452,66,0.03
288,"Goooooooooooooooooooool
Goooooooooooooooooooool

Jorge Bengúche a los 24' minutos

Olimpia 1 🇳🇱 - Saprissa 0

#ConcacafLeague
#StateOfGoal
#SomosOlimpia https://t.co/VXsXA9j06Y",469,91,2019,196452,560,0.29
289,"13' minutos en el Metropolitano 🕛

Olimpia 0 🇳🇱 - Saprissa 0 🇱🇻

#ConcacafLeague
#StateOfGoal
#SomosOlimpia",32,0,2019,196452,32,0.02
290,"¡Se mueve el balón en el Metropolitano de Sula! ⚽🏟️

Olimpia 🇳🇱 - Saprissa 🇱🇻

#ConcacafLeague
#StateOfGoal
#SomosOlimpia https://t.co/8RR9fwBkfC",97,7,2019,196452,104,0.05
291,"Calentamiento previo al clásico Centroamericano. 🏋️‍♂️💪

¡Dale León! 🦁 https://t.co/x63u8i3TEY",114,8,2019,196452,122,0.06
292,"¡El banderazo tricolor! 🔴⚪🔵

¡Juntos, siempre juntos! 🙌🤝

#SomosOlimpia
#SomosFamilia https://t.co/y37Z7R1ZjV",239,40,2019,196452,279,0.14
293,"Así sale el León esta tarde en el Metropolitano Vrs @SaprissaOficial

@Concacaf
#ConcacafLeague
#StateOfGoal
#SomosOlimpia 
🇳🇱🇳🇱🇳🇱🇳🇱🇳🇱🇳🇱🇳🇱🇳🇱🇳🇱🇳🇱🇳🇱 https://t.co/ayACdXkCOE",134,36,2019,196452,170,0.09
294,¡Hoy juega Olimpia! 🇳🇱 https://t.co/LXCcfJEzx3,392,96,2019,196452,488,0.25
295,"El Tetracampeon realizó entrenamiento previo a semifinales de #LigaConcacaf contra @SaprissaOficial

#SomosOlimpia
#HastaElÚltimoMinuto https://t.co/VjwNXqLmgF",200,28,2019,196452,228,0.12
296,"Mañana jugamos a puerta cerrada ¡Pero nunca solos!🇳🇱

¡Ponete la blanca mañana! ⚪⚪

Envíanos fotos desde tu trabajo, pone la bandera en tu carro, desde cualquier rincón del mundo donde se encuentre un Olimpista. 🌍

#SomosOlimpia

LA AFICIÓN MÁS GRANDE DE CENTROAMÉRICA 🔴⚪🔵 https://t.co/9VKmLuwBty",321,60,2019,196452,381,0.19
297,"¡El León ya está en camino a San Pedro Sula! 🚌

#HastaElÚltimoMinuto
#SomosOlimpia https://t.co/9mKFu7wYun",287,39,2019,196452,326,0.17
298,Listos para viajar mañana a San Pedro Sula 💪🏋️‍♂️ https://t.co/GeeoKe8Wdf,304,23,2019,196452,327,0.17
299,"¿La cantamos juntos? 🇳🇱

🎶Vamos mi león,queremos la copa... 🎶

#SomosOlimpia

EL MÁS GRANDE DE CENTROAMÉRICA
🏆🏆🏆🏆🏆🏆🏆🏆🏆🏆🏆 https://t.co/0DApmRuPGh",292,33,2019,196452,325,0.17
300,"El León sale de cacería 🦁🇳🇱🇱🇻

🏟 Estadio Metropolitano
🗓️ 24/10/19
⏲ 6:00 pm 
📺 Espn 2 Fox Sports 2
🏆Liga Concacaf 

#SomosOlimpia @Concacaf https://t.co/TDM8vqe6Sl",293,55,2019,196452,348,0.18
301,"Describe con emojis a Patón

Nosotros 🥇👷‍♂️🏋️‍♂️💪💎 https://t.co/jTlJdePeqy",267,11,2019,196452,278,0.14
302,Así la definió el goleador ⚽💪🇳🇱 https://t.co/WjYnwaHkTE,137,8,2019,196452,145,0.07
303,"Conferencia de prensa Pedro Troglio🎤:

""Olimpia tuvo un primer tiempo de alto vuelo y 30 minutos del segundo también...se ganó y lo importante es ganar"" 

#SomosOlimpia https://t.co/cwrue1Eoqm",102,10,2019,196452,112,0.06
304,"Conferencia de prensa Pedro Troglio🎤:

""Le ganamos a un rival durisimo,hemos merecido hacer algún gol mas"" 

#SomosOlimpia https://t.co/2iRklGufBR",170,15,2019,196452,185,0.09
305,"Las postales del triunfo de esta tarde ante Lobos Upn. 📷

⬆️⬆️⬆️⬆️⬆️⬆️⬆️⬆️

El más grande de Centroamérica
🇳🇱🇳🇱🇳🇱🇳🇱🇳🇱🇳🇱🇳🇱🇳🇱🇳🇱🇳🇱 https://t.co/D31LPmoeT4",207,17,2019,196452,224,0.11
306,"Muchas gracias a toda la afición olimpista que nos acompañó esta tarde en el Nacional de Tegucigalpa.

#ElMasGrandeDeCA

🔴🔵⚪ #SomosOlimpia https://t.co/03oGFC9aBc",265,19,2019,196452,284,0.14
307,"Finaliza el partido en el Nacional. Tres puntos importantes ante UPN 💪🏼

#SomosOlimpia
🇳🇱🇳🇱🇳🇱🇳🇱🇳🇱🇳🇱🇳🇱🇳🇱

¡El más grande de Centroamérica!
🔴⚪🔵🔴⚪🔵🔴⚪🔵🔴 https://t.co/FPlGCQnocV",233,54,2019,196452,287,0.15
308,"Tercer cambio en Olimpia a los 77' minutos:

Sale:Jorge Benguche 
Entra:Cristhian Maidana

#SomosOlimpia
🔴⚪🔵🔴⚪🔵🔴⚪🔵",30,0,2019,196452,30,0.02
309,"Segundo cambio en Olimpia a los 73' minutos:

Sale:Matías Garrido
Entra:Maylor Núñez 

#SomosOlimpia
🔴⚪🔵🔴⚪🔵🔴⚪🔵",17,0,2019,196452,17,0.01
310,"Cambio en Olimpia a los 64' minutos:

Sale:Edwin Rodriguez
Entra:Junior Lacayo

#SomosOlimpia
🔴⚪🔵🔴⚪🔵🔴⚪🔵",21,0,2019,196452,21,0.01
311,"60' minutos en el Nacional 🕛

Olimpia 1 - Lobos Upn 0

#SomosOlimpia
🔴⚪🔵🔴⚪🔵🔴⚪🔵",23,0,2019,196452,23,0.01
312,"Inicia el segundo tiempo en el Nacional 🕛

Olimpia 1 - Lobos Upn 0

#SomosOlimpia
🔴⚪🔵🔴⚪🔵🔴⚪🔵",39,1,2019,196452,40,0.02
313,"¡Cerramos el primer tiempo arriba con un gol de Jerry!

🦁Olimpia 1 - 0 UPN🐺

#SomosOlimpia
#ElMasGrandeDeCA
🇳🇱🇳🇱🇳🇱🇳🇱🇳🇱🇳🇱🇳🇱 https://t.co/gsZFtd4wuM",57,2,2019,196452,59,0.03
314,"⏰46” ¡Goooooooool del Olimpia🦁!

Jerry Bengston anota el primero para el león.
Olimpia 1 - 0 UPN

🦁🦁👏👏🇱🇺🇱🇺🤩
#ElMasGrandeDeCA #HastaElÚltimoMinuto https://t.co/qa1kRcKwKG",208,28,2019,196452,236,0.12
315,"¡Arranca el partido contra el UPN!

#SomosOlimpia
🇳🇱🇳🇱🇳🇱🇳🇱🇳🇱🇳🇱🇳🇱🇳🇱

¡El más grande de Centroamérica!
🔴⚪🔵🔴⚪🔵🔴⚪🔵🔴⚪🔵 https://t.co/6zcuroE0RO",54,1,2019,196452,55,0.03
316,"Así sale el León contra los Lobos✏️

#SomosOlimpia
🇳🇱🇳🇱🇳🇱🇳🇱🇳🇱🇳🇱🇳🇱🇳🇱

El más grande de Centroamérica
🔴⚪🔵🔴⚪🔵🔴⚪🔵🔴⚪🔵 https://t.co/eqeTWQSIF0",60,9,2019,196452,69,0.04
317,"Así sale el León contra los Lobos✏️

#SomosOlimpia
🇳🇱🇳🇱🇳🇱🇳🇱🇳🇱🇳🇱🇳🇱🇳🇱

El más grande de Centroamérica
🔴⚪🔵🔴⚪🔵🔴⚪🔵🔴⚪🔵 https://t.co/J3vAUR7vzY",106,7,2019,196452,113,0.06
318,¡Hoy juega Olimpia! 🇳🇱 https://t.co/0jraEkByWP,225,29,2019,196452,254,0.13
319,"¡Listos para mañana! 🙏🙏

Nos vemos en el Nacional 🏟️🏟️

#SomosOlimpia
#SomosFamilia https://t.co/6GdcGeAKGu",203,24,2019,196452,227,0.12
320,"¡Feliz Cumpleaños a nuestro PF.!
🎉🎉🎉💪💪🎉🎉💪💪

Felicidades al Profesor Pablo Martín de parte de toda la familia olimpista en el mundo. 🎂🍰🎂🍰

¡Olimpia es su casa! 🔴⚪🔵

#CumpleañosAlbo https://t.co/twY73GGqNl",261,19,2019,196452,280,0.14
321,"A pintar de blanco el Nacional🦁

💵 Sol 70 Lps Sombra 150 Silla 250
🏟 Estadio Nacional
🗓️ 20/10/19
⏲ 4:00 pm 
📺 Canal 5
🏆Liga SalvaVida

Boletos en todos los puntos Tengo.

Niños menores de 12 años entran gratis a sector de Sol. 

Aplica descuento para la tercera edad. https://t.co/k7NIrPRjTm",240,42,2019,196452,282,0.14
322,"Las postales del triunfo anoche ante Honduras Progreso. 📷

#SomosOlimpia https://t.co/xqbBJ57DU6",280,30,2019,196452,310,0.16
323,"¡Muchas Gracias! A todo el Olimpismo que nos acompañó la noche del día de ayer en nuestro regreso a casa. #ElMasGrandeDeCA
🔴🔵⚪ #SomosOlimpia https://t.co/P34DBIqes6",227,31,2019,196452,258,0.13
324,"¡Terminamos con un triunfazo con el regreso a casa!

Gracias a la afición que asistió.

Olimpia 4 - 0 Honduras Progreso

#HastaElÚltimoMinuto #ElMasGrandeDeCA https://t.co/rTLIi5amfB",333,77,2019,196452,410,0.21
325,"⏰82” ¡Goooooooool del Olimpiaaaaa🦁!

¡Jerry Bengston de penal mete el cuarto para el Olimpia! 

Olimpia 4 - H. Progreso

🦁🦁👏👏🇱🇺🇱🇺🤩
#ElMasGrandeDeCA #HastaElÚltimoMinuto https://t.co/CWGS0YM0hv",136,13,2019,196452,149,0.08
326,¡Penal para el león!,42,5,2019,196452,47,0.02
327,"⏱79” Cambio en el Olimpia:

❎Sale: 9 J. Bengúche
✔ Entra: 30 E. Hernández

#HastaElÚltimoMinuto
#ElMasGrandeDeCA https://t.co/XxtCq8Kg3H",22,0,2019,196452,22,0.01
328,"⏱68” Cambio en el Olimpia:

❎Sale: 10 M. Garrido
✔ Entra: 12  C. Maidana

#HastaElÚltimoMinuto
#ElMasGrandeDeCA https://t.co/jojh7nOO3V",24,1,2019,196452,25,0.01
329,"⏱57” Cambio en el Olimpia:

❎Sale: 15 E. Rodríguez
✔ Entra: 14  J. Lacayo 

#HastaElÚltimoMinuto
#ElMasGrandeDeCA https://t.co/k06GADL20n",34,1,2019,196452,35,0.02
330,⏱️45' Inicia el segundo tiempo en el Nacional de Tegucigalpa.,26,1,2019,196452,27,0.01
331,"Final del primer tiempo en casa. 

🦁Olimpia 3 - Honduras Progreso 

#SomosOlimpia
#ElMasGrandeDeCA
🇳🇱🇳🇱🇳🇱🇳🇱🇳🇱🇳🇱🇳🇱 https://t.co/zE31mu7HH6",76,11,2019,196452,87,0.04
332,"⏰40” ¡Goooooooool del Olimpia🦁!

¡Ever Alvarado el capítaaan mete de cabeza el tercero para el Olimpia! 

Olimpia 3 - H. Progreso

🦁🦁👏👏🇱🇺🇱🇺🤩
#ElMasGrandeDeCA #HastaElÚltimoMinuto https://t.co/MA2pKszUxr",210,24,2019,196452,234,0.12
333,"⏰32” ¡Goooooooool del Olimpia🦁!

¡Matías Garridooo mete de cabeza el segundo para el Olimpia! 

Olimpia 2 - H. Progreso

🦁🦁👏👏🇱🇺🇱🇺🤩
#ElMasGrandeDeCA #HastaElÚltimoMinuto https://t.co/VMrId9Giiz",142,20,2019,196452,162,0.08
334,"⏰24” ¡Goooooooool del Olimpia🦁!

¡Edwin Rodriguez mete el primero para el Olimpia! 

Olimpia 1 - H. Progreso

🦁🦁👏👏🇱🇺🇱🇺🤩
#ElMasGrandeDeCA #HastaElÚltimoMinuto https://t.co/Y99aOTKSob",184,23,2019,196452,207,0.11
335,"¡Arrancamos contra el progreso, por fin en casa!

#SomosOlimpia
🇳🇱🇳🇱🇳🇱🇳🇱🇳🇱🇳🇱🇳🇱🇳🇱

¡El más grande de Centroamérica!
🔴⚪🔵🔴⚪🔵🔴⚪🔵🔴⚪🔵 https://t.co/dVpFUBXQxK",57,12,2019,196452,69,0.04
336,"Así sale el león esta noche 💪🏼

#SomosOlimpia 🔴⚪️🔵 https://t.co/CqtoVfloao",109,23,2019,196452,132,0.07
337,"Queremos que todos los
aficionados puedan disfrutar de una verdadera fiesta deportiva.

#SomosOlimpia 🔴⚪️🔵 https://t.co/uyonHVMqlr",89,14,2019,196452,103,0.05
338,"A toda nuestra afición: de nuevo jugamos como locales en nuestro estadio. Esperamos contar con tu respaldo en todo sentido.

#SomosOlimpia 🔴⚪️🔵 https://t.co/JBMh2ScI9e",76,12,2019,196452,88,0.04
339,👊💪🙏🦁🔴⚪🔵 https://t.co/10LDNM6Ub7,217,30,2019,196452,247,0.13
340,"El Nacional respira 🏟️🏟️🏟️🏟️

🇳🇱🇳🇱🇳🇱🇳🇱🇳🇱🇳🇱🇳🇱🇳🇱 https://t.co/Jj7RaiSGMb",377,50,2019,196452,427,0.22
341,"¡Esto somos! 👨‍👩‍👦‍👦🙌

Familias unidas por una misma pasión. 🇳🇱

Los ganadores de los pases dobles para el juego de hoy.

Reclamar boletos con Id en portón de ingreso a camerinos.

#SomosOlimpia
#SomosFamilia
#ElNacionalRespira https://t.co/o3Go0Cojdj",79,7,2019,196452,86,0.04
342,"¡Felicidades para uno de nuestros valuartes del mejor equipo de utileria! 🎉🎉🎉

Feliz Cumpleaños a Rony Avila
🎂🎂🎂🎂🎂🎂🎂🎂🎂

¡Olimpia es tu casa! 🦁🇳🇱

#CumpleañosAlbo https://t.co/7ujguAjj4X",127,7,2019,196452,134,0.07
343,¡Hoy juega Olimpia! 🇳🇱 https://t.co/exV5MYgUVI,283,42,2019,196452,325,0.17
344,"¡Tenemos pases dobles de cortesía para ver al León mañana en nuestra casa! 🏠

Subí una foto con tu familia en el estadio junto al Hashtag #SomosFamilia y participa en 10 pases dobles. 📷

#SomosOlimpia
#SomosFamilia
#ElNacionalRespira https://t.co/lI6EBaLDZJ",254,29,2019,196452,283,0.14
345,"¡El Nacional respira! 🏟️🏟️

Mañana nos volvemos a encontrar en nuestra casa.✔️

Acercate a los puntos Tengo a adquirir tu boleto para cualquier localidad.

💵 Sol 70 Lps Sombra 150 Silla 250

#SomosOlimpia 🔴⚪️🔵 https://t.co/TLH1AGNsuW",269,36,2019,196452,305,0.16
346,"Olimpia femenino sigue de líder y en ruta al campeonato regional.🏆

Con un poker de nuestra goleadora
Yendi Martínez vencimos 4-1 a Pumas. ⚽⚽⚽⚽

#OlimpiaDeCorazón
🔴⚪🔵🔴⚪🔵🔴⚪🔵 https://t.co/dPGDHAeqZI",111,7,2019,196452,118,0.06
347,"¡Con todo Deiby! 👊💪

#SomosOlimpia
🇱🇺🇱🇺🇱🇺🇱🇺 https://t.co/EURRip3fCw",193,10,2019,196452,203,0.1
348,"Felicidades a toda la familia del @cdsvida al arribar a sus 79 años de fundación. 
🎉🎉🎉🎉🎉🎉🎉🎉🎉

¡Esa Vida juega paps! 🇦🇹🇦🇹🌴🌴 https://t.co/SGwTLSH5Ux",373,48,2019,196452,421,0.21
349,"Olimpia vuelve a casa🦁

💵 Sol 70 Lps Sombra 150 Silla 250
🏟 Estadio Nacional
🗓️ 16/10/19
⏲ 7:00 pm 
📺 Deportes Televicentro 
🏆Liga SalvaVida

Boletos en todos los puntos Tengo.

Niños menores de 12 años entran gratis a sector de Sol. 

Aplica descuento para la tercera edad. https://t.co/lv5tNXyofK",258,49,2019,196452,307,0.16
350,"El Tetracampeón vuelve a casa.
🏆🏆🏆🏆

¡Juntos, siempre juntos!
🔴⚪🔵🔴⚪🔵🔴⚪🔵

Miércoles, estadio Nacional
7:00 pm

#HastaElÚltimoMinuto
#SomosFamilia
#SomosOlimpia

🇳🇱🇳🇱🇳🇱🇳🇱🇳🇱🇳🇱🇳🇱🇳🇱🇳🇱 https://t.co/gNROmK8OjK",465,104,2019,196452,569,0.29
351,#SomosOlimpia 💪👊 https://t.co/U2tYnGAs5o,221,24,2019,196452,245,0.12
352,Galería de Imágenes del Meet &amp; Greet en @diunsa Los PRÓCERES-Tegucigalpa con los jugadores de Club Olimpia Deportivo https://t.co/GYcIHVrKNf,157,18,2019,196452,175,0.09
353,"¡Olimpista! 🦁🦁🦁🦁

Nos vemos a las 2:00 pm en @diunsahn Próceres.

#SomosOlimpia
#SomosUmbro https://t.co/8YIyPZyqcI",131,20,2019,196452,151,0.08
354,"Trabajo y mas trabajo de la mano del Profe Troglio y el Cuerpo Técnico. 💪💪💪💪

Nos vemos el miércoles en el Nacional. 🏟️🏟️

🇳🇱🇳🇱🇳🇱🇳🇱🇳🇱🇳🇱🇳🇱🇳🇱🇳🇱🇳🇱

#ElMásGrandeDeCa https://t.co/myOZCfylr1",367,44,2019,196452,411,0.21
355,"Viernes de trabajo a doble horario 🏋️‍♀️🏋️‍♀️⚽⚽

¡Juntos, siempre juntos!
🔴⚪🔵🔴⚪🔵🔴⚪🔵

#SomosOlimpia https://t.co/D8Ly7bUkVz",200,19,2019,196452,219,0.11
356,"En el campamento del León sólo se respira alegría 🕺

#SomosFamilia
#SomosOlimpia https://t.co/1nSagkFzBf",342,43,2019,196452,385,0.2
357,"El León sigue y no para 💪🦁

#SomosOlimpia 1️⃣0️⃣7️⃣ https://t.co/eWFcIPlC9v",244,30,2019,196452,274,0.14
358,"Olimpia femenino sigue su marcha al título nacional.🇳🇱🦁

#OlimpiaDeCorazón https://t.co/GBaOOJbDrL",96,9,2019,196452,105,0.05
359,"¡Felicidades Harold! 🎉🎉🎉🎉

Feliz Cumpleaños 🎂🎂🎂 @haroldfonseca_1

¡Porteroo! ¡Porteroo! 🧤🧤

Olimpia es tu casa 🦁

#CumpleañosAlbo https://t.co/UhCalVlIo0",377,24,2019,196452,401,0.2
360,La galería de fotos del triunfo en el Superclásico 📷 https://t.co/EcRT6q5ZKn,119,7,2019,196452,126,0.06
361,Martes de darlo todo 💪🇳🇱 https://t.co/apIESb903x,175,11,2019,196452,186,0.09
362,"El León regresa a casa 🏟️

💵 Sol 70 Lps Sombra 150 Silla 250
🏟 Estadio Nacional
🗓️ 16/10/19
⏲ 7:00 pm 
📺 Tigo Sport 
🏆Liga SalvaVida

Boletos en todos los puntos Tengo.

Niños menores de 12 años no pagan entrada en el sector de Sol. 

Aplica descuento para la tercera edad. https://t.co/dd0sf1Hm2v",248,42,2019,196452,290,0.15
363,"Describe con un emoji a nuestro Pedro.

Nosotros:😍🏆🥇👏🤝🦁🇳🇱

#ElMásGrandeDeCa https://t.co/4hwx1V6c3Y",328,23,2019,196452,351,0.18
364,"Gooooooooooooooooool 

¡Volvelo a cantar! 🔉🔉

 ""Pie de Angel"" 👼

#SomosOlimpia
🇳🇱🇳🇱🇳🇱🇳🇱🇳🇱🇳🇱🇳🇱🇳🇱🇳🇱 https://t.co/HjGTlxUpTl",456,82,2019,196452,538,0.27
365,"Feliz inicio de semana para todo el Olimpismo alrededor del mundo.
☀️☀️

Hacia arriba siempre. ⬆️⬆️

¡Juntos, siempre juntos! 🇳🇱🇳🇱

#SomosOlimpia https://t.co/MlhOYCbNyo",427,50,2019,196457,477,0.24
366,"⏱️95' Finaliza el clásico en Comayagua. 

🦅Motagua  1 - 2 Olimpia 🦁

Goles de:
Matías Garrido
Jorge Bengúche

#SomosOlimpia
#ElMasGrandeDeCA
🇳🇱🇳🇱🇳🇱🇳🇱🇳🇱🇳🇱🇳🇱 https://t.co/MTIiSXjXhr",575,130,2019,196457,705,0.36
367,"⏱93” Cambio en el Olimpia:

✔ Entra: 20 D. Flores
❎ Sale: 10 M. Garrido

#HastaElÚltimoMinuto https://t.co/UeilrKtoIl",36,1,2019,196457,37,0.02
368,"⏱76” Cambio en el Olimpia:

✔ Entra: 30 E. Hernandez
❎ Sale: 9  J. Bengúche

#HastaElÚltimoMinuto https://t.co/p3kJxTNQFD",29,0,2019,196457,29,0.01
369,"⏱64” Cambio en el Olimpia:

✔ Entra: 8 A. Reyes
❎ Sale: 15 E. Rodríguez

#HastaElÚltimoMinuto https://t.co/xNYRleY9bN",27,4,2019,196457,31,0.02
370,"⏰51” ¡Gooooooooolaaaazoooo del Olimpia🦁!

¡Jorge Renan Bengúchee mete el segundoo para el león! 

Motagua 1 - 2 Olimpia 

🦁🦁👏👏🇱🇺🇱🇺🤩
#ElMasGrandeDeCA #HastaElÚltimoMinuto
JORGEEEE RENAN BENGUCHEEEE https://t.co/ho1ZFhrNah",199,37,2019,196457,236,0.12
371,"¡Arranca el segundo tiempo del clásico!

Motagua 1 - 1 Olimpia 

#HastaElÚltimoMinuto",34,0,2019,196457,34,0.02
372,"Final del primer tiempo en Comayagua. 

🦅Motagua  1 - 1 Olimpia 🦁

#SomosOlimpia
#ElMasGrandeDeCA
🇳🇱🇳🇱🇳🇱🇳🇱🇳🇱🇳🇱🇳🇱 https://t.co/mT41klzy2Z",34,2,2019,196457,36,0.02
373,"⏰44”  Marcelo Estigarribia empata el partido para el Motagua.

Motagua 1 - 1 Olimpia 

#HastaElÚltimoMinuto",20,0,2019,196457,20,0.01
374,"⏰29” ¡Goooooooool del Olimpia🦁!

¡Matías Garrido mete el primero para el Olimpia! 

Motagua 0 - 1 Olimpia 

🦁🦁👏👏🇱🇺🇱🇺🤩
#ElMasGrandeDeCA #HastaElÚltimoMinuto https://t.co/VwRWuxaRRk",248,37,2019,196457,285,0.15
375,"🔈 Inicia el clásico en Comayagua:

Motagua - Olimpia

#SomosOlimpia
🔴⚪🔵🔴⚪🔵🔴⚪🔵 https://t.co/S07AktH9iF",51,5,2019,196457,56,0.03
376,"¡Estamos en el Carlos Miranda! 🏟️

🎶Te alentaremos de corazón 🎶

#SomosOlimpia
#ElMásGrandeDeCa https://t.co/tDlYkBavuZ",113,18,2019,196457,131,0.07
377,¡Hoy juega Olimpia 🇳🇱! https://t.co/yxToX1I5fO,305,57,2019,196457,362,0.18
378,"¡Felicidades Prono! 🎉🎉🎉

¡Feliz Cumpleaños a un referente histórico del Club!
🎂🎂🎂🎂🎂🎂🎂🎂

¡Olimpia es tu casa! 🔴⚪🔵

#CumpleañosAlbo https://t.co/J9o5HFjAjS",482,48,2019,196457,530,0.27
379,"¡Mañana hay Superclásico! 

🏟 Estadio Carlos Miranda
🏰 Comayagua 
🗓️ 06/10/19
⏲ 04:00 pm
📺 Deportes Televicentro 
🏆Liga SalvaVida

#SomosOlimpia #LigaSalvaVida
🇳🇱🇳🇱🇳🇱🇳🇱🇳🇱🇳🇱🇳🇱🇳🇱🇳🇱🇳🇱🇳🇱

🔴⚪🔵🔴⚪🔵🔴⚪🔵 https://t.co/TbPB8v8hmO",165,32,2019,196457,197,0.1
380,"🎶Vamos mi león queremos la copa 🎶

#SomosOlimpia
🇳🇱🇳🇱🇳🇱🇳🇱🇳🇱🇳🇱 https://t.co/e8TdyjMYSy",246,34,2019,196457,280,0.14
381,"Definidas las fechas para las semifinales de @Concacaf League.

¡Clásico centroamericano en Sps y San José! 🇭🇳🇨🇷🇳🇱🇱🇻

#SomosOlimpia 🔴⚪🔵
#ElMásGrandeDeCa
#SCL2019
#ConcacafLeague https://t.co/IWpn01EXpO",194,51,2019,196457,245,0.12
382,Comunicado Club Olimpia Deportivo https://t.co/C5H3iJWC7W,141,22,2019,196457,163,0.08
383,⏱️94' Finaliza el encuentro en Guatemala. Comunicaciones 0 - Olimpia 0. Clasificamos a las Semifinales De la Concacaf League. Saprissa será nuestro rival. #ElMasGrandeDeCA #SomosOlimpia https://t.co/ghEPwEgi77,207,44,2019,196457,251,0.13
384,⏱️92 cambio en Comunicaciones. García por Lombardi,17,0,2019,196457,17,0.01
385,"⏱86” Cambio en el Olimpia:
❎Sale: 9 J. Benguche
✔ Entra: 20 Deybi Flores

#HastaElÚltimoMinuto
#ElMasGrandeDeCA https://t.co/suNJeLYRtY",26,2,2019,196457,28,0.01
386,⏱️83' Tiro Libre para @CDOlimpia. J. Álvarez a cobrar,11,0,2019,196457,11,0.01
387,⏱️81' Matías Morales con un tiro directo al marco que el portero saca al tiro de esquina.,16,1,2019,196457,17,0.01
388,"⏱79” Cambio en el Olimpia:
❎Sale: 10 M. Garrido
✔ Entra: 31  M. Morales 

#HastaElÚltimoMinuto
#ElMasGrandeDeCA https://t.co/Zhsh7mlKEu",15,1,2019,196457,16,0.01
389,"⏱️76' Harold Fonseca de nuevo en gran atajada, saca un tiro directo al marco. #ElMasGrandeDeCa",43,8,2019,196457,51,0.03
390,⏱️71' Tiro libre para Olímpia. Falta contra E. Rodríguez.,13,0,2019,196457,13,0.01
391,⏱️69' Tiro libre para Olímpia. Falta contra J. Benguche,18,0,2019,196457,18,0.01
392,"⏱️66' Cambio en Comunicaciones
Entra : Betancourth
Sale : Hernandez",6,0,2019,196457,6,0.0
393,"⏱️58' Cambio en Comunicaciones
 Sale:Galindo
 Entra:Vargas",10,0,2019,196457,10,0.01
394,⏱️52' Benguche falla frente al portero una opción clara de Gol.,16,1,2019,196457,17,0.01
395,"⏱49” Cambio en el Olimpia:
❎Sale: 10  J. Lacayo
✔ Entra:  E. Rodriguez

#HastaElÚltimoMinuto
#ElMasGrandeDeCA https://t.co/zE5vsGUSNe",12,0,2019,196457,12,0.01
396,⏱️47' Junior Lacayo se lesiona y sale del campo.,12,1,2019,196457,13,0.01
397,⏱️45' Inicia el Segundo Tiempo en Guatemala,16,3,2019,196457,19,0.01
398,"⏱️46' Final del primer tiempo en Guatemala:

Comunicaciones 0 - Olimpia 0

#SomosOlimpia
#ElMasGrandeDeCA
🇳🇱🇳🇱🇳🇱🇳🇱🇳🇱🇳🇱🇳🇱 https://t.co/B0rwqcKkCV",39,1,2019,196457,40,0.02
399,⏱️43' Tiro de Esquina para @CDOlimpia Garrido a lanzar.,15,0,2019,196457,15,0.01
400,"⏱️39"" Tarjeta Amarilla para el No 4. Umaña de Comunicaciones por falta clara contra J. Benguche.",15,1,2019,196457,16,0.01
401,⏱️36' Falta contra paton Mejía,7,0,2019,196457,7,0.0
402,"⏱️33"" Tarjeta Amarilla para Jorge Álvarez",8,0,2019,196457,8,0.0
403,⏱️30' Tiro libre para Comunicaciones.,10,1,2019,196457,11,0.01
404,⏱️27' Falta contra Carlitos Pineda,10,0,2019,196457,10,0.01
405,⏱️22' De nuevo Fonseca saca un tiro directo al marco #SomosOlimpia #ElMásGrandeDeCa,33,4,2019,196457,37,0.02
406,"⏱️19' Tarjeta amarilla para el No. 20 - C. Chirino de Comunicaciones 

#SomosOlimpia
🔴⚪🔵🔴⚪🔵🔴⚪🔵",15,0,2019,196457,15,0.01
407,"⏱️11"" Enorme atajada de Harold Fonseca
Comunicaciones 0 - Olimpia 0

#SomosOlimpia
🔴⚪🔵🔴⚪🔵🔴⚪🔵",66,9,2019,196457,75,0.04
408,"🔈 Inicia el partido en el Doroteo Guamuch Flores:

Comunicaciones - Olimpia

#SomosOlimpia
🔴⚪🔵🔴⚪🔵🔴⚪🔵 https://t.co/iGE8styqtB",64,9,2019,196457,73,0.04
409,"🔊Así sale el León hoy #SomosOlimpia #ElMasGrandeDeCA
🔴⚪🔵🔴⚪🔵🔴⚪🔵 https://t.co/YWKNnX17SU",162,39,2019,196457,201,0.1
410,"🔈 Así salimos hoy en Guatemala:

Comunicaciones - Olimpia

#SomosOlimpia #ElMasGrandeDeCA
🔴⚪🔵🔴⚪🔵🔴⚪🔵 https://t.co/xKiqnXcuyC",72,21,2019,196457,93,0.05
411,¡Hoy juega Olimpia 🇳🇱! https://t.co/tSLCXsVp18,347,62,2019,196457,409,0.21
412,"¡Felicidades Patón!

¡Feliz Cumpleaños Germán Mejía!
🎂🎂🎂🎂🎂🎂🎂🎂

¡Olimpia es tu casa!

#CumpleañosAlbo https://t.co/aNXQiiMfiz",250,20,2019,196457,270,0.14
413,Comunicado Club Olimpia Deportivo. https://t.co/cywt8V5m8I,200,48,2019,196457,248,0.13
414,"Declaraciones Prof. Pedro Troglio día de medios.
🎤🎥

#SomosOlimpia https://t.co/6guJ7tHTUv",109,11,2019,196457,120,0.06
415,#NuevaFotoDePerfil,120,15,2019,196457,135,0.07
416,"🎶Será siempre el Olimpia, el orgullo nacional🎶 🇳🇱🇳🇱🇭🇳🇭🇳

🏟 Estadio Doroteo Guamuch Flores
🗓️ 03/10/19
⏲ 8:06pm 
📺 Espn 2 -Fox Sport 2 
🏆Concacaf League
📌 Cuartos de final vuelta

#SomosOlimpia #SCL2019
#ConcacafLeague

🔴⚪🔵🔴⚪🔵🔴⚪🔵 https://t.co/uq7WIV6Fh0",185,50,2019,196457,235,0.12
417,"La galería del triunfo de ayer ante Real de Minas 📷

🇳🇱🇳🇱🇳🇱🇳🇱🇳🇱

https://t.co/Hv1xJtRxvl",121,6,2019,196457,127,0.06
418,"Elegí al León 🦁 del juego de ayer:

A) Eddie Hernández ⚽⚽
B) Jerry Bengtson ⚽⚽
C) Maylor Núñez ⭐

#SomosOlimpia https://t.co/3pH8VxrmoD",165,8,2019,196457,173,0.09
419,"Buenas noches Olimpistas 💤💤

Se viene una semana importante para todos. 🙏🙏

¡Somos millones! 🔴⚪🔵
¡Somos Olimpia!🇳🇱🇳🇱🇳🇱🇳🇱

#ElMásGrandeDeCa https://t.co/Oi4n9r2hzq",236,38,2019,196457,274,0.14
420,"Muchas gracias a todos los fieles de San Pedro Sula.

#SomosOlimpia 🦁🦁🦁 https://t.co/U5krf8wcxB",173,20,2019,196457,193,0.1
421,"Finaliza el partido en San Pedro Sula y nos llevamos la victoria.

Olimpia 5 - 1 Real de Minas 

🦁🦁👏👏🇱🇺🇱🇺🤩
#ElMasGrandeDeCA #HastaElÚltimoMinuto https://t.co/v0kmrGgonl",466,107,2019,196457,573,0.29
422,"⏰84” ¡Gooooooooool del Olimpiaa 🦁!

¡Alejandro Reyes mete el quinto!

Olimpia 5 - 1 Real de Minas 

🦁🦁👏👏🇱🇺🇱🇺🤩
#ElMasGrandeDeCA #HastaElÚltimoMinuto https://t.co/iIRUqSvj06",113,17,2019,196457,130,0.07
423,"⏱82” Cambio en el Olimpia:

✔ Entra: 8 J. Reyes
❎ Sale: 30 E. Hernández

#HastaElÚltimoMinuto https://t.co/EKZptqvtZX",28,2,2019,196457,30,0.02
424,"⏰81” ¡Gooooooooolaaazoooo del León 🦁!

¡Eddie Hernandez con categoría mete el cuarto para el Olimpia! 

Olimpia 4 - 1 Real de Minas 

🦁🦁👏👏🇱🇺🇱🇺🤩
#ElMasGrandeDeCA #HastaElÚltimoMinuto https://t.co/d5axDhC1XV",68,15,2019,196457,83,0.04
425,"⏱75” Tarjeta amarilla para Edwin Rodríguez.

#HastaElÚltimoMinuto",13,1,2019,196457,14,0.01
426,"⏱74” Cambio en el Olimpia:

✔ Entra: 6 B. Beckeles
❎ Sale: 16 J. Leverón

#HastaElÚltimoMinuto https://t.co/ohQnJj3Gf7",18,1,2019,196457,19,0.01
427,"⏱66” Cambio en el Olimpia:

✔ Entra: 32 C. Pineda
❎ Sale: 31 M. Morales

#HastaElÚltimoMinuto https://t.co/5NKSB25QPh",18,1,2019,196457,19,0.01
428,"⏰68” ¡Goooooooool del León 🦁!

¡Jerry Bengston mete el tercero para el Olimpia! 

Olimpia 3 - 1 Real de Minas 

🦁🦁👏👏🇱🇺🇱🇺🤩
#ElMasGrandeDeCA #HastaElÚltimoMinuto https://t.co/2mmdhuZiqb",107,24,2019,196457,131,0.07
429,⏰56” Tarjeta amarilla para Eddie Hernández.,11,0,2019,196457,11,0.01
430,"Gooooooooooooooooool
Gooooooooooooooooool

¡Goleador! ¡Goleador!

Jerry Bengston a los 50'

Olimpia 2 - Real de Minas 1

#SomosOlimpia
🇳🇱🇳🇱🇳🇱🇳🇱🇳🇱🇳🇱🇳🇱🇳🇱🇳🇱 https://t.co/OwvFaQ4YdW",102,16,2019,196457,118,0.06
431,"🕦 Inicia el segundo tiempo en el Metropolitano de Sula

#SomosOlimpia
🇳🇱🇳🇱🇳🇱🇳🇱🇳🇱🇳🇱 https://t.co/PLbNvy38gx",43,2,2019,196457,45,0.02
432,"Final del primer tiempo en el Metropolitano de Sula:

Olimpia 1 - Real de Minas 1

JR Mejía 22'
Eddie Hernández 29'

#SomosOlimpia
🇳🇱🇳🇱🇳🇱🇳🇱🇳🇱🇳🇱🇳🇱 https://t.co/5GmhqBQJu9",44,4,2019,196457,48,0.02
433,"Gooooooooooooool
Gooooooooooooool

Eddie Hernández a los 29' minutos

Olimpia 1 - Real de Minas 1

#SomosOlimpia
🇳🇱🇳🇱🇳🇱🇳🇱🇳🇱🇳🇱 https://t.co/ODt7gGoLuL",99,17,2019,196457,116,0.06
434,"Gol de Real de Minas a los 22'

Juan Ramón Mejía

Olimpia 0 - Real De Minas 1

#SomosOlimpia
🇳🇱🇳🇱🇳🇱🇳🇱🇳🇱🇳🇱🇳🇱🇳🇱",24,2,2019,196457,26,0.01
435,"🕦 12' minutos del primer tiempo

Olimpia 🦁 0 - Real De Minas ⛏️ 0

#SomosOlimpia
🇳🇱🇳🇱🇳🇱🇳🇱🇳🇱🇳🇱🇳🇱",28,1,2019,196457,29,0.01
436,"🔈 Inicia el partido en el Metropolitano de Sula:

Olimpia - Real de Minas

#SomosOlimpia
🔴⚪🔵🔴⚪🔵🔴⚪🔵 https://t.co/fl1vPNa797",52,2,2019,196457,54,0.03
437,"Ganadores de pases dobles al sector de Sol. 🎟️🎟️🎟️🎟️🎟️

@Ralvarado2020 @Garmendia30 @realsandy11 @GabyArchila_ @pescobar95

Reclamar boletos en el portón del sector de Silla. https://t.co/YUqQMBdPok",42,5,2019,196457,47,0.02
438,¡Hoy juega Olimpia 🇳🇱! https://t.co/TnV8pxNOVD,239,41,2019,196457,280,0.14
439,"🎶Casi todos sabemos querer... Pero pocos sabemos amar🎶

Mañana nos volvemos a encontrar con la mejor afición de Centroamérica. ✅✅

#SomosOlimpia
🇳🇱🇳🇱🇳🇱🇳🇱🇳🇱🇳🇱🇳🇱🇳🇱🇳🇱 https://t.co/g44eqGpPur",306,68,2019,196457,374,0.19
440,Club Olimpia Deportivo para medios de comunicación: https://t.co/goxsseggcp,77,16,2019,196457,93,0.05
441,"¡Olimpista! 🙌🙌🙌

El León necesita tu apoyo responsable.

🏟 Estadio Metropolitano
🗓️ 29/09/19
⏲ 5:00 pm 
📺 Tigo Sport
🏆Liga SalvaVida
💵 Sol 80 Lps Sombra 200 Silla 300

Ve por tus boletos a todos los puntos Tengo.

#SomosOlimpia
#OlimpiaResponsable
🇳🇱🇳🇱🇳🇱🇳🇱🇳🇱🇳🇱 https://t.co/xNW9RUcYXi",154,29,2019,196457,183,0.09
442,"¡Tenemos boletos de cortesías de Sol para el juego de mañana ante Real de Minas.! 🎫🎫🎫🎫🎫

Subí tu foto con la camisa del Olimpia desde un punto de la zona norte y participá en el sorteo de pases dobles para ver al León. 
🎟️🎟️🎟️🎟️🎟️🎟️

#SomosOlimpia
🔴⚪🔵🔴⚪🔵🔴⚪🔵 https://t.co/cequ6BtkbY",115,22,2019,196457,137,0.07
443,"Este día nuestros leones se desplazaron hacia Omoa para saborear de una sabrosa sopa.
🏝️🏝️🏝️🏖️🏖️🏖️

¡Juntos, siempre juntos!
🔴⚪🔵🔴⚪🔵🔴⚪🔵

#SomosOlimpia https://t.co/xoYSAS4Vkm",334,30,2019,196457,364,0.19
444,"Olimpia 0501 🔴⚪🔵🔴⚪🔵

🇳🇱🇳🇱🇳🇱🇳🇱🇳🇱🇳🇱🇳🇱🇳🇱🇳🇱

#SomosOlimpia
#ElMásGrandeDeCa https://t.co/PsFDhJs1T0",163,23,2019,196457,186,0.09
445,"¡A pintar de blanco el Metropolitano! 

🎶En la costa nos quieren porque somos el mejor🎶

🏟 Estadio Metropolitano
🗓️ 29/09/19
⏲ 5:00 pm 
📺 Tigo Sport
🏆Liga SalvaVida
💵 Sol 80 Lps Sombra 200 Silla 300

Boletos a la venta en todos los puntos Tengo

#SomosOlimpia
🇳🇱🇳🇱🇳🇱🇳🇱🇳🇱🇳🇱 https://t.co/AAUVYZ09bu",180,34,2019,196457,214,0.11
446,Comunicado Club Olimpia Deportivo para toda nuestra afición: https://t.co/DYg9MbTdOL,410,115,2019,196457,525,0.27
447,"¡San Pedro Sula! 🙌🙌🙌

Seguimos ⬆️⬆️⬆️⬆️

¿Llenamos el Metropolitano el domingo?🏟️🏟️🏟️

Somos Olimpia 🇳🇱🇳🇱

#ElMásGrandeDeCa https://t.co/ytDxoehcJF",210,30,2019,196457,240,0.12
448,"¡Termina el partido en San Pedro Sula y nos vamos con la victoria!

🦁 Olimpia 2 - 0 Comunicaciones

#ElMásGrandeDeCa https://t.co/XfoS6wHUmB",381,111,2019,196457,492,0.25
449,"Amarilla para Carlos Pineda.

¡Seguimos arriba en el marcador!",26,3,2019,196457,29,0.01
450,"⏱80” Cambio en el Olimpia:

❎Sale: 10   M. Garrido
✔ Entra: 31 M. Morales

#HastaElÚltimoMinuto https://t.co/rheUKvAT5W",16,0,2019,196457,16,0.01
451,"⏱72” Cambio en el Olimpia:

❎Sale: 27   J. Bengston
✔ Entra: 12    C. Maidana

#HastaElÚltimoMinuto https://t.co/vjduVaSZpn",22,2,2019,196457,24,0.01
452,"Cambio en Olimpia a los 59' :

Sale:Junior Lacayo
Entra:Edwin Rodríguez

#SomosOlimpia https://t.co/dLgnq9l94T",19,0,2019,196457,19,0.01
453,"⚽ Inicia el segundo tiempo en el Metropolitano:

Olimpia 2 - @CremasOficial 0

#SomosOlimpia",41,4,2019,196457,45,0.02
454,"Termina el primer tiempo y vamos arriba en el marcador.

Olimpia 2 - 0 Comunicaciones 

🦁🦁👏👏🇱🇺🇱🇺🤩
#ElMasGrandeDeCA #HastaElÚltimoMinuto https://t.co/0DYDvKXv6p",151,28,2019,196457,179,0.09
455,"⏰5” ¡Goooooooool del León 🦁!

¡Ever Alvarado mete el segundooooo para el Olimpia! 

Olimpia 2 - 0 Comunicaciones 

🦁🦁👏👏🇱🇺🇱🇺🤩
#ElMasGrandeDeCA #HastaElÚltimoMinuto https://t.co/hbKGvzFXCQ",205,49,2019,196457,254,0.13
456,"1” ¡Goooooooool del León 🦁!

¡Matías Garrido! 

Olimpia 1 - 0 Comunicaciones 

🦁🦁👏👏🇱🇺🇱🇺🤩
#ElMasGrandeDeCA #HastaElÚltimoMinuto https://t.co/UDiGEMjfqk",151,34,2019,196457,185,0.09
457,"¡Arranca el partido de #ConcacafLeague en el Olímpico!

¡Vamos León! https://t.co/5pfwZCPHDR",53,7,2019,196457,60,0.03
458,"📌 Así sale el más grande de Centroamérica está noche ante @CremasOficial

#SomosOlimpia 🇳🇱🇳🇱🇳🇱🇳🇱🇳🇱
#SCL2019 https://t.co/7V2K5N6AJ4",199,43,2019,196457,242,0.12
459,"¡El orgullo nacional!
🇳🇱🇳🇱🇭🇳🇭🇳🇳🇱🇳🇱🇭🇳🇭🇳

🎶 Te alentaremos de corazón 🎶

#ElMásGrandeDeCa https://t.co/HS7gOxqHov",215,29,2019,196457,244,0.12
460,"¡Juntos, siempre juntos! 🔴⚪🔵🔴⚪🔵🔴⚪🔵 https://t.co/YuN34Nd394",136,17,2019,196457,153,0.08
461,"¡Hoy jugamos millones! 

🎶Será siempre el Olimpia, el orgullo nacional🎶 🇳🇱🇳🇱🇭🇳🇭🇳

🏟 Estadio Metropolitano
🗓️ 26/09/19
⏲ 8:00 pm 
📺 Espn 2 
🏆Concacaf League
📌 Cuartos de final ida

#SomosOlimpia #SCL2019

🔴⚪🔵🔴⚪🔵🔴⚪🔵 https://t.co/ZzOqvXOY2F",290,71,2019,196457,361,0.18
462,"¡Día de Cumpleaños doble en el León!  🎉🎉🎉🎉🎉🎉🎉🎉

Feliz Cumpleaños a Edwin Rodríguez y al Chelito @marvinolimpia33
🎂🎂🎂🎂🎂🎂🎂🎂🎂

¡Olimpia es su casa! 🔴⚪🔵🔴⚪🔵

#CumpleañosAlbo https://t.co/RbEEaHWsNx",143,19,2019,196457,162,0.08
463,"¡Feliz miércoles leones! 🦁🦁🦁

El más grande de Centroamérica llega hoy a Sps y vamos a empezar a mandarles las mejores vibras para el partido contra @CremasOficial

¡Juntos, siempre juntos! 🔴⚪🔵

El orgullo nacional 🇭🇳🇭🇳🇭🇳🇭🇳

#SomosOlimpia
#ElOrgulloNacional
#ConcacafLeague https://t.co/ocuehKOfJx",264,42,2019,196457,306,0.16
464,"¡A dar el primer zarpazo! 🦁🦁🦁

🎶Será siempre el Olimpia, el orgullo nacional🎶 🇳🇱🇳🇱🇭🇳🇭🇳

🏟 Estadio Metropolitano
🗓️ 26/09/19
⏲ 8:00 pm 
📺 Espn 2 
🏆Concacaf League
📌 Cuartos de final ida

#SomosOlimpia #SCL2019
#ConcacafLeague

🔴⚪🔵🔴⚪🔵🔴⚪🔵 https://t.co/hi5NdtZzhx",226,50,2019,196457,276,0.14
465,"La galería del triunfo de ayer en el clásico. 
📷📷📷📷📷📷

#SomosOlimpia 
🇳🇱🇳🇱🇳🇱🇳🇱🇳🇱🇳🇱🇳🇱🇳🇱

https://t.co/jkk2jhzhBC",91,11,2019,196457,102,0.05
466,"¡Felicidades Carlitos!
🎉🎉🎉🎉🎉🎉🎉

Feliz Cumpleaños a nuestro medallista de plata Panamericano Carlos Pineda.
🎂🎂🎂🎂🎂🎂🎂🎂🎂

¡Olimpia es tu casa!
🇳🇱🇳🇱🇳🇱🇳🇱🇳🇱🇳🇱🇳🇱🇳🇱🇳🇱🇳🇱

#CumpleañosAlbo https://t.co/xwXPtU12OW",278,25,2019,196457,303,0.15
467,"Buen lunes y feliz semana pueblo Olimpista. ☀️☀️☀️☀️

Semana de Concacaf League 🏆🏆clásico centroamericano vrs @CremasOficial

¡Somos Olimpia! 🔴⚪🔵🔴⚪🔵

#ElMásGrandeDeCa
🇳🇱🇳🇱🇳🇱🇳🇱🇳🇱🇳🇱🇳🇱🇳🇱🇳🇱🇳🇱🇳🇱🇳🇱 https://t.co/gV8qrXHMov",194,35,2019,196457,229,0.12
468,"¡Se pita el final en San Pedro Sula y nos llevamos el gane!

🚂 España 0 - Olimpia 2 🦁

#SomosOlimpia
🇳🇱🇳🇱🇳🇱🇳🇱🇳🇱🇳🇱🇳🇱🇳🇱🇳🇱 https://t.co/ff0CG2kuBH",259,46,2019,196457,305,0.16
469,"⏱72” Cambio en el Olimpia:

❎Sale: 27   J. Bengston
✔ Entra: 20    D. Flores

#HastaElÚltimoMinuto https://t.co/YaNZqTHWtv",25,5,2019,196457,30,0.02
470,Comienza el 2 tiempo en el clásico.,22,2,2019,196457,24,0.01
471,"Jugadota en el primer gol con habilitación de Jerry Bengston para Jorge “El Toro” Bengúche para el primer gol.

#SomosOlimpia
🇳🇱🇳🇱🇳🇱🇳🇱🇳🇱🇳🇱🇳🇱 https://t.co/umGGOzcz9i",240,40,2019,196457,280,0.14
472,"🕙 Final del primer tiempo en el Olímpico Metropolitano y vamos arriba.

🚂 España 0 - Olimpia 2 🦁

#SomosOlimpia
🇳🇱🇳🇱🇳🇱🇳🇱🇳🇱🇳🇱🇳🇱🇳🇱🇳🇱🇳🇱🇳🇱 https://t.co/fIJb8DjXjF",66,12,2019,196457,78,0.04
473,"⏱ 45” ¡Goooooooool del León 🦁!

¡Junior Lacayo pone el segundooo vamosss! 

 Real España 0 - 2 Olimpia

🦁🦁👏👏🇱🇺🇱🇺🤩
#ElMasGrandeDeCA #HastaElÚltimoMinuto https://t.co/htXigKHYkc",109,22,2019,196457,131,0.07
474,"¡HAROOOOOOLD FONSECAAAA rechaza el penal de Jhow Benavides!

Seguimos arriba después del gol del Toro Bengúche.

Real España 0 - 1 Olimpia",262,47,2019,196457,309,0.16
475,"💥 ¡Empieza el partido en San Pedro Sula!

🏟 Estadio Metropolitano 
⏲ 5:00 pm 
📺 Deportes Televicentro
🏆Liga Salvavida

#SomosOlimpia #LigaSalvaVida https://t.co/cQjx8uwf5n",44,4,2019,196457,48,0.02
476,"💥 ¡Empieza el partido en San Pedro! 

🏟 Estadio Metropolitano 
⏲ 5:00 pm 
📺 Deportes Televicentro
🏆Liga Salvavida

#SomosOlimpia #LigaSalvaVida 
🇳🇱🇳🇱🇳🇱🇳🇱🇳🇱🇳🇱🇳🇱🇳🇱🇳🇱🇳🇱 https://t.co/LawM4whSDX",25,3,2019,196457,28,0.01
477,"📝 Así sale el León 🦁 esta tarde en el Metropolitano de San Pedro Sula:

#SomosOlimpia
🇳🇱🇳🇱🇳🇱🇳🇱🇳🇱🇳🇱🇳🇱🇳🇱🇳🇱🇳🇱 https://t.co/FFOmHbLM1m",133,36,2019,196457,169,0.09
478,"¡Hoy juega el más grande de Centroamérica! 🦁🦁🦁🦁🦁

Real España 🚂- Olimpia 🦁

🎶 Te alentaremos de corazón 🎶

🏟 Estadio Metropolitano 
⏲ 5:00 pm 
📺 Deportes Televicentro
📅22/09/19
🏆Liga Salvavida

#SomosOlimpia
🇳🇱🇳🇱🇳🇱🇳🇱🇳🇱🇳🇱🇳🇱🇳🇱🇳🇱🇳🇱 https://t.co/Ykoj86x1Ic",218,35,2019,196457,253,0.13
479,"Hoy trabajamos con todas las energías puestas. 🇳🇱🔴⚪🔵

#HastaElÚltimoMinuto https://t.co/Li6bO4AgX4",189,21,2019,196457,210,0.11
480,"¿Nos caemos? Nos levantamos las veces que sea necesario. ⬆️⬆️⬆️

Real España 🚂 - Olimpia 🦁

¡Somos Olimpia! 🔴⚪🔵🔴⚪🔵

🏟 Estadio Metropolitano
⏲ 5:00 pm 
📺 Deportes Televicentro
📅22/09/19
🏆Liga Salvavida

#ElMásGrandeDeCa
🇳🇱🇳🇱🇳🇱🇳🇱🇳🇱🇳🇱🇳🇱🇳🇱🇳🇱🇳🇱🇳🇱🇳🇱 https://t.co/MkmKA8SMVt",180,29,2019,196457,209,0.11
481,"¡Felicidades Alex!
🎉🎉🎉🎉🎉🎉🎉

Feliz Cumpleaños a nuestro portero y medallista de Plata Panamericano Alex Barrios.
🎂🎂🎂🎂🎂🎂🎂🎂🎂

¡Olimpia es tu casa!
🇳🇱🇳🇱🇳🇱🇳🇱🇳🇱🇳🇱🇳🇱🇳🇱🇳🇱🇳🇱

#CumpleañosAlbo https://t.co/ksgP6BgwIH",195,20,2019,196457,215,0.11
482,"Final en el Excelsior:

#SomosOlimpia
🇳🇱🇳🇱🇳🇱🇳🇱🇳🇱🇳🇱🇳🇱🇳🇱🇳🇱🇳🇱🇳🇱 https://t.co/5WBUKCyz8k",88,20,2019,196457,108,0.05
483,"Tercer cambio en Olimpia a los 88:

Sale:Bryan Beckeles
Entra:Edwin Rodríguez 

#SomosOlimpia
🇳🇱🇳🇱🇳🇱🇳🇱🇳🇱🇳🇱🇳🇱🇳🇱🇳🇱🇳🇱 https://t.co/Kq830ab9gg",6,0,2019,196457,6,0.0
484,"Gol de Platense a los 86'

Platense 2 - Olimpia 1

#SomosOlimpia
🇳🇱🇳🇱🇳🇱🇳🇱🇳🇱🇳🇱🇳🇱🇳🇱",31,6,2019,196457,37,0.02
485,"Cambio en Olimpia a los 77:

Sale:Eddy Hernández 
Entra:Jerry Bengston 

#SomosOlimpia
🇳🇱🇳🇱🇳🇱🇳🇱🇳🇱🇳🇱🇳🇱🇳🇱🇳🇱🇳🇱 https://t.co/eXQ4XTe56h",6,0,2019,196457,6,0.0
486,"Gol de Platense a los 72'

Platense 1 - Olimpia 1

#SomosOlimpia
🇳🇱🇳🇱🇳🇱🇳🇱🇳🇱🇳🇱🇳🇱🇳🇱",14,3,2019,196457,17,0.01
487,"Cambio en Olimpia a los 66':

Sale:Matías Morales
Entra:Elmer Güity

#SomosOlimpia
🇳🇱🇳🇱🇳🇱🇳🇱🇳🇱🇳🇱🇳🇱🇳🇱🇳🇱🇳🇱 https://t.co/IjSNAxefvX",9,4,2019,196457,13,0.01
488,"El Toro 🐃🐃🐃🐃🐃

#SomosOlimpia
🇳🇱🇳🇱🇳🇱🇳🇱🇳🇱🇳🇱🇳🇱 https://t.co/Z6itf31x35",101,12,2019,196457,113,0.06
489,"Gooooooooooooooool
Gooooooooooooooool

Jorge Benguche a los 7' del segundo tiempo

Platense 0 - Olimpia 1 https://t.co/vqS9wuanXG",70,13,2019,196457,83,0.04
490,"🕙 Inicia el segundo tiempo en el Excelsior 

Platense 0 - Olimpia 0 🦈🦁

#SomosOlimpia
🇳🇱🇳🇱🇳🇱🇳🇱🇳🇱🇳🇱🇳🇱🇳🇱🇳🇱🇳🇱🇳🇱 https://t.co/bUmc6KhcJ5",9,2,2019,196457,11,0.01
491,"🕙 Final del primer tiempo en el Excelsior 

Platense 0 - Olimpia 0 🦈🦁

#SomosOlimpia
🇳🇱🇳🇱🇳🇱🇳🇱🇳🇱🇳🇱🇳🇱🇳🇱🇳🇱🇳🇱🇳🇱 https://t.co/gDj6gLC1u9",9,3,2019,196457,12,0.01
492,"🕙 30' minutos del primer tiempo

Platense 0 - Olimpia 0 🦈🦁

#SomosOlimpia
🇳🇱🇳🇱🇳🇱🇳🇱🇳🇱🇳🇱🇳🇱🇳🇱🇳🇱🇳🇱🇳🇱",16,0,2019,196457,16,0.01
493,"🕙 12' minutos del primer tiempo

Platense 0 - Olimpia 0 🦈🦁

#SomosOlimpia
🇳🇱🇳🇱🇳🇱🇳🇱🇳🇱🇳🇱🇳🇱🇳🇱🇳🇱🇳🇱🇳🇱",12,2,2019,196457,14,0.01
494,"¡Inicio el partido en el Excelsior!

#SomosOlimpia https://t.co/qLcz4tC37a",18,2,2019,196457,20,0.01
495,"📝 Así sale el León 🦁 esta noche en el Excelsior:

#SomosOlimpia
🇳🇱🇳🇱🇳🇱🇳🇱🇳🇱🇳🇱🇳🇱🇳🇱🇳🇱🇳🇱 https://t.co/OEg1Qf8XAx",64,21,2019,196457,85,0.04
496,"Desde este punto hasta el final unidos.

¡Juntos, siempre juntos! 🔴⚪🔵

#EstoEsOlimpia
#SomosOlimpia
#ElMásGrandeDeCa

🇳🇱🇳🇱🇳🇱🇳🇱🇳🇱🇳🇱🇳🇱🇳🇱🇳🇱🇳🇱🇳🇱 https://t.co/ge20zmgRkd",264,50,2019,196457,314,0.16
497,"¡Hoy hay carnaval y fiesta en Puerto Cortés! 🎉🎉🎉🎉

🏖️🏝️🏖️🏝️🏖️🏝️⛱️

Platense 🦈 - Olimpia 🦁

🎶 Te alentaremos de corazón 🎶

🏟 Estadio Excelsior
⏲ 7:15 pm 
📺 Deportes Televicentro
📅19/09/19
🏆Liga Salvavida

#ElMásGrandeDeCa https://t.co/xnm2RJ6OKg",182,41,2019,196457,223,0.11
498,"El fútbol es rivalidad no violencia. 🤝🤝

 El fútbol es familias. 👨‍👩‍👧‍👧 

Vivamos el fútbol sin violencia. ⚽

 ¡Juntos, siempre juntos! 🔴⚪🔵🔴⚪🔵🔴⚪🔵 

🦁🦅🦖🦉 

#SomosOlimpia 
#ElMásGrandeDeCa
#ElFútbolEsVida

https://t.co/wORe4dCaNh",119,19,2019,196457,138,0.07
499,"Partido a partido ⚽⚽

¡Juntos, siempre juntos! 🇳🇱🇳🇱🇳🇱

¡Esto es Olimpia! 🔴⚪🔵🔴⚪🔵

#SomosOlimpia
#ElMásGrandeDeCa https://t.co/glZqqeo1oI",224,41,2019,196457,265,0.13
500,"Conferencia de prensa Profesor Pedro Troglio. 🎥

Parte 1

#ElMásGrandeDeCa https://t.co/hpC5WO2tDe",136,20,2019,196457,156,0.08
501,"La galería del empate en el clásico. 📷📷📷📷

Seguimos en la ruta. ⏫⏫⏫

#SomosOlimpia
🇳🇱🇳🇱🇳🇱🇳🇱🇳🇱🇳🇱🇳🇱🇳🇱🇳🇱 https://t.co/2mGJqjve2Z",65,4,2019,196457,69,0.04
502,"¡Pto Cortés recibe al León! 🏖️🏖️

Platense 🦈 - Olimpia 🦁

🎶 Te alentaremos de corazón 🎶

🏟 Estadio Excelsior
⏲ 7:15 pm 
📺 Deportes Televicentro
📅19/09/19
🏆Liga Salvavida

#ElMásGrandeDeCa https://t.co/gBhtlio6lW",150,33,2019,196457,183,0.09
503,"Final del clásico en Comayagua:

Olimpia 1 - Real España 1

#SomosOlimpia 🇳🇱🇳🇱🇳🇱 https://t.co/ayGzf2vvjc",105,11,2019,196457,116,0.06
504,"⏱77” Cambio en el Olimpia:

❎Sale: 27    J. Bengston
✔ Entra:29   G. Mejía 

#HastaElÚltimoMinuto https://t.co/k1L9fogmlX",8,1,2019,196457,9,0.0
505,"⏱76”

⛔Tarjeta roja para Carlos Pineda en el Olimpia.",9,3,2019,196457,12,0.01
506,Le anulan un gol al toro Bengúche en offside.,12,2,2019,196457,14,0.01
507,"⏱51” ¡Logramos el empatee!

¡Jerry Bengstooon!

Olimpia 1 - 1 Real España

🦁🦁👏👏🇱🇺🇱🇺🤩
#ElMasGrandeDeCA #HastaElÚltimoMinuto https://t.co/wLvG8eKsVs",73,6,2019,196457,79,0.04
508,¡¡Penal para el OLIMPIA!!,42,8,2019,196457,50,0.03
509,"Arranca el segundo tiempo.

¡Ruge León! 🦁🦁🦁

#SomosOlimpia 🇳🇱🇳🇱🇳🇱",16,2,2019,196457,18,0.01
510,"Final del primer tiempo en Comayagua:

Olimpia 0 - Real España 1

#SomosOlimpia 🇳🇱🇳🇱🇳🇱🇳🇱 https://t.co/s74Ge737kE",18,1,2019,196457,19,0.01
511,"⏱38”  Gol del España.

#HastaElÚltimoMinuto",6,1,2019,196457,7,0.0
512,"⏱34” Cambio en el Olimpia:

❎Sale: 12   J. Lacayo
✔ Entra: 23    A. Reyes

#HastaElÚltimoMinuto https://t.co/kS4BleZf56",9,1,2019,196457,10,0.01
513,"⏱25” 

Bengúche no logra concretar después de un centro de Rodriguez.

Seguimos empatados 
Cd Olimpia 0-0 Real España",3,2,2019,196457,5,0.0
514,"Arranca el partido en Comayagua contra el España. 

¡Vamos Olimpia! https://t.co/rbKagFeD7Y",41,7,2019,196457,48,0.02
515,"Así sale el León esta noche:

#SomosOlimpia 🇳🇱🇳🇱🇳🇱🇳🇱🇳🇱 https://t.co/qJvMQDMa1Y",113,36,2019,196457,149,0.08
516,"¡Esta noche cueste lo que cueste!
🇳🇱🇳🇱🇳🇱🇳🇱🇳🇱🇳🇱🇳🇱🇳🇱🇳🇱

🎶 Te alentaremos de corazón 🎶

🏟 Estadio Carlos Miranda
⏲ 7:00 pm 
📺 Tigo Sport
📅15/09/19
🏆Liga Salvavida

#ElMásGrandeDeCa https://t.co/0Devt7WXHa",216,31,2019,196457,247,0.13
517,"198 años de Independencia patria. 🎉🎉🎉🎉🎉🎉🎉

Felicidades a todos los hondureños en cada rincón del mundo. 1️⃣9️⃣8️⃣

#SomosHonduras 🇭🇳🇭🇳🇭🇳🇭🇳🇭🇳
#SomosOlimpia 🇳🇱🇳🇱🇳🇱🇳🇱🇳🇱🇳🇱
#198añosdeindependencia https://t.co/XtKRchVRT5",338,62,2019,196457,400,0.2
518,"¡Cueste lo que cueste! 💪💪

🎶Te alentaremos de corazón🎶

¡Juntos, siempre juntos! 🔴⚪🔵

#ElMásGrandeDeCa https://t.co/SNaAHqAgG5",231,23,2019,196457,254,0.13
519,"¡El domingo cueste lo que cueste!
🇳🇱🇳🇱🇳🇱🇳🇱🇳🇱🇳🇱🇳🇱🇳🇱🇳🇱

🎶 Te alentaremos de corazón 🎶

🏟 Estadio Carlos Miranda
⏲ 7:00 pm 
📺 Tigo Sport
📅15/09/19
🏆Liga Salvavida

#ElMásGrandeDeCa https://t.co/YMCPWEfBGK",173,29,2019,196457,202,0.1
520,"A todos los medios de comunicación se les recuerda que el proceso de acreditación para los Cuartos de Final Liga Concacaf Scotiabank 2019 está abierto a través del Centro de Medios de Concacaf. 

Los invitamos a seguir las instrucciones en: https://t.co/1H5ZKyMXzb https://t.co/ZU5djycOcI",40,11,2019,196457,51,0.03
521,"Final en Comayagua:

Olimpia 1 - Platense 2

#SomosOlimpia 🇳🇱🇳🇱🇳🇱🇳🇱 https://t.co/93DkaCt2sZ",56,13,2019,196457,69,0.04
522,"¡Goooooooooool! Jerry Bengston de penal.

Olimpia 1-Platense 2

! Vamos Olimpia!

#SomosOlimpia 🇳🇱🇳🇱🇳🇱🇳🇱 https://t.co/VuPABzvVXc",49,13,2019,196457,62,0.03
523,"Arranca el segundo tiempo con doble cambio en Olimpia:

Sale: Matías Garrido
Sale: Jonathan Ferrari

Entra:Edwin Rodríguez
Entra:Jerry Bengston

¡Ruge León! 🦁🦁🦁

#SomosOlimpia 🇳🇱🇳🇱🇳🇱",15,3,2019,196457,18,0.01
524,"Final del primer tiempo en Comayagua:

Olimpia 0 - Platense 2

¡Ruge León! 🦁🦁🦁

#SomosOlimpia 🇳🇱🇳🇱🇳🇱🇳🇱 https://t.co/KcEST5d5mc",25,3,2019,196457,28,0.01
525,"Gol de Platense a los 26' minutos.

Olimpia 0 - Platense 2

¡Ruge León! 🦁🦁

#SomosOlimpia 🔴⚪🔵",15,2,2019,196457,17,0.01
526,"Gol de Platense a los 9' minutos.

Olimpia 0 - Platense 1

¡Ruge León! 🦁🦁

#SomosOlimpia 🔴⚪🔵",10,3,2019,196457,13,0.01
527,"🕖 Arranca el partido en el Carlos Miranda de Comayagua.

Olimpia 0 - Platense 0

¡Ruge León! 🦁🦁🦁🦁

#SomosOlimpia 🔴⚪🔵 https://t.co/G5RfDCyfax",38,4,2019,196457,42,0.02
528,"Así sale el León esta noche:

#SomosOlimpia 🇳🇱🇳🇱🇳🇱🇳🇱🇳🇱 https://t.co/VSiKJty0KN",96,23,2019,196457,119,0.06
529,"¡¡Felicidades Eduardo Bennett!
🍰🍰🎉🎉🥧🥧

Feliz Cumpleaños a uno de nuestros goleadores históricos.
⚽⚽1️⃣9️⃣

¡Olimpia es tu casa! 
🇳🇱🇳🇱🇳🇱🇳🇱🇳🇱🇳🇱🇳🇱

#CumpleañosAlbo https://t.co/N4vFWmptBy",266,13,2019,196457,279,0.14
530,"¡Hoy jugamos millones!
🇳🇱🇳🇱🇳🇱🇳🇱🇳🇱🇳🇱🇳🇱🇳🇱🇳🇱

🎶 Te alentaremos de corazón 🎶

🏟 Estadio Carlos Miranda
⏲ 7:00 pm 
📺 Tigo Sport
📅11/09/19
🏆Liga Salvavida

#ElMásGrandeDeCa https://t.co/aai9oi6df1",207,36,2019,196457,243,0.12
531,"¡Gran triunfo de la H rumbo al hexagonal! 🎉🎉

¡Juntos, siempre juntos!
🔵⚪🔵⚪🔵⚪🔵⚪🔵⚪

#SomosHonduras
🇭🇳🇭🇳🇭🇳🇭🇳🇭🇳🇭🇳🇭🇳 https://t.co/sUSbSVv0mu",474,59,2019,196457,533,0.27
532,"El León a mantener el liderato🦁🦁

🏟 Estadio Carlos Miranda
⏲ 7:00 pm 
📺 Tigo Sport
📅11/09/19
🏆Liga Salvavida

¡Juntos, siempre juntos! 

#ElMásGrandeDeCa https://t.co/NAkodvevlR",135,22,2019,196457,157,0.08
533,"¡¡Felicidades Capitán!! 💪💪💪💪

Feliz Cumpleaños a nuestro eterno capitán Fabio de Souza Lodeiro. 4️⃣

¡Olimpia es tu casa! 🍰🍰🎉🎉
🇳🇱🇳🇱🇳🇱🇳🇱🇳🇱🇳🇱🇳🇱

#CumpleañosAlbo https://t.co/yCaqAxu6O4",530,55,2019,196457,585,0.3
534,"¡Felicidades niños de Honduras!
🎉🎉🎉🎉🎉🎉🎉🎉🎉🎉🎉

El León más grande de Centroamérica saluda al futuro y presente de nuestro país. 🥧🍰

#SomosOlimpia 🔴⚪🔵🔴⚪🔵
#FelizDiaDelNiño 🇭🇳🇭🇳🇭🇳🇭🇳🇭🇳 https://t.co/IFwUD8RE7G",211,46,2019,196457,257,0.13
535,"Rivales en la cancha familias en los estadios 👨‍👩‍👧‍👧

¡Juntos, siempre juntos!
🔴⚪🔵🔴⚪🔵🔴⚪🔵

#SomosOlimpia
#SomosFamilia https://t.co/bDy0x9UwuA",201,34,2019,196457,235,0.12
536,"Comenzamos la semana con triunfo de Olimpia femenino en el clásico. 👏👏👏👏

Inicio de la Liga Mayor 🏆

Yendi Martínez ⚽⚽
Noelia Hernández ⚽
🔴⚪🔵🔴⚪🔵🔴⚪🔵

#OlimpiaDeCorazón
🇳🇱🇳🇱🇳🇱🇳🇱🇳🇱🇳🇱🇳🇱 https://t.co/ZmRAO2Frht",132,22,2019,196457,154,0.08
537,"¿Que tal su domingo sin ellos? 😴🤒📴

🔴⚪🔵 https://t.co/WYu9oB9OCf",214,17,2019,196457,231,0.12
538,"Sábado de entrenamiento del León. 🦁🦁🦁🦁🦁

#SomosOlimpia 🇳🇱🇳🇱🇳🇱🇳🇱 https://t.co/iAGic9DK5Z",289,28,2019,196457,317,0.16
539,"Sin descanso seguimos en la ruta 👊👊👊👊

#SomosOlimpia 🇳🇱🇳🇱🇳🇱🇳🇱 https://t.co/deCKwXubh2",259,23,2019,196457,282,0.14
540,"¡Felicidades Bengu! ⚽⚽

Doblete en el debút con la H 🦁🦁

#SomosHonduras
🇭🇳🇭🇳🇭🇳🇭🇳🇭🇳🇭🇳🇭🇳 https://t.co/mVpTL6SEMr",463,59,2019,196457,522,0.27
541,"Cuando te das cuenta que el León no jugará el fin de semana 😢😢😢

#ElMásGrandeDeCa 
#SomosOlimpia
#Lacayito

📷📷📷📷📷📷📷📷📷 https://t.co/BTAn1NTnaY",241,37,2019,196457,278,0.14
542,"¡Buen jueves para todo el Olimpismo! ☀️☀️☀️

Acá se trabaja con alegría y optimismo 🦁🦁🦁

¡Somos Olimpia!

#ElMásGrandeDeCa https://t.co/kRAwz7kZgf",235,25,2019,196457,260,0.13
543,"¡Feliz Cumpleaños a nuestro León legionario! 🎉🎉🎉

Felicidades @boniek1426

¡Olimpia es tu casa!

#CumpleañosAlbo https://t.co/IVhvfDZi9h",380,32,2019,196457,412,0.21
544,"Buen miércoles Olimpistas 💪💪

¿Que se hace cuando no juega Olimpia un fin de semana? 😴😴

#TeExtrañamosOlimpia
#SomosOlimpia https://t.co/hsnhTwPhsN",180,21,2019,196457,201,0.1
545,"La galería del triunfo de las reservas el día de ayer 3-0 sobre Real de Minas. 📷📷📷

👇👇👇👇👇👇👇

#LaReserva
#SomosOlimpia https://t.co/SCeANqcfXp",138,16,2019,196457,154,0.08
546,"""El Cerebro"" Jorge Álvarez 🧠

Dale Me Gusta ❤️ Si crees que es espectacular o Rt 🔄 Si crees que es único.

#SomosOlimpia 🇳🇱🇳🇱🇳🇱 https://t.co/yjYUgqVlB2",528,57,2019,196457,585,0.3
547,"Ponelo en tu agenda 🗓️🗓️

Cuartos de final Concacaf League 📌📌📌📌

#SomosOlimpia 🇳🇱🇳🇱🇳🇱🇳🇱
#ConcacafLeague https://t.co/LeL7RBIgbd",240,57,2019,196457,297,0.15
548,"Felicidades @Mauriciodubon10 por tu primer Home Run en @LasMayores.
🇭🇳🇭🇳🇭🇳🇭🇳🇭🇳🇭🇳🇭🇳🇭🇳

Nos sentimos orgullosos de vos 👋

#OrgullososDeSerHondureños https://t.co/ZLnQ19PK5G https://t.co/KEAHcY5r4Q",570,102,2019,196457,672,0.34
549,"La galería del triunfo y liderato ayer en Danlí. ⬆️⬆️⬆️⬆️⬆️

#SomosOlimpia 🇳🇱🇳🇱🇳🇱🇳🇱

👇👇👇👇👇👇 https://t.co/OUJAKHrKqI",195,25,2019,196457,220,0.11
550,"Lo ganamos en el Marcelo Tinoco y mantenemos nuestro invicto. 

¡Vamos Olimpia!

#ElMasGrandeDeCa https://t.co/EKvAXcsTIp",202,39,2019,196457,241,0.12
551,"Minuto 92: TAPADON de Harold Fonseca.

#ElMasGrandeDeCa #Minuto",84,9,2019,196452,93,0.05
552,"Gooooooool, grande capitán, al minuto 88 Ever Alvarado manda la pelota al fondo desde el punto penal. ¡Vamos Olimpia!

#ElMásGrandedeCa https://t.co/9gfLlIUPQ9",95,10,2019,196452,105,0.05
553,"Minuto 87: Penal a favor nuestro.

¡Vamos Olimpia, Vamos muchachos por los 3 puntos!

#ElMasGrandeDeCa #MinutoAMinuto",38,1,2019,196452,39,0.02
554,"Minuto 78: Gol anulado a Eddie Hernandez por mano.

#ElMasGrandeDeCa #MinutoAMinuto",25,0,2019,196452,25,0.01
555,"Minuto 71: Sale Junior Lacayo Entra Rembrandt Flores

¡Vamos Olimpia!

#ElMásGrandedeCa https://t.co/vmIPyQqJE3",19,1,2019,196452,20,0.01
556,"Minuto 65: Sale Jerry Bengtson Entra Jorge Benguché

¡Vamos Olimpia!

#ElMásGrandedeCa #MinutoAMinuto",7,0,2019,196452,7,0.0
557,Minuto 63: Real de Minas empata mediante tiro penal.,10,0,2019,196452,10,0.01
558,Minuto 62: Penal a favor de Real de Minas.,10,0,2019,196452,10,0.01
559,"Minuto 58: Lacayo a punto de anotar el segundo para Olimpia.

#ElMasGrandeDeCa #MinutoAMinuto",9,1,2019,196452,10,0.01
560,"Minuto 57: Gran tapada de Harold Fonseca.

#ElMasGrandeDeCa #MinutoAMinuto",18,0,2019,196452,18,0.01
561,"Nos vamos al descanso, lo ganamos 1-0.

¡Vamos Olimpia!

#ElMásGrandedeCa https://t.co/XLwrO7G47n",33,1,2019,196452,34,0.02
562,"Minuto a minuto: Se agregam 3 minutos de descuento para el primer tiempo.

#ElMasGrandeDeCA #HastaElÚltimoMinuto #MinutoaMinuto",24,0,2019,196452,24,0.01
563,"Al minuto 38 por lesión sale Mayor Núñez y entra Elvin Casildo.

#ElMásGrandedeCa https://t.co/BqbONhbaHA",17,1,2019,196452,18,0.01
564,"Al minuto 28 gol anulado por posición adelantada de Junior Lacayo.

#ElMásGrandeDeCA #HastaElÚltimoMinuto",14,2,2019,196452,16,0.01
565,"Goooooooolaaaaaaazooooooo de Eddie Hernandez despues de una gran habilitación de Jorge Alvarez!

¡Vamos Olimpia! https://t.co/KUEEZ8lQO4",187,35,2019,196452,222,0.11
566,Así estamos jugando hoy. https://t.co/ioBcp0CbNp,85,12,2019,196452,97,0.05
567,Arranca el partido en el Marcelo Tinoco de Danlí. ¡Vamos Olimpia! https://t.co/wqslCYKNjx,42,4,2019,196452,46,0.02
568,"A pintar de blanco Danlí 🦁🦁🦁

🏟 Estadio Marcelo Tinoco
⏲ 3:30pm
📺 Deportes Tvc
📅01/09/19
🏆Liga Salvavida

¡Juntos, siempre juntos! https://t.co/OYcX3W9nJ8",79,5,2019,196452,84,0.04
569,"A pintar de blanco Danlí 🦁🦁🦁

🏟 Estadio Marcelo Tinoco
⏲ 3:30pm
📺 Deportes Tvc
📅01/09/19
🏆Liga Salvavida

¡Juntos, siempre juntos! https://t.co/0Xi7hMVnaH",122,21,2019,196452,143,0.07
570,"La ruta nos lleva a Danlí 🦁🦁🦁

🏟 Estadio Marcelo Tinoco
⏲ 3:30pm
📺 Deportes Tvc
📅01/09/19
🏆Liga Salvavida

¡Juntos, siempre juntos! https://t.co/qYBsBe2WXI",191,27,2019,196452,218,0.11
571,Este día el Club recibió esta comunicación por parte de @Concacaf https://t.co/SNHMAPIDVD,126,31,2019,196452,157,0.08
572,Felicitamos en su 91 aniversario al FC Motagua. @motagua https://t.co/HanFK54U5G,519,53,2019,196452,572,0.29
573,"¡Final del partido, logramos remontar!

Olimpia 4 - 1 Forge

Goles:
Jonathan Ferrari
Deiby Flores
Junior Lacayo
Jerry Bengston

🦁🦁👏👏🇫🇷🇫🇷🤩

#ElMasGrandeDeCA #HastaElÚltimoMinuto https://t.co/LRtRzbdnPs",498,122,2019,196452,620,0.32
574,"⏱88” Gol del Forge..

Olimpia 4 - 1 Forge

#ElMasGrandeDeCA #HastaElÚltimoMinuto",59,5,2019,196452,64,0.03
575,"⏱78” ¡Jerry Bengston mete el cuarto de taquito!

Olimpia 4 - 0 Forge

🦁🦁👏👏🇱🇺🇱🇺🤩
#ElMasGrandeDeCA #HastaElÚltimoMinuto https://t.co/GafQQxk4pI",141,35,2019,196452,176,0.09
576,"⏱74” ¡Cae el tercero del Olimpia!
 ¡Junior Lacayo anota de cabeza para Olimpiaa!

Olimpia 3 - 0 Forge

🦁🦁👏👏🇱🇺🇱🇺🤩
#ElMasGrandeDeCA #HastaElÚltimoMinuto https://t.co/cvVTjiY1LT",121,23,2019,196452,144,0.07
577,"⏱73” Cambio en el Olimpia:

❎Sale: 9   J. Benguché
✔ Entra: 27   J. Bengston

#HastaElÚltimoMinuto https://t.co/ri7skB2SUg",20,1,2019,196452,21,0.01
578,"⏱66” Cambio en el Olimpia:

❎Sale: 12   C. Maidana
✔ Entra: 23    J. Alvarez

#HastaElÚltimoMinuto https://t.co/XKCgv4Dte9",12,0,2019,196452,12,0.01
579,"⏱59” Cambio en el Olimpia:

❎Sale: 10   M. Garrido
✔ Entra: 8    J. Reyes

#HastaElÚltimoMinuto https://t.co/cEXjGDliiU",13,0,2019,196452,13,0.01
580,"Termina la primera mitad en San Pedro Sula y vamos arriba en el marcador.

Olimpia 2 - 0 Forge 
🦁🦁🇫🇷🇫🇷
#ConcacafLeague
#HastaElÚltimoMinuto https://t.co/9DbjqgyYaq",103,18,2019,196452,121,0.06
581,"⏱41” ¡¡Goooolaaaazoooo del León!! 
¡Un misil al anguloooo!
 ¡Deiby Flores mete el segundo para Olimpiaa!!

Olimpia 2 - 0 Forge

🦁🦁👏👏🇱🇺🇱🇺🤩
#ElMasGrandeDeCA https://t.co/c5aAV6KmqP",211,49,2019,196452,260,0.13
582,"⏱29” ¡¡Gooool del León!!
 ¡Jonathan Ferrari mete el primero para Olimpiaa!!

Olimpia 1 - 0 Forge

🦁🦁👏👏🇱🇺🇱🇺🤩
#ElMasGrandeDeCA #HastaElÚltimoMinuto https://t.co/vwKG1uqIzb",247,57,2019,196452,304,0.15
583,"¡Arrancamos contra el FORGE en el partido de vuelta!

¡Vamos por la remontada!
🦁🦁🇫🇷🇫🇷
#ElMasGrandeDeCA 
¡¡Vamos Olimpia!! https://t.co/wEngzJt9ps",81,10,2019,196452,91,0.05
584,Así sale el León esta noche. #Concacafleague #ElMásGrandeDeCa https://t.co/etKIrwm2lU,179,37,2019,196452,216,0.11
585,"Hoy jugamos millones 🦁🦁🦁🦁

🏟 Estadio Olímpico SPS
⏲ 8:00 pm
📺 Fox Sports 3
📅29/08/19
🏆Liga Concacaf

¡Juntos,Siempre Juntos! https://t.co/JbzLfLdOxn",196,45,2019,196452,241,0.12
586,El sueño de todos nosotros es clasificar... Vamos Olimpia.. Que SI se puede! Juntos...Siempre Juntos. #ElMásGrandeDeCa https://t.co/qerCvybuCy,374,90,2019,196452,464,0.24
587,"Reconocimiento Estadio Olimpico Metropolitano 🏟🏟

#ConcacafLeague
#SomosOlimpia https://t.co/DvVShcV4OE",179,20,2019,196452,199,0.1
588,"El Club Deportivo Olimpia agradece a Coca-Cola y al personal del Hotel Copantl por el recibimiento este día en San Pedro Sula.

#SomosOlimpia #ElMásGrandeDeCA https://t.co/SEK6CfIYnH",212,29,2019,196452,241,0.12
589,"¡Estos son nuestros convocados a la H! 🇭🇳 

Orgullosos del llamado de nuestros jugadores a la Selección Mayor.

 #ElMasGrandeDeCA https://t.co/oglIcWUEiS",247,38,2019,196452,285,0.15
590,"El León ya está en San Pedro Sula y nuestro patrocinador @CocaCola_HN le tenía preparada una sorpresa a los jugadores a su arribo. ✌😎

#SomosOlimpia #SienteElSabor https://t.co/IqWpdkEtSU",331,51,2019,196452,382,0.19
591,"El león ya está camino a San Pedro Sula 🚌🚌 con las buenas vibras para la remontada. 🦁💪

#SomosOlimpia https://t.co/86UFN862KS",354,50,2019,196452,404,0.21
592,"Alegria y optimismo en el campamento del más grande.🥳🥳

Mañana rumbo a San Pedro Sula por la remontada.🚌🚌🚌

¡Juntos,Siempre Juntos! 🇳🇱🇳🇱🇳🇱🇳🇱

#ElMásGrandeDeCa https://t.co/DuPCIr7P3u",228,33,2019,196452,261,0.13
593,"!El León por la remontada! 👊👊

A puerta cerrada pero nunca solos 🔴⚪🔵

Juntos,Siempre Juntos! 🇱🇺🇱🇺🇱🇺

#SomosOlimpia
#ElMàsGrandeDeCa https://t.co/hUAm117Go9",192,31,2019,196452,223,0.11
594,Con tu emoji favorito describe a Chaco Maidana🎩🎩🎩 #SomosOlimpia 🇱🇺🇱🇺🇱🇺 https://t.co/PuBKWxNU5x,413,35,2019,196452,448,0.23
595,"¡Olimpia Femenino clasifica a la Gran Final nacional! 🏆🏆

Con global de 5-4 nuestras chicas se clasificaron a una nueva Final.🦁🦁🦁

¡Vamos Olimpia!

#OlimpiaDeCorazón https://t.co/Sw28Htmoxl",120,12,2019,196452,132,0.07
596,"Felicidades Axel Gomez y Eddie Hernandez por su primer gol con la camiseta del más grande de Centroamérica. ⚽️

#ElMásGrandeDeCa https://t.co/GoWqXGsJ4f",282,29,2019,196452,311,0.16
597,Lideres en Twitter a nivel nacional gracias a los millones de Olimpistas. https://t.co/q3RSJNytDH,191,31,2019,196452,222,0.11
598,"Feliz inicio de semana Olimpista 🤗🤗

Las imágenes que nos dejó el triunfo ayer en Choluteca. 🇱🇺🇱🇺🇱🇺🇱🇺

¡Juntos,Siempre Juntos! 👐👐

#SomosOlimpia https://t.co/cTsXLN0mQu",235,27,2019,196452,262,0.13
599,"¡Final del partido, nos regresamos con 3 puntos de Choluteca!

Lobos UPN 0 - 2 Olimpia

Goles:
Eddy Hernandez
Axel Gomez

🦁🦁👏👏🇫🇷🇫🇷🤩

#ElMasGrandeDeCA #HastaElÚltimoMinuto https://t.co/3Jh2crM86F",251,55,2019,196452,306,0.16
600,"⏱75” Cambio en el Olimpia:

❎Sale: 12   C. Maidana
✔ Entra: 29    G. Mejía

#HastaElÚltimoMinuto https://t.co/BHKfZI0CqU",27,1,2019,196452,28,0.01
601,"⏱66” ¡¡Goooolaaazoooo del León!!
 ¡Axel Gomez mete el segundo para Olimpiaa!!

Lobos UPN 0 - 2 Olimpia

🦁🦁👏👏🇱🇺🇱🇺🤩
#ElMasGrandeDeCA #HastaElÚltimoMinuto https://t.co/FhaoWjvCrz",110,17,2019,196452,127,0.06
602,"⏱64” Cambio en el Olimpia:

❎Sale: 8   J. Reyes
✔ Entra: 14     J. Lacayo

#HastaElÚltimoMinuto https://t.co/TSd0d0JXWz",14,2,2019,196452,16,0.01
603,¡Arranca el segundo tiempo en el estadio Emilio Williams!,37,4,2019,196452,41,0.02
604,"Termina la primera mitad en Choluteca.

Lobos UPN 0 - 1 Olimpia

🦁🦁🇫🇷🇫🇷
#SomosOlimpia #HastaElÚltimoMinuto https://t.co/dTVgRqHaqO",42,4,2019,196452,46,0.02
605,https://t.co/LYMBcDpcZV,101,13,2019,196452,114,0.06
606,"⏱24” Cambio en el Olimpia:

❎Sale: 2     J. Paz
✔Entra: 25     E. Casildo

#HastaElÚltimoMinuto https://t.co/y6DMb9nmz6",16,3,2019,196452,19,0.01
607,Arrancamos en Choluteca! #ElMasGrandeDeCA Vamos Olimpia!!! https://t.co/0fxTCQKWkV,33,2,2019,196452,35,0.02
608,Así sale #ElMasGrandeDeCA hoy!  Vamos que si se puede! Juntos.. Siempre Juntos! https://t.co/X5go0KRAji,106,30,2019,196452,136,0.07
609,"El León ya en camino para el Estadio... Juntos, Siempre Juntos! #ElMasGrandeDeCA https://t.co/hXaNFZHGuv",57,8,2019,196452,65,0.03
610,Levántate Choluteca! Que llego #ElMasGrandeDeCA. Vamos Leones! Por ese triunfo de hoy! https://t.co/xZoWjIUJ8s,199,30,2019,196452,229,0.12
611,"Seguimos trabajando para alcanzar el objetivo 💪💪💪

¡Juntos Somos Más Fuertes! 🇱🇺🇱🇺🇱🇺

#SomosOlimpia https://t.co/jsaCwEVxWq",277,28,2019,196452,305,0.16
612,"¡Juntos,Siempre Juntos!

#ElMásGrandeDeCa https://t.co/RsizEmm12O",158,19,2019,196452,177,0.09
613,"El León se traslada a Choluteca para recuperar el liderato.🦁🦁🦁🦁

🏟 Estadio Emilio Williams
⏲ 6:00 pm
📺 Deportes TVC 
📅25/08/19
🏆Liga SalvaVida

¡Juntos,Siempre Juntos!

#SomosOlimpia https://t.co/fkbY2W3hJK",164,29,2019,196452,193,0.1
614,"Final en el Tim Hortons Field de Canadá 🕐

Forge Fc 1 - Olimpia 0

¡Juntos,Siempre Juntos! 🇱🇺🇱🇺🇱🇺

#SomosOlimpia https://t.co/ykOzNk9Tbu",81,18,2019,196452,99,0.05
615,"🕐81"" cambio en Olimpia:

Sale:Junior Lacayo
Entra: Matias Morales

#SomosOlimpia",7,0,2019,196452,7,0.0
616,"🕐72"" cambio en Olimpia:

Sale: Jonathan Ferrari
Entra: Ovidio Lanza

#SomosOlimpia",7,0,2019,196452,7,0.0
617,"🕐66"" cambio en Olimpia:

Sale:Matias Garrido
Entra: Cristhian Maidana

#SomosOlimpia",17,1,2019,196452,18,0.01
618,"Inicia el segundo tiempo en el Tim Hortons Field de Canadá:

Forge Fc 1 - Olimpia 0

¡Juntos,Siempre Juntos!🇱🇺🇱🇺🇱🇺

#SomosOlimpia https://t.co/Si65rACEkJ",17,2,2019,196452,19,0.01
619,"Final del primer tiempo en el Tim Hortons Field de Canadá:

Forge Fc 1 - Olimpia 0

¡Juntos,Siempre Juntos!🇱🇺🇱🇺🇱🇺

#SomosOlimpia https://t.co/AwxmNkoEeT",30,4,2019,196452,34,0.02
620,"🕐23 minutos lo falla Ever Alvarado.

#SomosOlimpia",21,2,2019,196452,23,0.01
621,"¡Penaaaaaaal!! a favor del Olimpia a los 22"" minutos del primer tiempo.

¡Vamos Olimpia!",50,4,2019,196452,54,0.03
622,"🕐Gol del Forge Fc a los 3 minutos.

#SomosOlimpia",14,5,2019,196452,19,0.01
623,"Inicia el partido en el Tim Hortons Field de Canadá

¡Juntos,Siempre Juntos!

#SomosOlimpia https://t.co/NWzb5Pao4d",32,7,2019,196452,39,0.02
624,"¡Estamos listos! El León ya realizó los trabajos de calentamiento.💪💪💪

¡Juntos,Siempre Juntos! 🇱🇺🇱🇺

#Somos Olimpia https://t.co/f9gYkOWDr2",132,25,2019,196452,157,0.08
625,"Comunicado Club Olimpia Deportivo:

Ingresar al siguiente Link: https://t.co/vK2DTQGUTv https://t.co/NCjPTKeIsz",97,29,2019,196452,126,0.06
626,"Muchas gracias por los deseos a nuestro Club Hermano @MOTAGUAcom y Felicidades por dar el primer paso en la Concacaf League.

#MásPazMásFutbol
#PorHonduras https://t.co/dFkzb2gysZ",1324,248,2019,196452,1572,0.8
627,"¡Olimpia somos millones! !Hoy jugamos! 🏆🏆🏆

🏟 Tim Hortons Field 🇨🇦
⏲ 6:00 pm 
📺 Fox Sports 2

¡Juntos,Siempre Juntos! 🇱🇺🇱🇺🇱🇺

#SomosOlimpia https://t.co/bDBQFJBQQs",252,54,2019,196452,306,0.16
628,"Reconocimiento al Tim Hortons Field de Hamilton,Canada.🇨🇦🇨🇦🇨🇦

¡Juntos,Siempre Juntos! 🤝🤝

#SomosOlimpia https://t.co/vWYdkH5MY3",208,32,2019,196452,240,0.12
629,"El León debuta en la Concacaf League.🦁

🏟 Tim Hortons Field 🇨🇦
⏲ 6:00 pm 
📺 Fox Sport 2 

 ¡Juntos,Siempre Juntos! 🇱🇺🇱🇺🇱🇺

#SomosOlimpia https://t.co/Q4COefWKad",274,50,2019,196452,324,0.16
630,Esta es la plantilla que viaja a Canada por la Concacaf League. 🇱🇺🇱🇺🇱🇺🇱🇺 https://t.co/axdGha0uk2,257,55,2019,196452,312,0.16
631,Comunicado Club Olimpia. https://t.co/C7G2uNjjz8,133,23,2019,196452,156,0.08
632,Comunicado Club Olimpia Deportivo | https://t.co/i3Ch5NhqYY https://t.co/1jP4JhJIRL,200,49,2019,196452,249,0.13
633,Comunicado del Club Olimpia Deportivo. https://t.co/XG8zUrXrjY,379,100,2019,196452,479,0.24
634,"Olimpia Femenino, ahora por título inter-regional 🏆🏆🏆

Como equipo campeón de la Regional Centro enfrentará al Juventus, equipo campeón de la Regional Sur. 

Partido de ida: 

🏟 Estadio Birichiche 
🗓 Domingo 18 de agosto 2019
⏲ 10:00 am

#OlimpiaDeCorazón 
#OlimpiaFemenino",52,3,2019,196452,55,0.03
635,"Olimpista, necesitamos tu apoyo responsable.

Somos ¡la mejor afición de Centroamérica!
#SomosOlimpia 🔴⚪🔵🔴⚪🔵 https://t.co/3iXBDEIhAp",178,37,2019,196452,215,0.11
636,"¿Están listos?

Te esperamos esta noche en el Nacional para pintarlo de blanco. 

💵 Sol L80 Sombra L150 Silla L400

NIÑOS MENORES DE 12 AÑOS ENTRAN GRATIS AL SECTOR DE SOL ACOMPAÑADOS DE UN ADULTO.

#SomosOlimpia 🔴⚪🔵🔴⚪🔵 https://t.co/qXwGtKhtLs",209,36,2019,196452,245,0.12
637,"🎶Esta campaña volveremos a estar contigo🎶

Fiesta tricolor en el Nacional 🔴⚪🔵

#SomosOlimpia https://t.co/LakBFaxO3u",225,38,2019,196452,263,0.13
638,"¡Listos para el Superclásico! 👊👊👊

#SomosOlimpia 🇱🇺🇱🇺🇱🇺🇱🇺 https://t.co/mpEYw0p9G7",314,33,2019,196452,347,0.18
639,"Se lleva a cabo en este momento conferencia de prensa sobre la seguridad de cara al Superclásico de mañana. 📽

@lnphonduras
@PoliciaHonduras

#SomosOlimpia https://t.co/h5XRcZT3ak",104,16,2019,196452,120,0.06
640,"¡Feliz viernes Olimpistas! 🕺🎉

Mañana nuestra cita es en el Nacional para pintarlo de blanco. 

💵 Sol 80 Sombra 150 Silla 400

NIÑOS MENORES DE 12 AÑOS ENTRAN GRATIS AL SECTOR DE SOL ACOMPAÑADOS DE UN ADULTO.

Boletos a la venta en puntos Tengo

#SomosOlimpia 🔴⚪🔵🔴⚪🔵 https://t.co/aSiH5V6y7Z",222,35,2019,196452,257,0.13
641,"Así se vivió el penal atajado por @haroldfonseca_1 🧤🥅

#SomosOlimpia 🇱🇺🇱🇺🇱🇺 https://t.co/BqADqohd9H",387,51,2019,196452,438,0.22
642,"¡El superclásico lo jugamos millones! 🔴⚪🔵
 
🏟 Estadio Nacional
⏲ 7:30 pm
📺 Deportes TVC 
💵 Sol 80 Sombra 150 Silla 400

NIÑOS MENORES DE 12 AÑOS ENTRAN GRATIS AL SECTOR DE SOL ACOMPAÑADOS DE UN ADULTO.

Boletos a la venta en puntos Tengo

#SomosOlimpia https://t.co/5L0l1UEAz8",202,58,2019,196452,260,0.13
643,"La galería del triunfo de anoche ante el Vida.👏👏

¡Nos vemos el sábado en el Nacional! 🏟🇱🇺🇱🇺

#SomosOlimpia https://t.co/BzIhRP23MA",161,17,2019,196452,178,0.09
644,"A todos los medios de comunicación que aún no han realizado el proceso de acreditación de medios para la Liga Concacaf Scotiabank 2019, los invitamos a seguir las instrucciones indicadas en el siguiente enlace: https://t.co/qeKWZxIfeH https://t.co/dCiXM6yULy",52,7,2019,196452,59,0.03
645,"Agradecemos al Olimpismo por acompañarnos esta noche en este encuentro tan importante.

¡Juntos,Siempre Juntos! 🔴⚪🔵

#SomosOlimpia https://t.co/zxSYaDjnnq",203,27,2019,196452,230,0.12
646,"¡Final del partido, nos llevamos los 3 puntos!

Olimpia 1 - 0 Vida

Goles:
J. Bengúche

🦁🦁👏👏🇫🇷🇫🇷🤩

#ElMasGrandeDeCA #HastaElÚltimoMinuto https://t.co/o3gFXnfpT9",160,32,2019,196452,192,0.1
647,"¡¡HAROLD FONSECAAAA EVITA EL EMPATEEE!!

Olimpia 1 - 0 Vida

🦁🦁🇫🇷🇫🇷
#SomosOlimpia #HastaElÚltimoMinuto",227,28,2019,196452,255,0.13
648,"Penal para el vida.

#HastaElÚltimoMinuto
#SomosOlimpia",12,1,2019,196452,13,0.01
649,"⏱70” Cambio en el Olimpia:

❎Sale: 2 Maylor Nuñez
✔️Entra: 29 Paton Mejía

#HastaElÚltimoMinuto https://t.co/wG0N5axJo6",11,0,2019,196452,11,0.01
650,"⏱63” ¡¡Goooolaaazoooo del León!!
 ¡ El TORO Bengúche anota el primero del Olimpiaa!!

Olimpia 1 - 0 Vida

🦁🦁👏👏🇱🇺🇱🇺🤩
#ElMasGrandeDeCA #HastaElÚltimoMinuto https://t.co/cGb7lWmOJ2",114,24,2019,196452,138,0.07
651,"¡Arranca el segundo tiempo en Tegucigalpa!

¡Dale, dale, dale dale leóon!

#SomosOlimpia",27,4,2019,196452,31,0.02
652,"Termina la primera mitad en el Nacional de Tegucigalpa.

Olimpia 0 - Vida 0 

🦁🦁🇫🇷🇫🇷
#SomosOlimpia #HastaElÚltimoMinuto https://t.co/aVpibsOKtp",42,6,2019,196452,48,0.02
653,Comunicado Club Olimpia Deportivo: https://t.co/FBntbNnJdB https://t.co/7jImXdIqNH,133,47,2019,196452,180,0.09
654,"¡Arranca el partido!

¡Vamos a rugir! 🦁🦁🦁

#SomosOlimpia https://t.co/zDUVeQzlR5",59,6,2019,196452,65,0.03
655,"¡La alineación contra el VIDA! ⚽️⚽️

¡Vamos por esos 3 puntos en casa! 🏟🏟

#SomosOlimpia 🇱🇺🇱🇺🇱🇺🇱🇺🇱🇺 https://t.co/Slfbj5Ncz9",122,21,2019,196452,143,0.07
656,"¡Listos para hoy! ⚽️⚽️

Nos vemos en el Nacional 🏟🏟

#SomosOlimpia 🇱🇺🇱🇺🇱🇺🇱🇺🇱🇺 https://t.co/3k6BVmLcHI",193,29,2019,196452,222,0.11
657,"¡Hoy juega Olimpia! 🦁🦁🦁

Hoy jugamos millones 🔴⚪🔵
 
🏟 Estadio Nacional
⏲ 7:00 pm
📺 Deportes TVC 
💵 Sol 70 Sombra 120 Silla 250 

NIÑOS MENORES DE 12 AÑOS ENTRAN GRATIS AL SECTOR DE SOL ACOMPAÑADOS DE UN ADULTO.

Boletos a la venta en puntos Tengo

#SomosOlimpia https://t.co/kbSC30UM9w",227,48,2019,196452,275,0.14
658,"En el Dia Internacional del Zurdo recordamos al más importante que ha venido a Honduras.⚽️⚽️🥅🥅

#DiaInternacionalDelZurdo
#SomosOlimpia https://t.co/5sx07OTDd1",593,129,2019,196452,722,0.37
659,"¡Felíz martes Olimpistas! Ya con la mirada puesta en el partido de mañana ante el Vida. 

Gracias San Pedro Sula por acompañar al León hasta el último minuto.👏👏👏

#SomosOlimpia https://t.co/wzADtvXcOk",238,38,2019,196452,276,0.14
660,"¡Campeonas regionales!🏆🏆🏆🏆

Un nuevo título para nuestras chicas

¡Vamos por el título nacional! 🥇🥇

#OlimpiaDeCorazón 
#OlimpiaFemenino https://t.co/41oM7DZBvw",122,15,2019,196452,137,0.07
661,"El color del Clásico 📽📽

¡Somos Olimpia! 🇱🇺🇱🇺🇱🇺

¡Somos millones! 🔴⚪🔵

#ElMásGrandeDeCa https://t.co/DJfQmqk1Zu",251,56,2019,196452,307,0.16
662,"Los precios para ver al más popular el miércoles:
 
🏟 Estadio Nacional
⏲ 7:00 pm
📺 Deportes Televicentro
💵 Sol 70 Sombra 120 Silla 250 

NIÑOS MENORES DE 12 AÑOS ENTRAN GRATIS AL SECTOR DE SOL ACOMPAÑADOS DE UN ADULTO.

Boletos a la venta en puntos Tengo

#SomosOlimpia https://t.co/HP6Llvvdua",157,41,2019,196452,198,0.1
663,"Las imágenes del Clásico de ayer.📷📸

¡El miércoles al Nacional! 🏟

#SomosOlimpia https://t.co/rpWIVWq3If",270,31,2019,196452,301,0.15
664,Nota de Duelo Club Olimpia Deportivo https://t.co/TY76MSkNzj,260,48,2019,196452,308,0.16
665,"Fin del partido.

Marathón 1 - 1 Olimpia

🦁🦁👏👏🇫🇷🇫🇷🤩

#ElMasGrandeDeCA #HastaElÚltimoMinuto https://t.co/gUSEQxaUiJ",164,27,2019,196452,191,0.1
666,"⏱️80""

Sale expulsado Jonathan Ferrari. 

 #HastaElÚltimoMinuto",12,1,2019,196452,13,0.01
667,"⏱️81""

❎Sale: Jorge Bengúche 
☑️Entra: Johnny Leveron

 #HastaElÚltimoMinuto https://t.co/QwJ9SkrW2N",26,1,2019,196452,27,0.01
668,"⏱️73""

❎Sale: 10 Matias Garrido
☑️Entra: 30 Eddy Hernández 

 #HastaElÚltimoMinuto https://t.co/DXSOKucDXx",11,0,2019,196452,11,0.01
669,"⏱63”
❎ Sale: 7 Ovidio Lanza
☑️ Entra: 12 Cristhian Maidana
#HastaElÚltimoMinuto

🦁🦁👏👏🇫🇷🇫🇷
#ElMasGrandeDeCA #HastaElÚltimoMinuto https://t.co/69BVqA0a67",22,5,2019,196452,27,0.01
670,"Marathón anota el empate.

Marathón 1 - 1 Olimpia.",24,3,2019,196452,27,0.01
671,"⏱47” ¡¡GOOOOOOOOOL del OLIMPIAA!!
 ¡Junior Lacayo anota el primero para el Olimpiaaaaa!!
Marathón 0 - 1 Olimpia 
🦁🦁👏👏🇫🇷🇫🇷🤩
#ElMasGrandeDeCA #HastaElÚltimoMinuto https://t.co/GH8jQ8S46n",74,12,2019,196452,86,0.04
672,"Terminan la primera mitad en el olímpico.

Marathón 0 - Olimpia 0 

🦁🦁🇫🇷🇫🇷
#ElMasGrandeDeCA #HastaElÚltimoMinuto https://t.co/yHV0rhH2H2",30,7,2019,196452,37,0.02
673,"⏱30” seguimos empatados.

Marathón 0- 0 Olimpia

🦁👏👏
#ElMasGrandeDeCA #HastaElÚltimoMinuto",26,3,2019,196452,29,0.01
674,"¡Arranca el partido!

¡Vamos a rugir! 🦁🦁🇱🇺

#ElMásGrandeDeCa https://t.co/r2w5yTJjQt",42,7,2019,196452,49,0.02
675,La alineación del León para el clásico: https://t.co/BQrW8h2QqN,179,45,2019,196452,224,0.11
676,"¡Saquen sus banderas!🇱🇺🇱🇺🇱🇺
¡Saque sus camisas! 👕👕👕

El más popular invade San Pedro Sula. 

🏟 Estadio Olimpico Metropolitano 
⏲ 4:00 Pm
💵 150 Lps
📺 Canal 11 

#SomosOlimpia 
#ElMásPopular https://t.co/EVxfFhpRRp",261,54,2019,196452,315,0.16
677,"¡Felicidades muchachos! 🇭🇳🇭🇳🇭🇳🇭🇳

Nos sentimos orgullosos de ustedes.👏👏👏👏

#PanamericanosLima2019
#Honduras https://t.co/EewZQTUGqh",605,98,2019,196452,703,0.36
678,"¡Vamos Olimpia! 

Invasión Tricolor 🇱🇺🇱🇺🇱🇺

#ElMásGrandeDeCa https://t.co/Y4Z59rMnjs",304,70,2019,196452,374,0.19
679,"El Profesor @TroglioPedro En entrevista para @ESPN_CA

¡Olimpistas con banderas en sus carros en todo el Valle de Sula el dia de mañana! 🇱🇺🇱🇺🇱🇺

#SomosOlimpia 
#ElMásGrandeDeCa https://t.co/yPnJeahde1",212,25,2019,196452,237,0.12
680,"El León más grande de Centroamérica ya está en San Pedro Sula.🦁🦁🦁🦁🦁

#10deAgosto 
#DiaMundialdelLeon
#ElLeónMásGrandeDeCa https://t.co/PjbajJWNER",307,78,2019,196452,385,0.2
681,"¡San Pedro Sula! 🏢🏢🏗🏗

Ponete hermosa que tu visitante favorito llega hoy.🚌🚌

¡Somos Olimpia!

#ElMásGrandeDeCa https://t.co/QXvlV2MYWt",350,62,2019,196452,412,0.21
682,"Olimpista que asistirás este domingo a las 4:00 pm  al estadio Olímpico:

La venta de boletos para el sector otorgado a la afición de Olimpia será mañana en el Bunker del estadio Morazán a partir de la 1:00 pm hasta las 5:00 pm y el domingo de 10:00 am a 12:00 pm.

Tomar nota. https://t.co/9PLIW3lxE2",168,25,2019,196452,193,0.1
683,"¡Listos! El León viaja mañana hacia San Pedro Sula para el clásico contra Marathon.🦁🦖

#SomosOlimpia https://t.co/rUC0bWfl4g",298,46,2019,196452,344,0.18
684,"Olimpia Femenino por título regional 🏆🏆🏆🏆🏆🏆🏆🏆

Resultado final ida:
Olimpia 4 - Independiente 1 

🏟 Estadio Birichiche 
⏲ 4:00 Pm
💵 30 Lps

#OlimpiaDeCorazón 
#OlimpiaFemenino https://t.co/4H3Dey16Qn",95,14,2019,196452,109,0.06
685,"Es viernes y los Olimpistas lo saben 🎉🎉🎉🎉

Tenemos rival para los octavos de @Concacaf League.🏆🏆

Primera parada: Ontario,Canadá contra el @ForgeFCHamilton.🇨🇦🇨🇦

¡Somos Olimpia!

#ElMásGrandeDeCa 
#LoveForOurGame https://t.co/OK5dkibq8q",231,47,2019,196452,278,0.14
686,"Eddie Hernandez-Bryan Beckeles-Jerry Bengston ⚽️⚽️⚽️

¡Estamos completos!

#SomosOlimpia https://t.co/5eDwXSJzA9",518,105,2019,196452,623,0.32
687,"Bienvenidos al más grande de Centroamérica 🔴⚪🔵🇱🇺🇱🇺🇱🇺
🏆🏆🏆🏆🏆🏆🏆🏆

#SomosOlimpia 
#ElMásGrandeDeCa https://t.co/OzkTUhIJcS",725,149,2019,196452,874,0.44
688,"¡Feliz jueves Olimpistas! ☀️☀️☀️

Compartan este Chaco Maidana para que tengan un dia de lujo y de calidad. 💎💎

#SomosOlimpia https://t.co/inwJJ72DBn",342,62,2019,196452,404,0.21
689,"Momento en el que el Club Olimpia Deportivo realizó un homenaje póstumo a una de sus máximas glorias:

Carlos ""Calistrin"" Suazo(QEPD) 
El Vicepresidente deportivo del Club Osman Madrid hizo entrega de la placa de reconocimiento a la familia del Profesor Suazo.

#SomosOlimpia https://t.co/GHki4ryEvC",120,19,2019,196452,139,0.07
690,"¡Somos Olimpia! 🔴⚪🔵🔴⚪🔵

#ElMásGrandeDeCa https://t.co/l38CfHCNBR",308,42,2019,196452,350,0.18
691,Comunicado Club Olimpia Deportivo https://t.co/khMAseRVdH,348,55,2019,196452,403,0.21
692,Comunicado Club Olimpia Deportivo https://t.co/lHkMh5JgI6,141,39,2019,196452,180,0.09
693,"🎶Soy del Albo soy,Soy del Albo 🎶

Fiesta tricolor en el Nacional       🔴⚪🔵 https://t.co/bTpZuk01s7",408,76,2019,196452,484,0.25
694,"¡La familia Olimpista esta con vos!

#SomosOlimpia https://t.co/VGmvMbHoqK",279,33,2019,196452,312,0.16
695,"Agradecemos al Olimpismo por acompañarnos la tarde de ayer en nuestro primer partido de local.

¡Juntos,Siempre Juntos! 🔴⚪🔵

#SomosOlimpia https://t.co/HG8QaUXeeD",200,36,2019,196452,236,0.12
696,"Excelente inicio de semana para todos los Olimpistas del mundo. 🌍

¡Es semana de Clásico 🇱🇺 🇨🇮!  

Las fuerzas,buenas vibras para el más grande comienzan desde hoy. 

¡Juntos,Siempre Juntos! 🔴⚪🔵

#SomosOlimpia 
#ElMásGrandeDeCa https://t.co/SBDktll89n",255,36,2019,196452,291,0.15
697,"Fin del partido.
¡Sacamos los 3 puntos en casa! 

Olimpia 2 - 0 Real Sociedad
🦁🦁👏👏🇫🇷🇫🇷🤩
#ElMasGrandeDeCA #HastaElÚltimoMinuto https://t.co/DJp7EgDaKd",254,61,2019,196452,315,0.16
698,"⏱83”
⬅Sale: 14 Junior Lacayo
➡Entra: 19 Jairo Rochez 
#HastaElÚltimoMinuto

🦁🦁👏👏🇫🇷🇫🇷
#ElMasGrandeDeCA #HastaElÚltimoMinuto https://t.co/Vb9p310hBl",25,1,2019,196452,26,0.01
699,"⏱68”
⬅Sale: Matias Garrido
➡Entra: Elmer Güity 
#HastaElÚltimoMinuto

🦁🦁👏👏🇫🇷🇫🇷
#ElMasGrandeDeCA #HastaElÚltimoMinuto https://t.co/Vg61AchfJ7",19,0,2019,196452,19,0.01
700,"⏱64” ¡¡Goooolaaazoooo del León!!
 ¡Junior Lacayo anota el segundo para el Olimpiaaaaa!!
Olimpia 2 - 0 Real Sociedad
🦁🦁👏👏🇫🇷🇫🇷🤩
#ElMasGrandeDeCA #HastaElÚltimoMinuto https://t.co/X77zrO7tiu",81,24,2019,196452,105,0.05
701,"⏱60” ¡¡Gooool del León!!
 ¡Matias Garrido anota para el Olimpia!
Olimpia 1 - 0 Real Sociedad
🦁🦁👏👏🇫🇷🇫🇷🤩
#ElMasGrandeDeCA #HastaElÚltimoMinuto https://t.co/pxDMl2z7d7",113,25,2019,196452,138,0.07
702,"⬅Sale: Ovidio Lanza
➡Entra: Christian Maidana 
#HastaElÚltimoMinuto

🦁🦁👏👏🇫🇷🇫🇷
#ElMasGrandeDeCA #HastaElÚltimoMinuto https://t.co/wPmiuJ6Vzv",22,2,2019,196452,24,0.01
703,"⏱59"" 
Ovidio Lanza no logra conectar el gol clarisimooo.

Seguimos 0-0",8,1,2019,196452,9,0.0
704,"Termina la primera mitad en el nacional.

Olimpia 0 - Real Sociedad 0 

🦁🦁🇫🇷🇫🇷
#ElMasGrandeDeCA #HastaElÚltimoMinuto https://t.co/xRJNvnkqzP",27,6,2019,196452,33,0.02
705,"⏱39” Jorge Bengúche no logra anotar una clara, seguimos 0-0.",9,1,2019,196452,10,0.01
706,⏱24”  Ovidio Lanza dispara al marco luego de un centro de Bengúche y sale al tiro de esquina.,12,0,2019,196452,12,0.01
707,"⏲22'' minutos del primer tiempo 

Olimpia 0 - Real Sociedad 0

El dominio de la pelota la tiene el león.

¡Vamos Olimpia!",19,1,2019,196452,20,0.01
708,"¡Arranca el partido!

¡Vamos a rugir! 🦁🦁🦁

#ElMásGrandeDeCa https://t.co/mPsQZp9zdz",61,12,2019,196452,73,0.04
709,El león sale a la cancha contra el Real Sociedad con la siguiente alineación: https://t.co/dTGg2fNdHY,111,26,2019,196452,137,0.07
710,"Las familias Olimpistas ya en el Nacional. 🔴⚪🔵

 ¡Fiesta Tricolor! 🇱🇺🇱🇺🇱🇺🇱🇺

#SomosOlimpia 
#ElMásGrandeDeCa https://t.co/Z5FXa4s7jE",201,24,2019,196452,225,0.11
711,"¡Vamos a llenar el Nacional! 

🇱🇺 ¡Juntos, Siempre Juntos! 🇱🇺

🏟 Estadio Nacional
⏲ 6:00 Pm
📺 Tigo Sport
💵 70 Lps Sol 120 Lps Sombra 300 Lps Silla.

Boletos a la venta en puntos Tengo

🎶Olimpia mi buen amigo🎶

#ElMásGrandeDeCa https://t.co/NbpeVOdgZn",225,38,2019,196452,263,0.13
712,"Mañana se presenta el León de local. 🦁🦁🦁

Todos al Nacional 🏟🏟

¡Juntos somos más fuertes! 
               🔴⚪🔵

#SomosOlimpia https://t.co/kPSnBsISBn",357,79,2019,196452,436,0.22
713,"Rony y Capi 🦁🦁

El mejor equipo de utileria la tiene el más grande 🇱🇺🇱🇺

#SomosOlimpia https://t.co/hnAJ4C8vXT",186,17,2019,196452,203,0.1
714,Convocatoria para pruebas FBO Club Olimpia Deportivo https://t.co/X0OBOxydXF,87,22,2019,196452,109,0.06
715,"¡Vamos a llenar el Nacional! 

🇱🇺 ¡Juntos, Siempre Juntos! 🇱🇺

🏟 Estadio Nacional
⏲ 6:00 Pm
📺 Tigo Sport
💵 70 Lps Sol 120 Lps Sombra 300 Lps Silla.

Boletos a la venta en puntos Tengo

🎶Olimpia mi buen amigo🎶

#ElMásGrandeDeCa https://t.co/yCxeiophXK",189,29,2019,196452,218,0.11
716,"¡Boleto para el domingo! 🎟🎟

¿A qué jugador le pertenece este tatuaje ? ___________________

#SomosOlimpia https://t.co/V1Q3vZBQLp",150,11,2019,196452,161,0.08
717,A la afición y medios de comunicación tomar nota: https://t.co/Vs0ciuTXyy,248,73,2019,196452,321,0.16
718,"La afición de Olimpia 👏👏👏👏

Inimitable e inigualable 🦁🦁🦁

¡Locales en todos lados!

#LaMejorAficiónDeCentroamérica 
🔴⚪🔵 🔴⚪🔵 🔴⚪🔵 🔴⚪🔵 https://t.co/us4WBHut9l",234,30,2019,196452,264,0.13
719,"🔁Para que tu miércoles sea de mucha garra.
❤️Para nuestro pulmón en la media cancha.

#SomosOlimpia https://t.co/EsOUtTeKYN",306,43,2019,196452,349,0.18
720,"Sin descanso 😓😓

El equipo continúa preparándose para el juego contra Real Sociedad 👊👊

🇱🇺 Juntos,Siempre Juntos🇱🇺

#SomosOlimpia https://t.co/2OaZIBy1cF",183,29,2019,196452,212,0.11
721,"¡Feliz Cumpleaños Presi! 🎂🎈

Felicidades en su día a nuestro Presidente Lic. Rafael Villeda Ferrari 🔵⚪🔴

Muchos éxitos al mando del equipo más grande de Centroamérica 🦁🇱🇺

¡Presi,Olimpia es su casa! @R_Villeda

#CumpleañosAlbo https://t.co/FwG5Kujucv",252,31,2019,196452,283,0.14
722,"¡Vamos a llenar el Nacional! 

🇱🇺 ¡Juntos, Siempre Juntos! 🇱🇺

🏟 Estadio Nacional
⏲ 5:30 Pm
📺 Tigo Sport
💵 70 Lps Sol 120 Lps Sombra 300 Lps Silla.

Boletos a la venta en puntos Tengo

🎶Olimpia mi buen amigo🎶

#ElMásGrandeDeCa https://t.co/efdsMz2Uu3",314,51,2019,196452,365,0.19
723,"Somos todos en este abrazo 🤲🤲

Somos Olimpia 🦁🦁

🇱🇺 ¡Juntos, Siempre Juntos! 🇱🇺

#ElMásGrandeDeCA https://t.co/wOIQDtwGon",202,30,2019,196452,232,0.12
724,El Club Olimpia Deportivo informa: https://t.co/2vAOrKdgxW,175,58,2019,196452,233,0.12
725,"El 0 - 4 @chacomaidana10 

Excelente Servicio 

⭐⭐⭐⭐⭐ https://t.co/QQuyWp0XIc",192,17,2019,196452,209,0.11
726,"¡Felicidades Mago! ♠️♥️♦️♣️🎩

¡Feliz Cumpleaños para uno de los jugadores más importantes en la historia del Club! 🎂🍰🎁🎈

#CumpleañosAlbo https://t.co/3QZg2SjhdO",308,27,2019,196452,335,0.17
727,"3-0  Matías Garrido 
         ⚽️⚽️⚽️

         🔴⚪🔵

#SomosOlimpia https://t.co/r8jR1GLg9b",141,19,2019,196452,160,0.08
728,"El 2-0 ⚽️⚽️

La figura 🏅🏅 Michael Chirinos 

#SomosOlimpia https://t.co/TT8UpGYBGS",140,21,2019,196452,161,0.08
729,"¡Feliz semana Olimpistas! 🔴⚪🔵

El 1-0 con el que se abría el marcador⚽️

El domingo a llenar el Nacional 🏟

#SomosOlimpia https://t.co/1kZEiA3reb",194,29,2019,196452,223,0.11
730,"El jugador del partido 🏅🏅

El único...el nuestro @Michaellchirin1 

#ElMásGrandeDeCa https://t.co/hvMiJXuRqW",613,57,2019,196452,670,0.34
731,"¿Quién consideras que fue el jugador del partido?

🦁✔⚽️🏅🔴⚪🔵",122,16,2019,196452,138,0.07
732,"¡El León líder de la manada está de Cumpleaños! 🦁🦁🦁

¡Felicidades Profesor Pedro Troglio! 🎂🎂🎂 @TroglioPedro

¡Olimpia es su casa! 

#CumpleañosAlbo https://t.co/0OfkXbhCOH",729,110,2019,196452,839,0.43
733,"Final del partido en el Humberto Micheletti.
Honduras Progreso 0 - Olimpia 4 

#ElMasGrandeDeCA #HastaElÚltimoMinuto https://t.co/dD18b1amA5",486,122,2019,196452,608,0.31
734,⏱️71” Gooooll del León!!!! Christian Maidan anota para el #ElMasGrandeDeCA #HastaElÚltimoMinuto https://t.co/bAGUZnQmdn,109,18,2019,196452,127,0.06
735,⏱️67” Gooooll del León!!!! Leonardo Garrido anota para el #ElMasGrandeDeCA #HastaElÚltimoMinuto https://t.co/VGyso8MhjJ,91,13,2019,196452,104,0.05
736,"¡¡PENAAAAAAAAL PARA EL OLIMPIAAAAA!!

#ElMasGrandeDeCA #HastaElÚltimoMinuto",51,3,2019,196452,54,0.03
737,"Final del primer tiempo:

Honduras Progreso 0 - Olimpia 2

¡Dale León!

#ElMásGrandeDeCa https://t.co/VtuCR1IguT",87,11,2019,196452,98,0.05
738,"⏱️48” Tarjeta amarilla para Marlon Ramirez del Honduras Progreso.

#ElMasGrandeDeCA #HastaElÚltimoMinuto",14,0,2019,196452,14,0.01
739,⏱️24” Gooooll del Olimpia!!!!  Michael Chirinos anota para #ElMasGrandeDeCA #HastaElÚltimoMinuto https://t.co/kSiEFu1KYE,104,20,2019,196452,124,0.06
740,⏱️17” Gooooll del León!!!!  anota para #ElMasGrandeDeCA #HastaElÚltimoMinuto https://t.co/boRqyp4njU,191,37,2019,196452,228,0.12
741,"12' minutos del primer tiempo ⏲

Honduras Progreso  - Olimpia 0

¡Vamos Olimpia!",28,3,2019,196452,31,0.02
742,El León arranca el Apertura 2019 así: https://t.co/9atyPMPQXq,215,48,2019,196452,263,0.13
743,"Sábado 27-07-19 📅

¡Bienvenidos al Torneo Apertura! 

🎶 Dale León, Dale León 🎶 https://t.co/TWQ1LJggI7",368,72,2019,196452,440,0.22
744,"¡Mañana! ⏲⏲⏲⏲ 

-1

Mañana arranca una nueva temporada y la ilusión intacta siempre 🦁🦁

¡Somos Olimpia!

#ElMásGrandeDeCa https://t.co/0juOEdHMJo",229,29,2019,196452,258,0.13
745,"El camino a la 31 arranca en Progreso.🏆

🏟 Humberto Micheletti
⏲ 3:30 Pm
📺 Tigo Sport
💵 150 Lps/Preventa 100 Lps

🎶Olimpia mi buen amigo🎶

#ElMásGrandeDeCa https://t.co/n8dXhYXaWw",206,39,2019,196452,245,0.12
746,"-2 días 

¿Listos para la invasión blanca en el Progreso? 🚌🚌🚌🚌🚌🚌

🎶Olimpia mi buen amigo esta campaña volveremos a estar contigo🎶

#SomosOlimpia 
#ElMásGrandeDeCa https://t.co/4BmJ5Z1Wth",232,37,2019,196452,269,0.14
747,"¡Felicidades Don Tino! 🎂🎂

El conductor oficial del Club Olimpia está de cumpleaños 🚌🚌

¡Don Tino Olimpia es su casa!

#CumpleañosAlbo https://t.co/yVFYmzGafk",452,41,2019,196452,493,0.25
748,"-4 días

¡Se viene el León! 🦁🦁🦁

#ElMásGrandeDeCa https://t.co/DThRlOURW6",193,24,2019,196452,217,0.11
749,Pretemporada completada 👊👊👊 https://t.co/CaxL1H55WB,354,59,2019,196452,413,0.21
750,Nota de Duelo Club Olimpia Deportivo https://t.co/MxgDmtvtbX,89,7,2019,196452,96,0.05
751,"Entrenamiento lunes 

- 5 dias 

¡Dale León!

#ElMásGrandeDeCa https://t.co/fhEb1ycL7J",193,15,2019,196452,208,0.11
752,"El León ya conoce el calendario de de liga 📅

Nos vemos el próximo sábado en el Progreso. https://t.co/gHjmhooeaQ",351,95,2019,196452,446,0.23
753,"Feliz semana para la afición más grande de Centroamérica.🥇🥇

-5 días

Cada vez más cerca para ver al León.🦁🦁

#SomosOlimpia https://t.co/Lu26e1ILMo",267,33,2019,196452,300,0.15
754,"Matías Morales ya firmó su contrato con el Club Olimpia ✍✍

#ElMásGrandeDeCa https://t.co/ZFcahMl2uf",292,47,2019,196452,339,0.17
755,"El León ya está en casa despues de la victoria de anoche en Panamá.

Ya realiza  trabajos de preparación para todos los torneos de la temporada.
🦁🦁🦁🦁🦁🏟🏟🏟🏟

#ElMásGrandeDeCa https://t.co/oiE3hFwvDy",321,41,2019,196452,362,0.18
756,"¡Feliz jueves Olimpistas! 🌞🌞🌞

El equipo regresa hoy a casa para seguir preparándose de cara al inicio del torneo de Liga. ✈️

Les dejamos el color de la victoria 2-4 sobre Árabe Unido por la @CopaPremierCA 

#ElMasGrandeDeCa https://t.co/aNptChrbqp",331,59,2019,196452,390,0.2
757,"La galería 📷📷 

¡Somos Olimpia! 🦁🦁

#ElMásGrandeDeCa https://t.co/0bRG9jBzOf",391,74,2019,196452,465,0.24
758,"¡Final! Olimpia gana de visita ante el Arabe Unido 2 - 4

Matías Garrido
Jorge Bengúche 
Ever Alvarado
Jairo Rochez 

¡Vamos Olimpia!

#ElMásGrandeDeCa https://t.co/q4x7sv7gB6",485,114,2019,196452,599,0.3
759,"Gooooooooooooooooooool
Gooooooooooooooooooool

Jairo Rochez a las 91' minutos 

Arabe Unido 2 - Olimpia 4

#ElMásGrandeDeCa https://t.co/FepmbRIYGv",148,28,2019,196452,176,0.09
760,"Doble cambio en Olimpia a los 82' minutos 

Sale:Jorge Benguche 
Entra:Jairo Rochez

Sale:Michael Chirinos
Entra:Cristhian Maidana

¡Dale León!",33,2,2019,196452,35,0.02
761,"Cambio en Olimpia a los 79' minutos:

Sale:Matías Garrido
Entra:Axel Gómez

¡Dale León!",20,0,2019,196452,20,0.01
762,"Gol del @ArabeUnido_ a los 78' minutos.

Arabe Unido 2 - Olimpia 3

¡Dale León!

#ElMásGrandeDeCa",16,2,2019,196452,18,0.01
763,"Cambios en Olimpia:

Sale:Maylor Núñez
Entra:Elmer Güity 

Sale:Ovidio Lanza
Entra:Júnior Lacayo",30,2,2019,196452,32,0.02
764,"Gooooooooooooooool
Gooooooooooooooool

Ever Alvarado de penal a los 60 minutos 

Arabe Unido 1 - Olimpia 3 

#ElMásGrandeDeCa https://t.co/ZfkV9WMvRZ",172,31,2019,196452,203,0.1
765,"Gooooooooooooooooool
Gooooooooooooooooool

Jorge Bengúche a los 52' minutos 

Arabe Unido 1 - Olimpia 2

¡Dale León!

#ElMásGrandeDeCa https://t.co/zf4vkwQyXL",104,25,2019,196452,129,0.07
766,"Inicia el segundo tiempo:

Arabe Unido 1 - Olimpia 1 

¡Dale León!

#ElMásGrandeDeCa",23,1,2019,196452,24,0.01
767,"Final del primer tiempo en Panamá 

Arabe Unido 1 - Olimpia 1 

Matías Garrido 🦁 34'

¡Dale León!

#ElMásGrandeDeCa https://t.co/Hqw7Nmk6OY",52,13,2019,196452,65,0.03
768,"Goooooooooooooooool
Goooooooooooooooool

Matías Garrido a los 34' minutos 

Arabe Unido 1 - Olimpia 1

#ElMásGrandeDeCa https://t.co/F97XH8VN7j",148,27,2019,196452,175,0.09
769,"32' minutos del primer tiempo ⏲

@ArabeUnido_ 1 - Olimpia 0

¡Vamos Olimpia!",20,0,2019,196452,20,0.01
770,"15' minutos del primer tiempo ⏲

@ArabeUnido_ 1 - Olimpia 0

¡Vamos Olimpia!",13,0,2019,196452,13,0.01
771,"Gol del Arabe Unido a los 5 minutos del primer tiempo.

¡Vamos Olimpia!

@CopaPremierCA",21,3,2019,196452,24,0.01
772,"Inicia el partido en el Agustín ""Muquita"" Sánchez ⏲

¡Vamos Olimpia!

#ElMásGrandeDeCa https://t.co/eUAyHXsj8w",34,9,2019,196452,43,0.02
773,"¡Vamos Olimpia! 🦁🦁🇭🇳🇭🇳

Nunca solos.👏👏👏

#ElMásGrandeDeCa https://t.co/HzUeslSyYc",102,23,2019,196452,125,0.06
774,"Así sale el León esta tarde en Panamá:

@CopaPremierCA https://t.co/MvE86GPw4r",122,39,2019,196452,161,0.08
775,"Llegada Club Olimpia al estadio Agustín ""Muquita"" Sánchez.

@CopaPremierCA https://t.co/7nk3xVl7Kv",141,27,2019,196452,168,0.09
776,"¡Bienvenido Matías Morales!

🦁🦁👏👏🤩

#ElMásGrandeDeCa https://t.co/gyDhEhSXCj",221,42,2019,196452,263,0.13
777,"¡Hoy juega el orgullo nacional! 🇭🇳🇭🇳

@CopaPremierCA 

#ElMásGrandeDeCa https://t.co/6TkkCX2ELU",281,69,2019,196452,350,0.18
778,Comunicado Club Olimpia Deportivo https://t.co/OTolnGHedK,427,104,2019,196452,531,0.27
779,"Olimpia entrenó este día en Ciudad de Panamá previo al juego de mañana contra @ArabeUnido_

¡Dale León! 🦁🦁🦁🦁

#ElMásGrandeDeCa https://t.co/Blz5Fo98Zq",147,25,2019,196452,172,0.09
780,"¡Le León ya está en Panamá!

🇵🇦🇵🇦🇵🇦🇵🇦🇵🇦🇵🇦🇵🇦🇵🇦🇵🇦🇵🇦🇵🇦

¡Vamos Olimpia! 🦁🦁🦁🦁🦁

#ElMásGrandeDeCa https://t.co/8l95hXDEct",208,27,2019,196452,235,0.12
781,"Entrenamiento regenerativo hoy en Ciudad de Guatemala.🇬🇹🇬🇹🇬🇹🇬🇹🇬🇹

¡Mañana  rumbo a Panamá!
🇵🇦🇵🇦🇵🇦🇵🇦🇵🇦🇵🇦

@CopaPremierCA 

#ElMásGrandeDeCa https://t.co/v6zWiqL0QY",199,36,2019,196452,235,0.12
782,"¡Feliz lunes Olimpistas! ☀️☀️

Una nueva semana de compromisos y de apoyo de todos.

El miércoles contra el @ArabeUnido_ por el pase a semifinales 

@CopaPremierCA 

#ElMásGrandeDeCa https://t.co/sG7Z7HfZAW",200,25,2019,196452,225,0.11
783,"Con cada caída nos volvemos a levantar 🆙️ 

Gracias a los miles de aficionados que se movilizaron hasta Guatemala para apoyar al León.👏👊

 ¡Panamá allá va el más grande de Centroamérica! 🦁✈🛫 

#SomosOlimpia
#LaMejorAficiónDeCentroamérica https://t.co/mB77WDvQKu",350,50,2019,196452,400,0.2
784,"Resultado Final en el Doroteo Flores:

@CremasOficial 3 - Olimpia 0

¡Vamos que esto recién empieza! 👊

@CopaPremierCA 

#ElMásGrandeDeCa https://t.co/0IkttKfKgu",93,28,2019,196452,121,0.06
785,"Cambio en Olimpia a los 80' :

Sale:Elmer Güity 
Entra Jhonny Leveron 

¡Dale León!

#ElMásGrandeDeCa https://t.co/77Dw1VvVM1",10,2,2019,196452,12,0.01
786,"Tercer cambio en Olimpia a los 66':

Sale:Cristhian Maidana
Entra:Jhon Paul Suazo

¡Dale León!

#ElMásGrandeDeCa",8,1,2019,196452,9,0.0
787,"Gol de Comunicaciones a los 58':

Comunicaciones 3 - Olimpia 0

¡Dale León!

#ElMásGrandeDeCa",20,2,2019,196452,22,0.01
788,"Doble cambio en Olimpia a los 56 minutos:

Sale:Júnior Lacayo
Entra:Jairo Rochez

Sale:Maylor Núñez 
Entra:Michael Chirinos 

@CopaPremierCA 

¡Dale León!

#ElMásGrandeDeCa https://t.co/SaDRXevGZt",7,2,2019,196452,9,0.0
789,"Gol de @CremasOficial de penal a los 53 minutos:

Comunicaciones 2 - Olimpia 0

@CopaPremierCA 

¡Dale León!

#ElMásGrandeDeCa",6,1,2019,196452,7,0.0
790,"Inicia el segundo tiempo en el Doroteo Flores:

Comunicaciones 1 - Olimpia 0

@CopaPremierCA 

¡Dale León!

#ElMásGrandeDeCa",10,0,2019,196452,10,0.01
791,"Final del primer tiempo:

Comunicaciones 1 - Olimpia 0

¡Dale León!

#ElMásGrandeDeCa https://t.co/r5zNO5Vhy4",17,3,2019,196452,20,0.01
792,"⏲35 minutos del primer tiempo:

Comunicaciones 1 - Olimpia 0

¡Dale León!

#ElMásGrandeDeCa",8,0,2019,196452,8,0.0
793,"⏲25 minutos del primer tiempo:

Comunicaciones 1 - Olimpia 0

¡Dale León!

#ElMásGrandeDeCa",11,4,2019,196452,15,0.01
794,"15 minutos del primer tiempo:

Comunicaciones 1 - Olimpia 0

¡Dale León!

#ElMásGrandeDeCa",12,3,2019,196452,15,0.01
795,"Gol de Comunicaciones a las 6' minutos.

Comunicaciones 1 - Olimpia 0

¡Dale León!

#ElMásGrandeDeCa",22,4,2019,196452,26,0.01
796,"¡Inicia el partido en Doroteo Flores de Guatemala! ⚽️⚽️

¡Dale León!

#ElMásGrandeDeCa https://t.co/UrDQt0uBRP",17,5,2019,196452,22,0.01
797,Así sale el León esta mañana en el  Doroteo Flores https://t.co/6C5eOKZw95,87,30,2019,196452,117,0.06
798,"¡El León está listo! 💪🦁

⌚ | 11:00 am
🏟 | Estadio Doroteo Guamuch Flores - Guatemala
⚽️ | @CopaPremierCA 

#ElMásGrandeDeCA https://t.co/Ku9fI70hDh",169,33,2019,196452,202,0.1
799,Llego #ElMasGrandeDeCA a Guatemala. Vamos con todo por el triunfo. @CopaPremierCA https://t.co/1640e7BNVS,447,88,2019,196452,535,0.27
800,Gracias a nuestra afición por acompañarnos en nuestro primer encuentro. A partir de hoy estaremos dando a conocer la cantidad de aficionados que compran su boleto para asistir a cada partido. #ElMasGrandeDeCA https://t.co/x9jZyMidfC,290,38,2019,196452,328,0.17
801,"¡Estamos listos con la nueva piel del más grande!
@Umbrocac
#Olimpia 
#ElMasGrandeDeCA https://t.co/QghLOX64or",174,39,2019,196452,213,0.11
802,"Orgullosamente hacemos oficial la nueva indumentaria del gran Leon de Honduras, el club Olimpia deportivo lucirá próximamente su nuevo uniforme, en colaboración con Diunsa como su socio comercial.

#ElMasGrandeDeCa https://t.co/hDuC4MHHqU",338,97,2019,196452,435,0.22
803,"¡Buen viernes para todos los Olimpistas en el mundo! 🌍

#ElMásGrandeDeCa 
#CopaPremierCA https://t.co/D2kuU4PvA0",309,51,2019,196452,360,0.18
804,"Finalizó el partido en el Nacional de Tegucigalpa y hemos ganado nuestro primer partido en la #CopaPremier 
#CopaPremierCentroamericana  

Olimpia 3 - 0 Herediano
 
#Olimpia #ElMasGrandeDeCA #HastaElUltimoMinuto https://t.co/IQBoqhY9R5",315,95,2019,196452,410,0.21
805,"⏱85” Cambio en el Olimpia ✅ Ovidio Lanza
⛔️Jorge Bengúche

#Olimpia #ElMasGrandeDeCA #HastaElUltimoMinuto https://t.co/BEddl5hTGS",64,6,2019,196452,70,0.04
806,"⏱80”   ¡Falla el penal el Herediano!

Seguimos arriba en el marcador 3-0

#Olimpia #HastaElÚltimoMinuto",55,5,2019,196452,60,0.03
807,"⏱77"" Goooolllll!!! Gol de Junior Lacayo 3-0 arriba en el marcador contra el Herediano
#Olimpia #ElMasGrandeDeCA #HastaElUltimoMinuto https://t.co/bY4HhGWXSB",89,18,2019,196452,107,0.05
808,"⏱70"" Goooolllll!!! Gol de Jorge Bengúche 2-0 
#Olimpia #ElMasGrandeDeCA #HastaElUltimoMinuto https://t.co/qEW26abyDU",90,19,2019,196452,109,0.06
809,"⏱️69"" seguimos adelante en el marcador.
Olimpia 1 - 0 Herediano
🦁
#Olimpia #ElMasGrandeDeCA #HastaElUltimoMinuto",37,5,2019,196452,42,0.02
810,"⏱50"" Goooolllll!!! Gol de Matias Garrido 1-0 #Olimpia #ElMasGrandeDeCA #HastaElUltimoMinuto https://t.co/Xi3CeXKNN8",131,31,2019,196452,162,0.08
811,"¡Inicia el segundo tiempo, vamos con todo leones🦁por esa victoria!

¡Hasta el último minuto! 
#ElMásGrandeDeCa",34,4,2019,196452,38,0.02
812,"Fin del primer tiempo. Nos vamos al descanso empatados

Olimpia 0-0 Herediano

Vamos leones🦁 
¡Hasta el último minuto! 

#ElMásGrandeDeCa https://t.co/rHqyK5bG34",26,5,2019,196452,31,0.02
813,"⏱️40"" seguimos empatados con el Herediano.
🦁
#Olimpia #ElMasGrandeDeCA #HastaElUltimoMinuto",31,3,2019,196452,34,0.02
814,"¡Arranca la Copa Premier!

¡Vamos Olimpia! 🦁🦁🦁

#ElMásGrandeDeCa https://t.co/Tbyhfe0SLl",48,7,2019,196452,55,0.03
815,Así sale el León esta noche ⚽️⚽️🥅 https://t.co/gRnLOnTxoJ,87,27,2019,196452,114,0.06
816,"¡A llenar el Nacional! 🏟🏟 

Olimpista te esperamos está noche para apoyar al más grande de Centroamérica. 

 @CopaPremierCA

📅 11/07/19
🏟 Estadio Nacional 
⏰ 07:00 Pm
📺 Tigo Sport
💵 Sol 80- Sombra 150- Silla 250
(Niños gratis en localidad de Sol)

#ElMásGrandeDeCa https://t.co/YoTrakFHkA",128,35,2019,196452,163,0.08
817,"¡Comienza una nueva era! Te esperamos en el Nacional. 💪

Boletos a la venta en puntos Tengo y a través de la billetera electrónica. 

#ElMásGrandeDeCentroamérica https://t.co/dtikW5LUax",259,65,2019,196452,324,0.16
818,"🎶Yo te sigo a todas partes a donde vas...🎶

La mejor afición de Centroamérica https://t.co/ULEKnPtZG6",234,21,2019,196452,255,0.13
819,"Las FBO cierran de líderes su grupo con contundente victoria e invictos.

4 anotaciones del goleador Héctor Gabriel Ávila que lo colocan como líder de goleo con once anotaciones.

@donosticup 

#SomosFbo 
#ElMásGrandeDeCa https://t.co/tozLyKADgB",176,23,2019,196452,199,0.1
820,"El más popular debuta en la Premier .

No te quedes sin tu entrada en todos los puntos Tengo. @CopaPremierCA

📅 11/07/19
🏟 Estadio Nacional 
⏰ 07:00 Pm
📺 Tigo Sport
💵 Sol 80- Sombra 150- Silla 250
(Niños gratis en localidad de Sol)

#ElMásGrandeDeCa https://t.co/KaCcl9Oero",133,33,2019,196452,166,0.08
821,"¡Segunda victoria consecutiva de las FBO!

Las Reservas se apoderan del liderato de su grupo en la Donosti Cup @donosticup 

🥅 Héctor Gabriel Avila,Ronald Polanco,Carlos Daniel Gómez y dos anotaciones de Adrián Martínez.

#SomosFbo
#ElMásGrandeDeCa https://t.co/5UmntrrZuz",124,25,2019,196452,149,0.08
822,"¡Juntos como un puño! 👊 

¿Nos caemos? Nos volvemos a levantar.

Estamos listos para comenzar de nuevo ¿Y vos? 

#ElMásGrandeDeCa https://t.co/XBlwYWzJ5N",359,82,2019,196452,441,0.22
823,"Debut con goleada de las FBO en la Donosti Cup. 👏👏👏

Héctor Gabriel Ávila con 6 anotaciones se convierte en el máximo anotador del torneo en su categoría.⚽️⚽️

El día de mañana el segundo partido del grupo ante el Ribera St. 📅

¡Somos Olimpia!

#SomosFbo 
#ElMásGrandeDeCa https://t.co/xD5a0r4Obo",221,39,2019,196452,260,0.13
824,Acá están nuestros pequeños leones representando al país en la @donosticup https://t.co/DmCl1J7aEO,90,12,2019,196452,102,0.05
825,"🏟 Casa 🏟 Jueves 🗓🗓

¡Somos Olimpia! 🦁

#ElMásGrandeDeCa https://t.co/JG5Ep7Jnmk",259,48,2019,196452,307,0.16
826,"¡Feliz inicio de semana Olimpistas! ☀️☀️

Con la mira puesta en el jueves

¿Están listos? 🏟🏟🦁🦁🏆🏆

#PretemporadaOlimpia https://t.co/ZXXNkukEKH",257,44,2019,196452,301,0.15
827,"Comunicado Club Olimpia Deportivo 

Enlace sección de acreditaciones:
https://t.co/uQ4vN6xa81 https://t.co/wz9rrHjDSy",66,9,2019,196452,75,0.04
828,"¡Felicidades campeonas! 🏆🏆🏆

Olimpia Femenino se corona campeón regional al derrotar 2-1 a la Unah. 🥇🥇

Lisbeth Bonilla
Fanny Rodriguez

#OlimpiaDeCorazón 
#ElMásGrandeDeCa https://t.co/pWZfYaFKEq",263,52,2019,196452,315,0.16
829,"Fin de semana sin descanso en el más popular. 🦁🦁

Con la mente puesta en el inicio de la Copa Premier.

#PretemporadaOlimpia
#ElMásGrandeDeCa https://t.co/mRYedzitJ1",228,33,2019,196452,261,0.13
830,"😱😱😱😱 ¡Buenos días goleador!

#PretemporadaOlimpia https://t.co/c0RGyQPZiw",363,38,2019,196452,401,0.2
831,"El Club Olimpia Deportivo agradece el reconocimiento que la Fundación  Global África Latina ha realizado por espíritu humanitario y sentido de virtud.

Muchas gracias por reconocer los valores de nuestra institución.

#ElMásGrandeDeCa https://t.co/cetkmFVgBu",142,29,2019,196452,171,0.09
832,"La temporada para el León  inicia el próximo 11 de julio con el debut en la  @CopaPremierCA

📅 11/07/19
🏟 Estadio Nacional 
⏰ 07:00 Pm
📺 Tigo Sport
💵 Sol 80- Sombra 150- Silla 250
(Niños gratis en localidad de Sol)

#ElMásGrandeDeCa https://t.co/MlEzCC1nBV",169,34,2019,196452,203,0.1
833,"¡Ovidio Lanza ha estampado su firma! ✍

Bienvenido al más grande de Centroamérica 🏆🏆

#ElMásGrandeDeCa 
#SomosOlimpia https://t.co/ekJjs1vvS3",153,23,2019,196452,176,0.09
834,"Cristhian Maidana y Jhonny Leveron ya firmaron su contrato.

¡Bienvenidos al más grande de Centroamérica! 🏆🏆

@chacomaidana10 @JLeveron16 

#ElMásGrandeDeCa 
#SomosOlimpia https://t.co/QRGYf2uWTX",247,62,2019,196452,309,0.16
835,"Seguimos en preparación 🇫🇷🇫🇷

El camino a la 31 comienza con el apoyo de los millones de Olimpistas en todo el mundo.🌍🌍

¡Somos Olimpia!

#ElMásGrandeDeCa 
#PretemporadaOlimpia https://t.co/pnZA9wUVd6",300,39,2019,196452,339,0.17
836,Comunicado Club Olimpia Deportivo https://t.co/bRwzCZsXUW,322,81,2019,196452,403,0.21
837,"El Club Olimpia Deportivo agradece a Johnny Palacios por todos estos años de profesionalismo y amor hacia la institución.

¡Muchos éxitos Johnny!

#OlimpiaEsTuCasa https://t.co/yBfwwuQScl",314,34,2019,196452,348,0.18
838,"Entrenamiento martes ⚽️🏆

¡Somos Olimpia! 

#ElMasGrandeDeCa
#PretemporadaOlimpia https://t.co/rLxQogZizm",272,49,2019,196452,321,0.16
839,"⏳⏳⏳⏳ Tic Tac Tic Tac

Inicio de semana y el estreno se acerca.

11 de julio @CopaPremierCA contra Herediano

¡A llenar el Nacional! 

#ElMásGrandeDeCa https://t.co/A8AiuYIiAW",326,65,2019,196452,391,0.2
840,"Olimpia listo para la  Gran Final del Torneo Femenino.

Vamos a apoyar a nuestro equipo femenino para conseguir un título más.🦁🇫🇷🏃‍♀️

Precio de entrada: 30 Lps

#OlimpiaDeCorazón https://t.co/TWikYoggJ4",115,15,2019,196452,130,0.07
841,"¡Maidana! 🦁🦁👏👏🇫🇷🇫🇷🤩 @chacomaidana10

#ElMásGrandeDeCa https://t.co/E1XlkZ0qus",360,58,2019,196452,418,0.21
842,Comunicado Club Olimpia Deportivo https://t.co/kP9Y5Baruf,436,107,2019,196452,543,0.28
843,"Jonathan Ferrari ya estampó su firma en el contrato y recibió de parte del Vicepresidente deportivo Osman Madrid la camiseta de Club Olimpia Deportivo.

#ElMásGrandeDeCa https://t.co/0bQz6sYhLu",192,53,2019,196452,245,0.12
844,Comunicado Club Olimpia Deportivo https://t.co/176atqJYqp,335,79,2019,196452,414,0.21
845,Comunicado Club Olimpia Deportivo https://t.co/0EmDGB4UQK,292,101,2019,196452,393,0.2
846,"¡Gracias CW7!

Muchas gracias por tu Olimpismo y profesionalismo.

Olimpia es y será siempre tu casa 🦁🦁

¡Gracias Toro!

#ElMásGrandeDeCa 
#CW7 

@elwester1983 https://t.co/lkveuTDQWZ",461,112,2019,196452,573,0.29
847,"🎶Te alentaremos de corazón...esta es tu hinchada que te quiere ver campeón🎶 

¡Volveremos siempre!

#ElMásGrandeDeCa https://t.co/ZVZubf7Ivg",310,66,2019,196452,376,0.19
848,"🏆 Copa #PremierCA19

Síguenos en:

#Twitter: https://t.co/lZsh2rAll7
#Instagram: https://t.co/OtC7mmIkDj https://t.co/k0mjqo2H40",67,11,2019,196452,78,0.04
849,"¡Olimpia femenino a la final!

Noelia Hernández (3)
Janeth Guifarro (2)
Yeimi Estrada
Dora Alemán 
Lorena Cibrian 
Lisbeth Bonilla

Final Vrs UNAH 

#OlimpiaDeCorazón https://t.co/mz29kbvilg",126,15,2019,196452,141,0.07
850,"Buena semana Olimpistas.

El equipo comienza hoy trabajos de pretemporada en Siguatepeque.

¡Vamos Olimpia!

#SomosOlimpia https://t.co/VsZb3sg7EI",168,21,2019,196452,189,0.1
851,Matías Garrido nuevo jugador Club Olimpia Deportivo https://t.co/2Yu0sZ7kcA,288,80,2019,196452,368,0.19
852,Comunicado Club Olimpia Deportivo https://t.co/SG8iwz85pw,229,65,2019,196452,294,0.15
853,Jonathan Ferrari nuevo jugador del Club Olimpia Deportivo https://t.co/0wWfbkSl5S,268,74,2019,196452,342,0.17
854,Comunicado Club Olimpia Deportivo https://t.co/bZyIHOLlKA,221,77,2019,196452,298,0.15
855,"Olimpia femenino por la final

Vamos a apoyar mañana a nuestro equipo femenino para llegar a una nueva final.

¡Vamos Olimpia!

Valor 25 Lps 
Niños menores de 12 años no pagan.

#OlimpiaDeCorazón https://t.co/koE5dHdqpS",87,10,2019,196452,97,0.05
856,"Buenos días Olimpistas ☀️☀️🌞

Los Leones ya iniciaron pretemporada de la mano del Prof Pedro Troglio junto a todo el equipo técnico.

🦁🦁🏋️‍♂️⚽️🇫🇷🇫🇷

#SomosOlimpia 
#ElMásGrandeDeCa https://t.co/hJlhytWEu1",324,51,2019,196452,375,0.19
857,"Hoy comienza un nuevo camino de la mano del Profe Pedro Troglio.

Con más fervor y amor por estos colores para una nueva temporada.

¡Vamos Olimpia! 

#ElMásGrandeDeCa
#SomosOlimpia https://t.co/vAj0mDszbp",296,70,2019,196452,366,0.19
858,"Bienvenido al Más Grande de Centroamérica Profesor Pedro Troglio.

¡Somos Olimpia!

#ElMásGrandeDeCa https://t.co/ggWjwMNFYP",1032,202,2019,196452,1234,0.63
859,A todos los medios de comunicación que asistirán a la presentación del nuevo cuerpo técnico del Club Olimpia en el Hotel Marriot accesar por el lado del Mall Multiplaza.,160,18,2019,196452,178,0.09
860,Comunicado Club Olimpia Deportivo https://t.co/DP7m4K6LQd,179,38,2019,196452,217,0.11
861,"Un día como hoy en 1989 el Club Olimpia se coronoba Campeón de Centroamérica al vencer a Herediano de Costa Rica.

#ElMásGrandeDeCa https://t.co/YJVV1aePaD",264,75,2019,196452,339,0.17
862,"El Club Olimpia Deportivo felicita a la Liga Deportiva Alajuelense de Costa Rica por sus 100 años de historia.

¡Bienvenidos al club de los Centenarios en Centroamérica!

@ldacr https://t.co/aFgOkbBRgg",1056,109,2019,196452,1165,0.59
863,"Feliz Cumpleaños Michael!

¡Dejale tu mensaje a nuestro León legionario!

¡Felicidades Campeón!

#CumpleañosAlbo 
#OlimpiaEsTuCasa 

@Michaellchirin1 https://t.co/dvwXGVacFh",285,28,2019,196452,313,0.16
864,"Semifinal ida: Las Leonas pegan primero.

Vamos a apoyar a nuestro equipo femenino en casa.

#OlimpiaDeCorazón https://t.co/iGnYf6AQCU",76,11,2019,196452,87,0.04
865,"Mañana domingo en Cinco Deportivo entrevista con Pedro Troglio nuevo Director Técnico del Club Olimpia.

#ElMásGrandeDeCa https://t.co/Q2pm2yA23w",169,29,2019,196452,198,0.1
866,"Se juegan las semifinales Centro/Oriente del Fútbol Femenino y nuestras Leonas se movilizan a Juticalpa para el partido de ida.

¡Vamos Olimpia!

#OlimpiaDeCorazón https://t.co/G5fL4aW5aQ",70,14,2019,196452,84,0.04
867,"Este es el Cuerpo Técnico que acompañará al Profesor Pedro Troglio.

¡Bienvenidos!

#ElMásGrandeDeCa https://t.co/QefXPiWi2X",383,105,2019,196452,488,0.25
868,Comunicado Oficial Club Olimpia Deportivo https://t.co/dJWgcJjypk,819,288,2019,196452,1107,0.56
869,"¡Buenas Noches Olimpistas!

La lucha y el compromiso intacto con el empuje de la mejor afición de Centroamérica.

¡Somos Olimpia!

#ElMásGrandeDeCa https://t.co/uVEo7gQVwn",237,48,2019,196452,285,0.15
870,"Dos de nuestros máximos referentes y capitanes nos dejan su saludo de Cumpleaños 107.

#ElMásGrandeDeCa https://t.co/BNnfc2szoX",243,44,2019,196452,287,0.15
871,"1912-2019 Club Olimpia Deportivo.

107 años de Grandeza.

¡Somos Olimpia!

#ElMásGrandeDeCa https://t.co/kj2HiYynzy",306,113,2019,196452,419,0.21
872,"Agradecemos a nuestros patrocinadores que se unen al saludo por los 107 años de nuestro Club.

#107AñosDeGrandeza 
#BancoAtlantida
#SalvaVida https://t.co/5v4rMA0xt9",178,28,2019,196452,206,0.1
873,"El Rey David nos deja su mensaje desde Italia en el 107 aniversario del Más Grande de Centroamérica.

#ElMásGrandeDeCa https://t.co/mReAjeZ1d7",594,144,2019,196452,738,0.38
874,"Felicitamos hasta Costa Rica a los amigos del @csherediano1921 por celebrar hoy 98 años de historia.

¡Muchos éxitos!

Los esperamos en julio en la casa del Más Grande de Centroamérica.

#ElMásGrandeDeCa",379,52,2019,196452,431,0.22
875,"¡Orgullosos de nuestros orígenes!

En 1912 el deporte rey era el béisbol.

Fue con este que dió origen a la institución deportiva más grande del área.

#107AñosDeGrandeza 
#ElMásGrandeDeCa https://t.co/gTtq8lqzgh",314,98,2019,196452,412,0.21
876,"¡El Club Olimpia Deportivo está de Cumpleaños!

A todos los millones de aficionados en cada rincón del planeta que hacen que Olimpia sea una pasión desbordante les extendemos las felicitaciones en este día.

¡Somos Olimpia! 107 años de triunfos 

#ElMásGrandeDeCa https://t.co/836J5SBKOS",739,276,2019,196452,1015,0.52
877,"El calendario que nos toca en la Copa Premier.

Preparen maletas que nos vamos para Guate y Panamá.

#ElMásGrandeDeCa https://t.co/36MJ41vpnT",142,33,2019,196452,175,0.09
878,"Ha llegado la Copa Premier Centroamericana,donde los equipos presentarán a los jugadores con los cuales participarán en los torneos locales e internacionales.
Se viviran partidos de mucha intensidad,creando nuevos clásicos regionales.

@CopaPremierCA https://t.co/904YNk9fxv",115,31,2019,196452,146,0.07
879,"¡Feliz Cumpleaños Roger!

Los mejores deseos y éxitos de parte del Club Olimpia Deportivo 

¡Tu casa!

#CumpleañosAlbo https://t.co/SZikbQIr5C",249,27,2019,196452,276,0.14
880,Muchas Gracias al Profe Manuel Keosseian Y al Profesor Alejandro Martínez por defender está camiseta hasta el último minuto. https://t.co/MRywgSXBtF,330,54,2019,196452,384,0.2
881,Comunicado Oficial Club Olimpia Deportivo https://t.co/RZlPTlz3o7,265,101,2019,196452,366,0.19
882,Comunicado Club Olimpia Deportivo https://t.co/4GsDQdc8Ao,82,14,2019,196452,96,0.05
883,"¡Feliz Cumpleaños a uno de los nuestros! 

¡Felicidades Alex! 

¡Olimpia es tu casa!

#CumpleañosAlbo 

@Lpz10alex https://t.co/We7AyGaZWG",367,31,2019,196452,398,0.2
884,"Ya podes ver la galería de imágenes con todo el color que la mejor afición de Centroamérica nos dejó en la Gran Final.

https://t.co/Q36ueZBgv5 https://t.co/3Dn9Gscq2Z",304,41,2019,196452,345,0.18
885,"Comunicado Oficial Club Olimpia Deportivo 

https://t.co/U32ub8Fvxm",227,70,2019,196452,297,0.15
886,"¿Caemos? Nos levantamos las veces que sea necesario.

La mejor afición de Centroamerica

Somos Olimpia
 #ElMasGrandeDeCA https://t.co/k4ULrdXJl2",332,67,2019,196452,399,0.2
887,"Finalizó el partido en el Nacional de Tegucigalpa. Hemos perdido el campeonato.

Olimpia 0-1 Motagua 

¡Hasta el último minuto! | #ElMásGrandeDeCa https://t.co/n3gCv4Uh2C",103,34,2019,196452,137,0.07
888,"Min. 50 | Continúa el segundo tiempo en medio de una fuerte lluvia.

Olimpia 0-1 Motagua 

Vamos leones,🦁 ¡Hasta el último minuto! 

#ElMásGrandeDeCa",18,2,2019,196452,20,0.01
889,"Fin del primer tiempo. Nos vamos al descanso con el marcador en contra.  

Olimpia 0-1 Motagua 

Vamos leones,🦁 ¡Hasta el último minuto! 

#ElMásGrandeDeCa https://t.co/pCRMU4m10h",41,12,2019,196452,53,0.03
890,"Min. 17 | Gol de Motagua.  

Vamos leones,🦁 ¡Hasta el último minuto! 

#ElMásGrandeDeCa",16,5,2019,196452,21,0.01
891,"Min. 10 |  Edwin Rodríguez sale del terreno de juego por una lesión.  

Olimpia 0-0 Motagua 

Vamos leones,🦁 ¡Hasta el último minuto! 

#ElMásGrandeDeCa",7,0,2019,196452,7,0.0
892,"Inicia la Gran Final del fútbol hondureño en el Nacional de Tegucigalpa ⚽️ 

Vamos con todo Olimpia, 💪a luchar ¡Hasta el último minuto! 🦁

#ElMásGrandeDeCa https://t.co/Ql4UeoPqTE",46,14,2019,196452,60,0.03
893,"Ganadores pases dobles para la Gran Final.

Reclamar boleto en el portón 2 de camerino a partir de la 1:00 pm https://t.co/1KsIC1oylC",47,5,2019,196452,52,0.03
894,"¡Hoy hay Gran Final! ¡Hoy juega Olimpia!

Llego el dia.Hasta acá nos trajo la ruta.

¡Hoy más que nunca saquen las banderas y camisas que este equipo jamás jugó sólo ¡Siempre jugamos MILLONES!

¡Hasta el último minuto!

#ElMásGrandeDeCa https://t.co/OePTRzfJ4P",293,100,2019,196452,393,0.2
895,"¡Olimpista! Mañana seremos mayoría y necesitamos tu apoyo hasta el último minuto pero también necesitamos tu apoyo responsable.

¡La mejor afición de Centroamérica! https://t.co/fI2ZXjhSqR",105,31,2019,196452,136,0.07
896,Comunicado Club Olimpia Deportivo https://t.co/j9edtohE0F,123,30,2019,196452,153,0.08
897,"¡VAMOS LEONES, VAMOS A GANAR Y UNA VEZ MÁS CELEBRAR! El equipo más grande del país y sus aficionados buscan que la corona del fútbol nacional vuelva a casa. ¡Vamos Olimpia, vamos Campeón! 

Banco Atlantida máximo patrocinador de ese sentimiento que llevas en el pecho. https://t.co/6zBY0RIgOP",175,33,2019,196452,208,0.11
898,"¡La Gran Final! Con la ilusión intacta 

¡Somos Olimpia!

¡El Más Grande de Centroamérica!

#HastaElÚltimoMinuto https://t.co/54H2fHSlDX",212,54,2019,196452,266,0.14
899,"Mecanica #1: Subí una foto con la indumentaria oficial Umbro y te vas para la Gran Final.

¡Vamos Olimpia! https://t.co/Vrb8Z7Zz4k",224,26,2019,196452,250,0.13
900,"Sólo pasamos a decirles que vamos a regalar boletos para la Gran Final.

¿La mecánica? Vayan buscando su camisa,bandera y todos los tickets de local de esta temporada....a las 7:00 pm comenzamos.

¡Hasta el último minuto!

#ElMásGrandeDeCa https://t.co/NnVfObaDzo",238,36,2019,196452,274,0.14
901,"¡A estadio lleno!

 La mejor afición de Centroamérica pintará de blanco el Nacional y apoyará al León hasta él último minuto.

¡Somos Olimpia!

#ElMásGrandeDeCa https://t.co/tdUH7vL9Jp",249,61,2019,196452,310,0.16
902,El Club Olimpia en conjunto con Diunsa y Umbro hicieron entrega el día de ayer del donativo alcanzado por la venta de la camiseta conmemorativa a la lucha del Cáncer Infantil a la Fundación Hondureña del Niño Con Cáncer seguido de firma de autógrafos para los aficionados. https://t.co/aH6Km8k4ac,114,21,2019,196452,135,0.07
903,"Se llevó a cabo la reunión de seguridad entre directivos del Club Olimpia,Policía Nacional,Bomberos,Cruz Roja y la Ultra Fiel para establecer los elementos de seguridad para la Gran Final del próximo domingo.

En paz a llenar y pintar de blanco el Nacional. https://t.co/oqvXh9ufYQ",164,38,2019,196452,202,0.1
904,"¡Mitad de semana! ¡Olimpista! ¿Ya compraste tu boleto para la Final?

Sol 150 Sombra 250 Silla 600 

20% de descuento a quienes llenaron el Nacional contra Lobos.

DESCUENTO NO ES VALIDO EN EL SECTOR DE SILLA.

#ElMásGrandeDeCa https://t.co/0Csy0Ufwpg",161,31,2019,196452,192,0.1
905,¡Olimpia somos todos! No te pierdas la firma de autógrafos del Olimpia este miércoles 29 de mayo en Diunsa Los Próceres https://t.co/9j9uOB7Skt,125,25,2019,196452,150,0.08
906,"Ya podes la galería de imágenes que nos dejó la Final de ida en el estadio Nacional 

#ElMásGrandeDeCa 

https://t.co/TWVCFYlEi5 https://t.co/eHBOmas8Il",133,19,2019,196452,152,0.08
907,"¡Olimpia femenino también en la Final!

Vamos a apoyar a nuestro equipo femenino en la Final del Torneo Regional.

¡Vamos Olimpia!

#ElMásGrandeDeCa 

Entrada:25 Lps https://t.co/qGVWeDzz3P",107,24,2019,196452,131,0.07
908,"¡El Nacional pintado de blanco!

Preparen las caravanas desde todos los puntos del país que el domingo el León peleará hasta el último minuto para lograr la 31

¡Somos Olimpia!

#ElMásGrandeDeCa https://t.co/vob3bXMhPM",354,105,2019,196452,459,0.23
909,"Visitá las redes sociales de nuestro máximo patrocinador Banco Atlántida y participá en la mecánica para ganar pases dobles en la Zona Atlántida sector de Silla del estadio Nacional.

¡La Final la jugamos juntos!

#ElMásGrandeDeCa https://t.co/6a4eMAtvEz",96,19,2019,196452,115,0.06
910,"¡En este abrazo estamos todos!

Vamos a dar el último paso.

De blanco el Nacional en una fiesta inolvidable.

¡Hasta el último minuto!

#ElMásGrandeDeCa https://t.co/G6iTkKJftJ",308,66,2019,196452,374,0.19
911,"⏱️94"" Fin del Partido Motagua 2 - 2 Olimpia #ElMasGrandeDeCA  #HastaElÚltimoMinuto https://t.co/tYyMCcwHYr",106,43,2019,196452,149,0.08
912,"⏱️91"" ⬅️Leandro Sosa ➡️ Junior Lacayo https://t.co/FDmhK25Q9I",37,3,2019,196452,40,0.02
913,"⏱️90"" Gooooollll!!! ⚽ Auto Gol de Marcelo Pereira Motagua 2 - 2 Olimpia #ElMasGrandeDeCA #HastaElÚltimoMinuto https://t.co/BICvk5waRp",143,28,2019,196452,171,0.09
914,"⏱️81"" Penal para el Olimpia. Falta contra Maylor Nuñez",15,2,2019,196452,17,0.01
915,"⏱️53"" ⬅️Deybi Flores ➡️ German Mejia https://t.co/qwFCUOfMUh",16,4,2019,196452,20,0.01
916,"⏱️46"" Inicia la segunda parte del encuentro. Vamos Olimpia! #ElMasGrandeDeCA #HastaElÚltimoMinuto",9,3,2019,196452,12,0.01
917,"⏱️45"" Nos vamos al descanso. Motagua 2 - 1 Olimpia. https://t.co/fxOAoiS1lV",22,7,2019,196452,29,0.01
918,"⏱️""22 Pereira. Motagua 2 - 1 Olimpia",8,1,2019,196452,9,0.0
919,"⏱️17"" Gol. Olimpia 1- 1 Motagua",8,2,2019,196452,10,0.01
920,"⏱️1"" Gooooll!!!! Ever Alvarado anota para #ElMasGrandeDeCA #HastaElÚltimoMinuto https://t.co/9aC7EFnR0U",191,52,2019,196452,243,0.12
921,Inicia la Gran Final... Vamos Olimpia!!! #HastaElUltimoMinuto #ElMasGrandeDeCA https://t.co/DgdWMStlhO,32,5,2019,196452,37,0.02
922,Así sale #ElMasGrandeDeCA hoy. https://t.co/RTCaFwVTZT,75,34,2019,196452,109,0.06
923,"Esta Final la ganamos juntos.

Que esta imagen sea tu foto de perfil en redes sociales.

¡Somos Millones! Vamos a CREER 

#ElMásGrandeDeCa https://t.co/c9Qhq5PUsj",392,144,2019,196452,536,0.27
924,#NuevaFotoDePerfil,74,8,2019,196452,82,0.04
925,León venezolano!! https://t.co/lp4LoAcpea,178,20,2019,196452,198,0.1
926,"¡Día de Final! 

Hoy no juegan once ¡Hoy jugamos millones!

¡Hasta el último minuto! 

#ElMasGrandeDeCA https://t.co/32ygwROydK",272,73,2019,196452,345,0.18
927,"¡Feliz Dia del Periodista!

A todos los comunicadores en su dia el Club Olimpia Deportivo les extiende un saludo de felicitación por tan loable labor. https://t.co/0zS0TvYS2T",113,28,2019,196452,141,0.07
928,"No son once en la cancha ¡SOMOS MILLONES!

Vamos hasta el final ¡Hasta el último minuto! 

¡Somos Olimpia! 

El Más Grande de Centroamérica!

#HastaElÚltimoMinuto 
#ElMasGrandeDeCA 
#Creer https://t.co/t0yVA6AtCr",657,232,2019,196452,889,0.45
929,"Con respeto y convivencia.

Con valor, sacrificio, trabajo en equipo, tolerancia, juego limpio y disciplina jugaremos la gran final.

¡Somos Olimpia! #ElMásGrandeDeCa
#HastaElÚltimoMinuto https://t.co/zPlZrT3Oz3",244,59,2019,196452,303,0.15
930,"¡🤝Unidad ejemplar! 
La  esencia del fútbol.”balón y amistad entre las juntas directivas de una final que merece la paz en el estadio"" 

Azules y blancos jugarán 180 minutos el mejor de la cancha será el digno campeón.

Respeto y espectáculo; el ganador la gran afición hondureña. https://t.co/1NrEDYkYYG",332,82,2019,196452,414,0.21
931,"¡El León está listo para la Final!

#HastaElÚltimoMinuto 
#ElMásGrandeDeCa https://t.co/kBVQSnZscR",191,47,2019,196452,238,0.12
932,"¡El lider de goleo del Clausura está de Cumpleaños!

¡Feliz Cumpleaños Jorge!

¡Esta es tu casa!

#CumpleañosAlbo https://t.co/NFeXaIppVC",355,51,2019,196452,406,0.21
933,"Olimpismo en estado puro.

Si alguien lo representa es el.

@rrojasl 

#ElMásGrandeDeCa https://t.co/YPrFouywbS",488,53,2019,196452,541,0.28
934,"La sucesión del golazo del máximo goleador del Clausura.

¡Olimpistas! Uno de la casa 
De los nuestros.

Jorge Renan Bengúche Ramírez 

#HastaElÚltimoMinuto 
#ElMásGrandeDeCa https://t.co/Bd3UOpqbuV",231,39,2019,196452,270,0.14
935,"¡La postal final!

Buenas noches Olimpistas a retomar fuerzas para la Final.

¡Vamos Olimpia! ¡Somos el Más Grande de Centroamérica! https://t.co/yg1IQPGBHh",659,200,2019,196452,859,0.44
936,"¡Hasta el último minuto! 

Nos vemos en la Final

#Creer
#ElMasGrandeDeCA https://t.co/OUaEvJh6lo",221,56,2019,196452,277,0.14
937,"¡Estamos en la final!
Termina el partido 4-1 en el nacional.
¡Muchas gracias a la afición! 
#ElMásGrandedeCA https://t.co/q9VASZDkt5",222,88,2019,196452,310,0.16
938,"¡GOOoooooOOOOOOOOOoooooL deeeel Leooooon!!
¡El TORO Bengúcheeee mete el 4-1 en el nacional! 
¡Vamos por esa copa!
#VamosOLIMPIA https://t.co/vYvUHqcT8V",143,40,2019,196452,183,0.09
939,"¡GOOoooooOOOOOOOOOoooooL deeeel Leooooon!!
¡Ever Alvarado pone el 3-1 en el nacional! 

#VamosOLIMPIA https://t.co/BKDJ2zzh8I",160,33,2019,196452,193,0.1
940,"Medio tiempo en el nacional ganando 2-0, #VamosOLIMPIA ! https://t.co/TwAgrOpf7Z",42,5,2019,196452,47,0.02
941,¡Goooooooool de Bengúche! ¡2-0 gana el más queridoooo! #VamosLeon https://t.co/bhzePh42vM,180,43,2019,196452,223,0.11
942,¡Goooooooool de Deiby Floresss! ¡1-0 gana el más queridoooo! #VamosLeon https://t.co/yady7r9mbL,171,38,2019,196452,209,0.11
943,"⏱1' Arranca la semifinal hoy, ¡Vamos leoness! https://t.co/sCw0jElYBS",29,4,2019,196452,33,0.02
944,Los ganadores reclamar pases dobles en el portón 2 sector de camerinos https://t.co/aF1LnG3gao,26,4,2019,196452,30,0.02
945,"¡El Más Grande de Centroamérica nos espera hoy!

¡A llenar el Nacional!

¡Hasta el último minuto!

📅 19/05/19
🏟 Estadio Nacional 
⏰ 04:00 Pm
📺 Canal 5 @el5hn - Tigo Sport

#ElMásGrandeDeCa",153,35,2019,196452,188,0.1
946,"Las reservas se juegan el pase a la final en el preliminar.

Desde temprano en el Nacional para apoyar a Olimpia reservas

#LaReserva 
#ElMásGrandeDeCa https://t.co/paikE1TnFf",43,8,2019,196452,51,0.03
947,"¡Olimpista! Necesitamos tu apoyo hasta el último minuto pero también necesitamos tu apoyo responsable.

¡La mejor afición de Centroamérica! https://t.co/CfYXN0mTCD",184,55,2019,196452,239,0.12
948,Comunicado Club Olimpia Deportivo https://t.co/hx8T92eQJQ,80,14,2019,196452,94,0.05
949,"Declaraciones Leandro Sosa previa juego de vuelta semifinal

#ElMásGrandeDeCa https://t.co/X9HkpC8zam",94,13,2019,196452,107,0.05
950,"Y un día como hoy pero en el 2006...

Disfrútenlo

#ElMásGrandeDeCa https://t.co/EDKyQL83a4",262,71,2019,196452,333,0.17
951,"Un día como hoy se cumplen 60 años de la primera gesta de un Club hondureño a nivel internacional.

El Club Olimpia se coronoba campeón de Centroamérica y México derrotando a la Liga Deportiva Alajuelense.

Ese día nació ""La Garra Catracha"" 

#ElMásGrandeDeCa https://t.co/YKbLiMDgeU",222,78,2019,196452,300,0.15
952,"¡A estadio lleno! Olimpia tendrá el apoyo de miles en el Nacional y de millones alentando desde todos los rincones del mundo

¿Cuál fue el gol que más celebraste del León?

Participá en el sorteo de entradas a Sol para el domingo.

¡Hasta el último minuto!

#ElMásGrandeDeCa https://t.co/YFOYd30VjT",193,30,2019,196452,223,0.11
953,Nota de Duelo Club Olimpia Deportivo https://t.co/OPdiNcfuN6,112,22,2019,196452,134,0.07
954,"¡A llenar el Nacional!

¡Hasta el último minuto!

📅 19/05/19
🏟 Estadio Nacional 
⏰ 04:00 Pm
📺 Canal 5 @el5hn - Tigo Sport

#ElMásGrandeDeCa 

NIÑOS GRATIS SOLAMENTE EN LA LOCALIDAD DE SOL https://t.co/5DYdhwMQK1",96,28,2019,196452,124,0.06
955,"Dinámica #2 

1-Ingresa en Facebook a la página de SalvaVida.

2- Seguí las indicaciones para que disfrutés de la experiencia Olimpia-SalvaVida. 

#ElMásGrandeDeCa https://t.co/TjpmstNvU5",43,7,2019,196452,50,0.03
956,"Lo empezamos juntos, lo terminamos juntos.

Buen miércoles para todo el pueblo Olimpista en cada rincón del planeta.

Vamos a apoyar  ¡Hasta el último minuto!

#ElMásGrandeDeCa https://t.co/VC6qCxgLAy",171,28,2019,196452,199,0.1
957,"Compra tu camiseta Oficial en los puntos Tengo y obtén acceso a la Zona Olimpia-SalvaVida en el sector de Silla del estadio Nacional.Son 50 espacios. Aplican Restricciones.

#SomosOlimpia
#ElMásGrandeDeCa https://t.co/lU7KoW293K",43,10,2019,196452,53,0.03
958,"Empate en semifinal de reservas

La vuelta en el Nacional el domingo de Preliminar de Olimpia - Lobos Upn 

Yamir Maldonado anotador del gol

¡Dale León!

#LaReserva https://t.co/Z9IhtqFhrC",43,7,2019,196452,50,0.03
959,"La experiencia Olimpia-SalvaVida se volverá a vivir en el partido de vuelta de la semifinal Vrs Lobos Upn.

Pendientes de las promociones que Olimpia y SalvaVida traen para la mejor afición de Centroamérica.

#ElMásGrandeDeCa https://t.co/sPlXMIe0Fk",126,19,2019,196452,145,0.07
960,Quinto mes consecutivo 💪💪💪💪 https://t.co/Pmcr4ePeGy,144,33,2019,196452,177,0.09
961,Nota de Duelo Club Olimpia Deportivo https://t.co/fbCH32naG4,56,10,2019,196452,66,0.03
962,"¡Feliz Día de La Madre! 

""Porque no puede haber en la tierra,una imagen más clara de Dios""

Felicidades madres en este día 

#SemanaDeLaMamaOlimpista 
#ElMásGrandeDeCa https://t.co/m8QeoTcGmy",146,42,2019,196452,188,0.1
963,"Jorge Renan Bengúche Ramírez 

11 Goles Torneo Clausura 2019

Excelente servicio 

🌟🌟🌟🌟🌟 https://t.co/1uSSGuNoBX",381,73,2019,196452,454,0.23
964,"¿Qué dicen? ¿Lo llenamos? 

¡Hasta el último minuto!

#ElMásGrandeDeCa https://t.co/q6R4Ine3Gg",248,39,2019,196452,287,0.15
965,Salimos con triunfo Hoy de Choluteca! #ElmasgrandeCA vamos a llenar el Nacional!!! https://t.co/sMqxWLKEm6,184,69,2019,196452,253,0.13
966,⏱️84' ⬅️Benguche ➡️ Lacayo,15,0,2019,196452,15,0.01
967,⏱️76'   ⬅️Chavasco ➡️ Alejandro Reyes,15,1,2019,196452,16,0.01
968,⏱️75' Sale expulsado Eduard Reyes de Lobo UPN. Doble Tarjeta Amarilla,17,2,2019,196452,19,0.01
969,⏱️75' Goooooolllllll Jorge Ramírez de Nuevoooooo.... Hat Trick.... Esta On 🔥 #elmasgrandedeca https://t.co/180va0Ia7H,165,32,2019,196452,197,0.1
970,⏱️62' Gol de Lobos UPN 1- Olimpia 2,16,4,2019,196452,20,0.01
971,⏱️57' Goooolllll!!! Jorge Ramirez!!!! #elmasgrandedeca https://t.co/qnfatBVmFB,55,15,2019,196452,70,0.04
972,⏱️45' Olimpia 1 - Lobos UPN 0 #elmasgrandedeca Nos vamos al descanso. https://t.co/AX3kW3jUXC,28,8,2019,196452,36,0.02
973,⏱️24' Tarjeta amarilla para Sonny Fernández de Lobos UPN.,10,0,2019,196452,10,0.01
974,⏱️19' Tarjeta amarilla para Jerry Bengston,11,1,2019,196452,12,0.01
975,⏱️10' Jorge Benguche... Goooolllll del Olimpia!!!! https://t.co/1kyrbvNp2O,118,14,2019,196452,132,0.07
976,⏱️9' Tarjeta amarilla para Edward Reyes de Lobos UPN.,14,0,2019,196452,14,0.01
977,⏱️1' Comienza nuestra semifinal... Vamos Olimpia!!!! #elmasgrandedeca https://t.co/ejA8X9bPIL,22,4,2019,196452,26,0.01
978,"Así juega el León esta tarde:

#SemanaDeLaMamaOlimpista 

¡Hasta el último minuto!

#ElMásGrandeDeCa https://t.co/fXnqLBanRC",74,27,2019,196452,101,0.05
979,"¡Vamos Olimpia!

Dejá tu mensaje de apoyo al más grande y desde donde apoyas a Olimpia 

¡Hasta el último minuto!

#ElMásGrandeDeCa https://t.co/geQggYXKDB",95,16,2019,196452,111,0.06
980,"¡Lo hicimos 30 veces lo intentaremos una vez mas!
¡Somos Olimpia!

Vamos a apoyar hoy al León hasta el último minuto

#ElMásGrandeDeCa https://t.co/CpgWH2jpkt",186,51,2019,196452,237,0.12
981,"¡Saquen las banderas y las camisetas que hoy juega el Orgullo Nacional!

¡Hasta el último minuto!

📅 11/05/19
🏟 Emilio Williams
⏰ 03:00 Pm
📺 Canal 5 @el5hn - Tigo Sport 

¡Locales en todos lados!

#ElMásGrandeDeCa https://t.co/zhhUyp3YH2",123,33,2019,196452,156,0.08
982,Comunicado oficial Club Olimpia Deportivo https://t.co/INWSbIA6EJ,129,31,2019,196452,160,0.08
983,"¡Esta semana jugamos por Ellas!

Identificá a los jugadores que saldrán con el apellido de su mamá en la camiseta este sábado en Choluteca y ganá entradas para el partido de vuelta de semifinales en el Nacional. ¡Somos Olimpia! ¡Somos Umbro!

#ElMásGrandeDeCa
#OlimpiaUmbro https://t.co/vmAvwJKE6H",102,28,2019,196452,130,0.07
984,"¡Felicidades Danny!

Feliz Cumpleaños a nuestro ex-jugador y Dt del equipo de Reservas Elvis Danilo Turcios.

 ¡Esta es tu casa! @dannyturcios10

#CumpleañosAlbo https://t.co/0hX6Thr1aL",109,16,2019,196452,125,0.06
985,"¡Llegó el momento de hacernos un nudo!

Comienza la Semifinal y el León nos convoca.

¡Hasta el último minuto!

📅 11/05/19
🏟 Emilio Williams
⏰ 15:00 Pm
📺 Deportes TVC-Tigo Sport 

¡Locales en todos lados!

#ElMásGrandeDeCa https://t.co/QcJC0f0lE0",128,41,2019,196452,169,0.09
986,"¡Nuestra historia y nuestro orgullo en una camiseta!

Adquirí la indumentaria oficial del Más Grande de Centroamérica en https://t.co/b3d7US0Ypk 

¡Somos Olimpia! ¡Somos Umbro!

Envíos dentro y fuera del país a través de UPS.

#ElMásGrandeDeCa 
#OlimpiaUmbro https://t.co/kZxbdCnjXA",193,40,2019,196452,233,0.12
987,"Comienzan las Semifinales y no podes quedarte sin la piel del Más Grande.

Escoge el artículo que más te guste del León y te lo llevamos a tu casa con HUGO APP.

¡Somos Olimpia!

#ElMásGrandeDeCa https://t.co/rdmwnCJO14",48,4,2019,196452,52,0.03
988,https://t.co/XvdjvARkM3,117,23,2019,196452,140,0.07
989,"¡Olimpia Femenino a la Final!

Alejandra Amador, Fanny Rodriguez, Mirian Valladares  y Jicela Villeda(Doblete)

¡Vamos Olimpia! 

#ElMásGrandeDeCa https://t.co/xoj9TDKmTs",71,20,2019,196452,91,0.05
990,"¡El León está listo para las Semifinales!

En el Día Mundial de Star Wars Que La Fuerza Los Acompañe

¡Vamos Olimpia!

EL MÁS GRANDE DE CENTROAMERICA

#MayThe4thBeWithYou https://t.co/JqKXvegi1o",144,30,2019,196452,174,0.09
991,"Final en el Birichiche 

Olimpia 3 - Real de Minas 0

Maylor Núñez 18'
Júnior Lacayo 34'
Guillermo Chavasco 37' 

¡Listos para Semifinales!

#ElMásGrandeDeCa https://t.co/15gUA5xhEx",68,21,2019,196452,89,0.05
992,"Goooooooooooooool
Goooooooooooooool

Guillermo Chavasco pone el 3-0 a los 36 minutos 

Olimpia 3 - Real de Minas 0

¡Vamos Olimpia! https://t.co/m6vDx94DFW",95,13,2019,196452,108,0.05
993,"Gooooooooooooool
Gooooooooooooool

Júnior Lacayo pone el 2-0

Olimpia 2 - Real de Minas 0

¡Vamos Olimpia! https://t.co/fUTAraammG",36,7,2019,196452,43,0.02
994,"Gooooooooooooool
Gooooooooooooool

Maylor Núñez abre el marcador 

Olimpia 1 - Real de Minas 0

¡Vamos Olimpia! https://t.co/7kjLFrBtd6",40,4,2019,196452,44,0.02
995,"Así sale el León esta tarde:

Edrick Menjivar,Maylor Núñez,Jonathan Paz,Ever Alvarado,Elmer Güity,Deiby Flores,Jorge Álvarez,Leandro Sosa,Alejandro Reyes,Jorge Bengúche,Jerry Bengston 

¡Vamos Olimpia!

#ElMásGrandeDeCa https://t.co/SE9irQIM5g",60,8,2019,196452,68,0.03
996,"¡El León se presenta hoy ante su pueblo!

¡Vamos Olimpia!

📅 Amistoso
🏟 El Birichiche 
⏰ 18:30 hrs
💵 100 Lps

¡Locales en todos lados!

#ElMásGrandeDeCa https://t.co/FrZxto8cMO",52,9,2019,196452,61,0.03
997,"¡Felicidades Capitán!

Feliz Cumpleaños te desea tu casa y tu gente 

#CumpleañosAlbo 
#ElMásGrandeDeCa https://t.co/fVowWRrf7Y",236,41,2019,196452,277,0.14
998,"¡El León se sigue preparando de cara a las Semifinales!

¡Vamos Olimpia!

📅 Amistoso
🏟 El Birichiche 
⏰ 18:30 hrs

¡Locales en todos lados!

#ElMásGrandeDeCa https://t.co/Y8EK6XVO7P",62,18,2019,196452,80,0.04
999,"Final en el Roberto Martínez Ávila 

Santos 0 - Olimpia 2

Jerry Bengston 36
Wilson Palacios 80

¡Vamos Olimpia!

#ElMásGrandeDeCa https://t.co/klq86bwWXh",47,16,2019,196452,63,0.03
1000,"Gooooooooooooooool
Gooooooooooooooool

Wilson Palacios de penal a los 80 minutos 

Santos 0 - Olimpia 2 

¡Vamos Olimpia!

#ElMásGrandeDeCa https://t.co/v0oBxFazDr",92,19,2019,196452,111,0.06
1001,"Doble cambio en Olimpia:

Sale:Edrick Menjivar
Entra:Alex Güity 

Sale:Ever Alvarado
Entra:Elvin Casildo 

¡Vamos Olimpia! https://t.co/IIm7UDq4Yj",15,1,2019,196452,16,0.01
1002,"Inicia el segundo tiempo en el Roberto Martínez Ávila 

Santos 0 - Olimpia 1

Jerry Bengston 36

¡Vamos Olimpia!

#ElMásGrandeDeCa",5,0,2019,196452,5,0.0
1003,"Medio tiempo en el Roberto Martínez Ávila 

Santos 0 - Olimpia 1 

Jerry Bengston 36

¡Vamos Olimpia!

#ElMásGrandeDeCa https://t.co/KmaaUnpw5o",20,6,2019,196452,26,0.01
1004,"Goooooooooooooooool
Goooooooooooooooool

Jerry Bengston a los 36' minutos del primer tiempo

Santos 0 - Olimpia 1

¡Vamos Olimpia!

#ElMásGrandeDeCa https://t.co/qCr4mcMPx0",80,12,2019,196452,92,0.05
1005,"15' minutos del primer tiempo

Santos 0 - Olimpia 0

¡Vamos Olimpia!

#ElMásGrandeDeCa",10,1,2019,196452,11,0.01
1006,"Inicia el partido en el Roberto Martínez Ávila 

Santos 0 - Olimpia 0

¡Vamos Olimpia!

#ElMásGrandeDeCa https://t.co/uCoRB76p1T",7,1,2019,196452,8,0.0
1007,"Así sale el León esta noche:

Edrick Menjivar,Maylor Nuñez,Jonathan Paz,Ever Alvarado,Elmer Güity,Deiby Flores,Alejandro Reyes,Leandro Sosa,José Pinto,Jorge Bengúche,Jerry Bengston

¡Vamos Olimpia! 

#ElMásGrandeDeCa https://t.co/hbyGY5hAFA",65,10,2019,196452,75,0.04
1008,"¡Siguatepeque! ¡El León llega hoy!

¡Vamos Olimpia!

📅 Amistoso
🏟 Roberto Martínez Avila
⏰ 19:00 hrs
💵 80 Lps

¡Locales en todos lados!

#ElMásGrandeDeCa https://t.co/eheuipRQVQ",52,11,2019,196452,63,0.03
1009,"Feliz Día del Trabajador para todos los Olimpistas en cada rincón del planeta.

#DiaDelTrabajo
#ElMásGrandeDeCa https://t.co/JhrdrB4Aik",128,24,2019,196452,152,0.08
1010,"¡El León se prepara en Siguatepeque
Para las Semifinales!

¡Olimpista! Te esperamos este jueves en el Roberto Martínez para apoyar al Más Grande de cara a la parte final del Torneo.

¡Vamos Olimpia!

#ElMásGrandeDeCa https://t.co/U3AHWqop44",80,16,2019,196452,96,0.05
1011,https://t.co/1aTGn1sC8Z,113,32,2019,196452,145,0.07
1012,"Final en Choluteca

¡Nos vemos en Semifinales! https://t.co/ACMmeMG1nx",49,7,2019,196452,56,0.03
1013,"Gol de Lobos Upn

Franco Güity 

Lobos Upn 2 - Olimpia 0

¡Vamos Olimpia!",12,1,2019,196452,13,0.01
1014,"Primer cambio en Olimpia:

Sale:Axel Gómez
Entra: Elvin Casildo

¡Vamos Olimpia!",5,0,2019,196452,5,0.0
1015,"Inicio del segundo tiempo

¡Vamos Olimpia!",12,2,2019,196452,14,0.01
1016,"Final del primer tiempo en Choluteca:

Lobos Upn 1 - Olimpia 0

¡Vamos Olimpia! https://t.co/FPQsKvDk7j",19,3,2019,196452,22,0.01
1017,"Gol de Lobos Upn a los 22' minutos
Dennis Lagos  

Lobos Upn 1 - Olimpia 0

¡Vamos Olimpia!",11,0,2019,196452,11,0.01
1018,"16' minutos del primer tiempo

Lobos Upn 0 - Olimpia 0

¡Vamos Olimpia!

#ElMásGrandeDeCa",2,0,2019,196452,2,0.0
1019,"Inicia el partido en el Emilio Williams 

Lobos Upn - Olimpia 

¡Vamos Olimpia!

#ElMásGrandeDeCa https://t.co/qk50gH817j",24,1,2019,196452,25,0.01
1020,"¡Choluteca! ¡El Líder Absoluto cierra las vueltas esta tarde!

¡Vamos Olimpia!

📅 Fecha 18
🏟 Estadio Emilio Williams 
⏰ 15:00 hrs
📺 Megaclásicos Tvc 

¡Locales en todos lados!

#ElMásGrandeDeCa https://t.co/3fnLFSbL4F",62,18,2019,196452,80,0.04
1021,"!Feliz Cumpleaños Anthony!

Felicidades a uno de nuestros orgullos en el extranjero.

¡Olimpia es tu casa!

#CumpleañosAlbo 

@choko_9 https://t.co/TrXenQUtQf",196,21,2019,196452,217,0.11
1022,"Los resultados a la fecha del equipo femenino antes del clásico del viernes en el Birichiche.

¡Somos Olimpia!

#ElMásGrandeDeCa https://t.co/fQFXERkMdo",70,15,2019,196452,85,0.04
1023,"¡El León cierra las vueltas en Choluteca!

¡Olimpista de la Zona de Sur! El Más Popular te convoca para llenar una vez el Emilio Williams.

📅 Fecha 18
🏟 Estadio Emilio Williams 
⏰ 15:00 hrs
📺 Deportes Televicentro 

¡Locales en todos lados!

#ElMásGrandeDeCa https://t.co/YcD5C8uIgx",90,23,2019,196452,113,0.06
1024,"¡Las Superlider del Torneo Femenino juegan el Clásico! 

¡Olimpista!

Nos vemos el viernes en el Birichiche para apoyar a Olimpia Femenino en su camino hacia el campeonato regional.

📅 Fecha 14
🏟 Estadio Birichiche 
⏰ 16:00 hrs
💸 Entrada Gratis 

#ElMásGrandeDeCa https://t.co/tAqYd4HjK1",42,10,2019,196452,52,0.03
1025,"Una de las decisiones más difíciles:

1-Belarmino Rivera
2-Carlos Prono
3-Noel Valladares
4-Donis Escober 

#ElMásGrandeDeCa https://t.co/xktiybgJtN",222,28,2019,196452,250,0.13
1026,"Comienzo de semana y el León se prepara para cerrar el torneo en Choluteca.

¡Vamos Olimpia!

#ElMásGrandeDeCa https://t.co/HMlhPoET4t",99,18,2019,196452,117,0.06
1027,"Escoge el artículo que más te guste del León y te lo llevamos a tu casa.

¡Somos Olimpia!

#ElMásGrandeDeCa https://t.co/J1Facg12G8",76,12,2019,196452,88,0.04
1028,No te perdas mañana en La Mesa Redonda de Cinco Deportivo la entrevista al Técnico del lider indiscutible del Clausura 2019 Manuel Gregorio Keosseian. https://t.co/hXcbeIgKrH,75,15,2019,196452,90,0.05
1029,"El Club Olimpia Deportivo les desea Felices Vacaciones.

Nos volvemos a ver el sábado 27 de abril en Choluteca ante Lobos UPNFM

¡Seguimos en la ruta hacia la 31!

#SomosOlimpia
#HastaElÚltimoMinuto 
#ElMásGrandeDeCa https://t.co/OO63zKfn7P",139,21,2019,196452,160,0.08
1030,"Final en el Nacional

Olimpia 1 - Real de Minas 1

#ElMásGrandeDeCa https://t.co/9K2MFATVKR",39,12,2019,196452,51,0.03
1031,"Tercer y último cambio en Olimpia:

Sale:Leandro Sosa 
Entra:Carlos Will Mejía

¡Vamos Olimpia!

#ElMásGrandeDeCa https://t.co/qfYy9Rtcpg",7,0,2019,196452,7,0.0
1032,"Doble cambio en Olimpia:

Sale:Jorge Bengúche 
Entra: Júnior Lacayo 
Sale:Guillermo Chavasco
Entra: Alejandro Reyes https://t.co/TDAP0AI0Ps",11,1,2019,196452,12,0.01
1033,"Gol del Real de Minas 

Olimpia 1 - Real de Minas 1

!Vamos Olimpia!",28,4,2019,196452,32,0.02
1034,"Inicia el segundo tiempo en el Nacional

Olimpia 1 - Real de Minas 0

Jerry Bengston (30')

#ElMásGrandeDeCa https://t.co/4q2kU4YXUx",14,0,2019,196452,14,0.01
1035,"Medio tiempo en el Nacional

Olimpia 1- Real de Minas 0

Jerry Bengston (30')

¡Dale León!

#ElMásGrandeDeCa",34,3,2019,196452,37,0.02
1036,"Goooooooooooooooooool
Goooooooooooooooooool

El Goleador del torneo Jerry Bengston a los 30' minutos abre el marcador 

Olimpia 1 - Real de Minas 0

#ElMásGrandeDeCa https://t.co/JgiwH1huVj",86,19,2019,196452,105,0.05
1037,"20 minutos del primer tiempo 

Olimpia 0 - Real de Minas 0

¡Dale León!

#ElMásGrandeDeCa",13,1,2019,196452,14,0.01
1038,"Inicia el partido en el Nacional

Olimpia-Real de Minas 

¡Dale León!

#ElMásGrandeDeCa https://t.co/cn22I0Y3lv",33,6,2019,196452,39,0.02
1039,"Así sale el León hoy:Edrick Menjivar,Elmer Güity,Ever Alvarado,Jonathan Paz,Maylor Nuñez,Deiby Flores,Jorge Alvarez,Leandro Sosa,Guillermo Chavasco,Jorge Bengúche,Jerry Bengston.

¡Somos Olimpia!

#ElMásGrandeDeCa https://t.co/LRsJm4fiAL",64,18,2019,196452,82,0.04
1040,#NuevaFotoDePerfil,70,7,2019,196452,77,0.04
1041,"¡El León cierra de local!

Nos vemos a las 6:00 pm en el Nacional

📅 Fecha 17
🏟 Estadio Nacional
⏰ 18:00 hrs
📺 Tigo Sport 
💸 Sol 50 Sombra 100 Silla 200

Venta de boletos sólo en puntos Tengo 

¡Hasta el último minuto!

#ElMásGrandeDeCa https://t.co/ZBKTW8tC4j",51,22,2019,196452,73,0.04
1042,"¡Feliz Semana Santa pueblo Olimpista!

¡Líderes del Clausura 2019!

Ahora vamos a despedir al equipo  en el último partido de las vueltas en el Nacional. 

¡Hasta el último minuto!

#ElMásGrandeDeCa https://t.co/xa10yHVQ9k",155,34,2019,196452,189,0.1
1043,"Finaliza el clásico en San Pedro Sula. 

Real España 0-1 Olimpia 

¡Somos Olimpia!

#ElMásGrandeDeCA https://t.co/rFIxHIz4KJ",320,83,2019,196452,403,0.21
1044,"Cambio al min. 62
◀️Bengúche
▶️ Alejandro Reyes https://t.co/uF9S0B5YGd",21,1,2019,196452,22,0.01
1045,"¡Goooool del león!

Jerry bengston al minuto 23
#ElMásGrandeDeCa https://t.co/SXX4157RpY",101,23,2019,196452,124,0.06
1046,Así sale el León: https://t.co/hziT4arlpc,60,15,2019,196452,75,0.04
1047,"¡El Líder Absoluto Juega Hoy!

Que la Costa Norte saque sus camisas y sus banderas que hoy el equipo Más Grande de Centroamérica llega al Estadio Morazán.

¡Somos Olimpia!

#ElMásGrandeDeCa 
#HastaElÚltimoMinuto https://t.co/wrLayFceHD",146,43,2019,196452,189,0.1
1048,"¡Te deseamos la mejor y más pronta recuperación Edwin!

#FuerzaEdwin https://t.co/QIwcgBqq9r",157,30,2019,196452,187,0.1
1049,"El ganador de la experiencia ""Palco SalvaVida"" Byron Rodríguez junto a su acompañante  disfrutaron de una noche llena de goles.
 
Asistí a los partidos de local del Club Olimpia y participá en todas las promociones.

#ElMásGrandeDeCa https://t.co/SgbUAKQX8I",32,0,2019,196452,32,0.02
1050,"¡Feliz viernes Olimpistas!

El León ya viaja rumbo a San Pedro Sula para el Clásico de mañana!

¡Somos Olimpia!

#ElMásGrandeDeCa https://t.co/ebXVxi02rP",125,15,2019,196452,140,0.07
1051,"¡Abrazo de líder! 

¡Somos Olimpia!

#ElMásGrandeDeCa https://t.co/N63PNnagbC",201,33,2019,196452,234,0.12
1052,"La Reserva se afianza en el segundo lugar derrotando 2-0 a Juticalpa.

Limberth Perez
Daniel Moncada

#LaReserva 
#ElMásGrandeDeCa https://t.co/tv1HZWFbsm",28,8,2019,196452,36,0.02
1053,"¡El camino a la 31 nos lleva a San Pedro Sula!

¡Somos Olimpia!

¡Hasta el último minuto!

#ElMásGrandeDeCa https://t.co/csjU2EBt5P",81,28,2019,196452,109,0.06
1054,"Final en el Nacional 

Olimpia 4 - Juticalpa 0

¡Vamos Olimpia!

#ElMásGrandeDeCa https://t.co/M3YfwVdH2p",132,42,2019,196452,174,0.09
1055,"Gooooooooooooooooooooool
Gooooooooooooooooooooool

Jorge Álvarez anota el 4-0 

¡Vamos Olimpia!

#ElMásGrandeDeCa https://t.co/U8gBGMFTd3",135,32,2019,196452,167,0.09
1056,"Gooooooooooooooooooooool
Gooooooooooooooooooooool

Doblete de Jorge Bengúche 

Olimpia 3 - Juticalpa 0

#ElMásGrandeDeCa https://t.co/spe5MoAhT9",64,13,2019,196452,77,0.04
1057,"Gooooooooooooooooooool
Gooooooooooooooooooool

Jerry Bengston a los 53' minutos

Olimpia 2 - Juticalpa 0

#ElMásGrandeDeCa https://t.co/1tWUHSIdLP",71,21,2019,196452,92,0.05
1058,"Inicia el SegundoTiempo en el Nacional

Olimpia 1 - Juticalpa 0

Jorge Bengúche 24'

#ElMásGrandeDeCa",13,0,2019,196452,13,0.01
1059,"Medio Tiempo en el Nacional

Olimpia 1 - Juticalpa 0

Jorge Bengúche 24'

#ElMásGrandeDeCa https://t.co/cu1NRM70od",14,0,2019,196452,14,0.01
1060,"¡Gooooooooooooooooool!
¡Gooooooooooooooooool!

Jorge Bengúche a los 24 minutos del primer tiempo

Olimpia 1 - Juticalpa 0 https://t.co/mzhnCKbRSy",103,27,2019,196452,130,0.07
1061,"Primer cambio en Olimpia a los 15' minutos del primer tiempo:

Sale:Edwin Rodriguez(Lesión)
Entra: Guillermo Chavasco",9,1,2019,196452,10,0.01
1062,"10' minutos del primer tiempo

Olimpia 0 - Juticalpa 0

¡Vamos Olimpia!

#ElMásGrandeDeCa",13,1,2019,196452,14,0.01
1063,"¡Inicia el partido en el Nacional!

¡Dale León!

#ElMasGrandeDeCa https://t.co/qRCrOSgK5l",36,1,2019,196452,37,0.02
1064,"Así sale el León esta noche:

Edrick Menjivar,Axel Gomez,Ever Alvarado,Jonathan Paz,Maylor Nuñez,Deiby Flores,Jorge Alvarez,Leandro Sosa,Edwin Rodríguez,Jorge Bengúche y Jerry Bengston.

¡Somos Olimpia!

#ElMásGrandeDeCa https://t.co/VOuH257tyM",56,16,2019,196452,72,0.04
1065,"¡Tenemos boletos!

Lo primeros 15 mensajes de apoyo al León se van al Nacional al sector de Sol.

¡Somos Olimpia! https://t.co/u3e2Se0pLk",78,12,2019,196452,90,0.05
1066,"¡Las Reservas por el liderato esta tarde!

📅 Fecha 15
🏟 Estadio El Birichiche
⏰ 18:15 hrs
🇫🇷🇫🇷🇫🇷🇫🇷🇫🇷🇫🇷🇫🇷🇫🇷🇫🇷

#LaReserva
#ElMásGrandeDeCa https://t.co/wdDUJalW6i",20,4,2019,196452,24,0.01
1067,"¡Hoy Juega Olimpia!

Nos vemos  en el Nacional a partir de las 8:00 pm

📅 Fecha 15
🏟 Estadio Nacional
⏰ 20:00 hrs
📺 Tigo Sport 
🇫🇷🇫🇷🇫🇷🇫🇷🇫🇷🇫🇷🇫🇷🇫🇷🇫🇷

¡Hasta el último minuto!

#ElMásGrandeDeCa https://t.co/Cg9ACJEZfZ",61,19,2019,196452,80,0.04
1068,"¡El Clásico en Reservas se pintó de blanco!

Goles:Yamir Maldonado,Lesman Pavón

#LaReserva
#ElMásGrandeDeCa https://t.co/fTlzkSV2ST",43,13,2019,196452,56,0.03
1069,"¡Todos juntos vamos en la ruta hacia la 31!

Paso a paso y firmes para lograr el objetivo.

Mañana los esperamos en el Nacional 8:00 pm

¡Hasta el último minuto!

#ElMásGrandeDeCa https://t.co/9Zxo6irsr9",93,19,2019,196452,112,0.06
1070,"¡Olimpista! El miércoles vamos a consolidar el liderato

El León vuelve a contar con la mejor afición de Centroamérica para alentar hasta el final.

📅 Fecha 15
🏟 Estadio Nacional
⏰ 20:00 hrs
📺 Tigo Sport 
🇫🇷🇫🇷🇫🇷🇫🇷🇫🇷🇫🇷🇫🇷🇫🇷🇫🇷

¡Hasta el último minuto!

#ElMásGrandeDeCa https://t.co/zyKy8qTgyY",100,33,2019,196452,133,0.07
1071,"¡Lideres en la cancha,en las gradas y en las redes! https://t.co/zR3eAeuUXd",92,24,2019,196452,116,0.06
1072,"Termina el clásico capitalino.

Empatamos 0-0.

#ElMásGrandeDeCa https://t.co/JI2lNen8Lc",30,8,2019,196452,38,0.02
1073,"Cambio en Olimpia a los 81' minutos:

Sale: Leandro Sosa
Entra: Jose Pinto https://t.co/DgKjKHteAi",15,1,2019,196452,16,0.01
1074,"Arranca el 2 tiempo con 0-0 en la capital.

🇫🇷🇫🇷🇫🇷🇫🇷🇫🇷🇫🇷🇫🇷🇫🇷🇫🇷
¡Hasta el último minuto!

#ElMásGrandeDeCa https://t.co/DKAHp7rfDD",29,5,2019,196452,34,0.02
1075,"¡Peeenaaaal para los blancos!

Después de una jugada de Bengúche en el área, hay una mano clara y concede el penal a favor del Olimpia.",20,5,2019,196452,25,0.01
1076,"¡Arranca el clásico capitalino!

¡Vamos olimpia por el gane! https://t.co/7gNiOOTOyg",46,12,2019,196452,58,0.03
1077,"¡Así sale el 🦁León contra el azul en Tegucigalpa!

¡Vamos Olimpia!

#ElMásGrandeDeCa https://t.co/aFQk8FbZWC",65,26,2019,196452,91,0.05
1078,Compra tu camiseta oficial del Olimpia a L 999 con la 📲⚽️ Billetera Móvil de TENGO o también en los Kioskos TENGO de Multiplaza y Metromall en Tegucigalpa y te llevarás tu ENTRADA al #clásico 🎉COMPLETAMENTE GRATIS a cualquier localidad. https://t.co/Z94C3w21Ol,24,3,2019,196452,27,0.01
1079,"🎶Somos la mitad mas uno,somos el pueblo y el carnaval🎶

¡Hoy juega el León!

Pintemos de blanco el Nacional,
El Clásico lo jugamos juntos

¡Hasta el último minuto!

#ElMásGrandeDeCa 
#SomosOlimpia",162,44,2019,196452,206,0.1
1080,"¡Mucha fuerza ídolo!

Te deseamos una pronta recuperación para volverte a ver defender nuestro marco ¡Vamos Donis!

#FuerzaDonis https://t.co/hxvupfDGNa",222,46,2019,196452,268,0.14
1081,"Olimpistas de corazón y clientes de #BancoAtlántida, ganaron pases dobles para el Superclásico entre Club Olimpia Deportivo y Motagua este domingo 7 de Abril... https://t.co/dhpoLiUp9J",42,2,2019,196452,44,0.02
1082,"¡Este domingo comenzamos promoción para todos los partidos de local!

Guarda tu boleto de entrada del clásico y a medio tiempo sorteamos un pase para que veas al León desde palco con un acompañante.

#ElMásGrandeDeCa https://t.co/d5CcR1F2qt",58,10,2019,196452,68,0.03
1083,"Descubrí al jugador y participá en sorteos para entradas al Superclásico.

¡Somos Olimpia!

#ElMásGrandeDeCa https://t.co/nmrvcQ2kx2",59,8,2019,196452,67,0.03
1084,"El segundo gol anotado por Jorge Bengúche a los 55 y así nos llevábamos el triunfo del Puerto.

¡Somos Olimpia!

Podes disfrutar del resumen completo en el canal de Youtube del Club Olimpia.

No olvides suscribirte y activar la campana de notificaciones.

#ElMásGrandeDeCa https://t.co/Mk63VokxLQ",116,13,2019,196452,129,0.07
1085,"¡Así Edwin Rodriguez empató el marcador el domingo en el Excelsior!

¡Golaaazooo! 

#ElMásGrandeDeCa https://t.co/53Le2dex3V",119,25,2019,196452,144,0.07
1086,"¡De vuelta en casa! 

¡Que se vista de blanco cada rincón del país!

Desde hoy con la camisa del Albo en tu trabajo,en tu casa en todos lados.

¡Somos Olimpia!

#ElMásGrandeDeCa https://t.co/wheJBWJCYg",128,26,2019,196452,154,0.08
1087,"¡Este Domingo hay Fiesta en el Nacional!

 Adquirí la piel oficial del León y acompañanos en el Superclásico Nacional.

 #ElMásGrandeDeCa https://t.co/62USVv3fNH",78,19,2019,196452,97,0.05
1088,"La galería que nos dejó el triunfo sobre Platense el domingo pasado:

Completa en https://t.co/SFZYqR91x9

👉 https://t.co/LuoGh1cMve https://t.co/8zgLlMaESQ",85,14,2019,196452,99,0.05
1089,"¡El Superclásico lo jugamos juntos!

📅 Fecha 14
🏟 Estadio Nacional
⏰ 16:00 hrs
📺 Canal 5
🇫🇷🇫🇷🇫🇷🇫🇷🇫🇷🇫🇷🇫🇷🇫🇷🇫🇷

¡Hasta el último minuto!

#ElMásGrandeDeCa https://t.co/qYuVmiJQmY",73,30,2019,196452,103,0.05
1090,"¡Olimpista! ¡El Superclásico lo empezamos ganando en las gradas y con nuestros colores!

Venite este sábado y domingo a los puntos Tengo ubicados en el Mall Multiplaza en Tegucigalpa... https://t.co/Iymp6o40aB",90,22,2019,196452,112,0.06
1091,El Club Olimpia Deportivo extiende los mejores deseos en la nueva etapa de su vida a Edgard Alvarez luego de que el dia de ayer se despidiera de las canchas como jugador profesional dejando una extensa carrera futbolística... https://t.co/WL2xAhvHVB,257,38,2019,196452,295,0.15
1092,"¡Feliz inicio de semana Olimpistas!

Paso a paso en la ruta hacia la 31.

Se viene el Superclásico y vamos a pintar de blanco todos los rincones del Nacional.

¡Vamos Olimpia!

#ElMásGrandeDeCa https://t.co/kf3XzMYixA",153,38,2019,196452,191,0.1
1093,"¡Super lideres! Señoras y Señores el Olimpia de Manolo es lider del torneo!

Platense 1 - Olimpia 2

¡Vamos Olimpia!

#ElMásGrandeDeCa https://t.co/4JCESMFk5o",198,66,2019,196452,264,0.13
1094,"Min. 84 Se generan cambios en el partido.
▶️ Gullermo Chavasco
◀️ Jorge Bengúche

▶️ Alejandro Reyes
◀️ Leandro Sosa

¡Vamos Olimpia! @ Estadio Excélsior https://t.co/UCEGMTXCId",19,0,2019,196452,19,0.01
1095,"Minuto 76. 

Amarilla para Elmer Güity.

#ElMásGrandeDeCa",7,0,2019,196452,7,0.0
1096,"Min. 71 Se genera un cambio en el partido.
▶️ German Mejía
◀️ Jorge Álvarez

¡Vamos Olimpia! https://t.co/8lq9vxVVI5",10,0,2019,196452,10,0.01
1097,"¡Goooooooooooooooooooool!
¡Goooolazooooo!

¡Bengúche a los 56' minutos del segundo tiempo!

 Platense 1 -Olimpia 2

¡Vamos Olimpia! https://t.co/4PLXtqpTVy",109,21,2019,196452,130,0.07
1098,"Arranca el segundo tiempo.

¡Logramos el empate pero vamos por más! 

Platense 1 - Olimpia 1

#ElMásGrandeDeCA https://t.co/V0zoIyzQAY",20,1,2019,196452,21,0.01
1099,"Finalizan los primeros 45 minutos y logramos el empate en el excelsior.

¡Vamos León!

#ElMásGrandeDeCa",14,4,2019,196452,18,0.01
1100,"Goooooooooooooooooooool
Goooooooooooooooooooool

Edwin Rodriguez a los 45' minutos del primer tiempo

 Platense 1 -Olimpia 1

¡Vamos Olimpia! https://t.co/MQAII2hjSp",63,20,2019,196452,83,0.04
1101,"Sale Edgar Alvaréz para el Platense, y se despide del fútbol hondureño.

¡Mucha suerte campeón!

#ElMásGrandeDeCa",135,30,2019,196452,165,0.08
1102,"32 Minutos..

¡Seguimos 0-0 en el puerto!

#ElMásGrandeDeCa",7,0,2019,196452,7,0.0
1103,"Arranca el partido

¡Vamos león! https://t.co/EXZrW2nZ7N",30,4,2019,196452,34,0.02
1104,"Así sale el 🦁León en el puerto.

¡Vamos Olimpia!

#ElMásGrandeDeCa https://t.co/cz3QP5tqsf",41,21,2019,196452,62,0.03
1105,"Con un empate 1-1 en la Final de ida
Olimpia se juega el título en el Yankel Rosenthal

🏆 Torneo Nacional Femenino
🏟 Estadio Yankel Rosenthal
⏰ 15:00 hrs

🇫🇷🇫🇷🇫🇷🇫🇷🇫🇷🇫🇷🇫🇷🇫🇷🇫🇷 

¡Hasta el último minuto!

#ElMásGrandeDeCa https://t.co/dLugJLqtI8",30,4,2019,196452,34,0.02
1106,"¡Nos tomamos el Puerto!

¡Esto es Olimpia! El fenómeno social.

#ElMásGrandeDeCa https://t.co/XNWJIV0xV3",199,49,2019,196452,248,0.13
1107,"¡Saquen las banderas! ¡Saquen las camisas! 

Hoy juega El Más Grande de Centroamérica!

📅 Fecha 13
🏟 Estadio Excelsior
⏰ 16:00 hrs
📺 Tigo Sport
🇫🇷🇫🇷🇫🇷🇫🇷🇫🇷🇫🇷🇫🇷🇫🇷🇫🇷

¡Hasta el último minuto!

#ElMásGrandeDeCa https://t.co/vO6bDmwC4G",81,22,2019,196452,103,0.05
1108,"¡Olimpista! Nos vemos mañana en el puerto.

Desde las 11:00 am será la caravana desde la playa de la Coca-Cola hasta el Excelsior.

¡Vamos Olimpia!

¡La afición más grande de Centroamérica!

#HastaElÚltimoMinuto https://t.co/OLZX4xDvPK",92,30,2019,196452,122,0.06
1109,"Uno de los triunfos importantes de Olimpia en el Excelsior.

Torneo Clausura 2016 

Via Canal de Youtube Club Olimpia

https://t.co/Vme27nNhjP",23,5,2019,196452,28,0.01
1110,"¡Te recordamos siempre Arnold!

¡Feliz Cumpleaños hasta el cielo!

#CumpleañosAlbo 
#ElMásGrandeDeCa https://t.co/TLanE73FEV",311,55,2019,196452,366,0.19
1111,"¡Domingo apto para acompañar a Olimpia!

Unamonos a la caravana Olimpista hasta el estadio Excelsior desde las 11:00 am Playa de la Coca-Cola

¡Clima perfecto para apoyar al León!

#ElMásGrandeDeCa https://t.co/vUcr57x6IM",54,16,2019,196452,70,0.04
1112,"Arriba están los que lo dejan todo fuera de la cancha.

Abajo los que lo dejan todo adentro
.
Arropados por los mismos colores,la misma bandera y escudo.

Feliz fin de semana para todos los Olimpistas en cada rincón del planeta.

 ¡Locales en todos lados!

#ElMásGrandeDeCa https://t.co/DwEZ0WxOPL",128,35,2019,196452,163,0.08
1113,"Vamos a ponerlo nivel Pro

¿Quién para que maneje el mediocampo?

1-JC Espinoza
2- Vicente Daniel Viera
3-Alex Pineda Chacón
4-Danilo Turcios
5-Alex López

#ElMásGrandeDeCa https://t.co/62Z7lJbBLZ",112,15,2019,196452,127,0.06
1114,"¡Feliz Cumpleaños Danilo Javier Tosello!

Ídolo máximo de nuestra historia!.

6 titulos como jugador y 3 como entrenador es el legado que nos dejó el de Sunchales.

¡Felicidades ídolo! ¡Esta es tu casa!

#CumpleañosAlbo 
#ElMásGrandeDeCa https://t.co/hCBKSRXFgZ",303,87,2019,196452,390,0.2
1115,"Felicidades @jorgealvarez58 por tu debut en la H

💪💪🔝🔝 https://t.co/ubs2RjuyTv",145,17,2019,196452,162,0.08
1116,"La H comienza el camino a Qatar 2022

¡Vamos Honduras!

El pueblo Olimpista se une al apoyo total al equipo de todos.

#TodosConHonduras https://t.co/6xn7YDAUp0",78,19,2019,196452,97,0.05
1117,"Te invitamos a que visites https://t.co/b3d7US0Ypk y adquieras la indumentaria y artículos oficiales del Más Grande de Centroamérica

¡Somos Olimpia! ¡Somos Umbro!

#ElMásGrandeDeCa

REALIZAMOS LOS ENVÍOS PARA HONDURAS Y FUERA DEL PAÍS POR MEDIO DE UPS https://t.co/p5HX6zfGnx",47,10,2019,196452,57,0.03
1118,"¡Buen provecho Olimpistas!

Les dejamos este inolvidable gol del inigualable Wilmer Velasquez.

Disfrutá del resumen completo en el Canal de Youtube del Club Olimpia.

https://t.co/X8QseEJs9e

#ElMásGrandeDeCa https://t.co/91CSVTzqNb",160,39,2019,196452,199,0.1
1119,"El partido clásico de la semana:
Olimpia 2 - Liga Deportiva Alajuelense 0

Recordamos el triunfo del Olimpia en la cuadrangular final del Torneo de Uncaf con el que iniciaba el camino al campeonato Centroamericano en 1999

Vía Canal Youtube Cd Olimpia https://t.co/X8QseEJs9e",31,10,2019,196452,41,0.02
1120,"Arranca una nueva semana y el León ya entrena de cara al partido en Puerto Cortés.

Mas unidos que nunca en la ruta hacia la 31.

¡Hasta el último minuto todos juntos!

#ElMásGrandeDeCa 
#HastaElÚltimoMinuto https://t.co/YkihQvzqep",76,14,2019,196452,90,0.05
1121,"Minuto 90 tiro libre frente al area

¿A quién elegís para hacerlo?

😱😱😱😱😱😱 https://t.co/DRRYgiFT47",161,22,2019,196452,183,0.09
1122,"¡El León vuelve esta semana!

Puerto Cortés le abre las puertas al Más Grande de Centroamérica.

📅 Fecha 13
🏟 Estadio Excelsior
⏰ 16:00 hrs
🇫🇷🇫🇷🇫🇷🇫🇷🇫🇷🇫🇷🇫🇷🇫🇷🇫🇷

¡Hasta el último minuto!

#ElMásGrandeDeCa https://t.co/sS1uGyqTP2",72,25,2019,196452,97,0.05
1123,"Empate final en el Carlos Miranda.

Olimpia 1 - Real de Minas 1 

¡Próximo domingo en Puerto Cortés!

#ElMásGrandeDeCa https://t.co/8NJTL9kcWT",25,7,2019,196452,32,0.02
1124,"Los cambios en Olimpia:

⬅️Benguche ➡️ Bonfigli
⬅️Sosa          ➡️Alejandro Reyes
⬅️Pinto          ➡️Edwin Rodriguez
⬅️Chavasco ➡️ Wilson Palacios
⬅️Bonjour ➡️Sebastián 
⬅️Gómez      ➡️Guity https://t.co/Fck1OcFaIr",35,4,2019,196452,39,0.02
1125,"Final del primer tiempo en el Carlos Miranda de Comayagua:

Olimpia 1 - Real de Minas 0

Elmer Güity (8')

¡Vamos Olimpia!

#ElMásGrandeDeCa https://t.co/VLqZc22h8n",20,3,2019,196452,23,0.01
1126,"¡Goooooooooooooooooooool!
¡Goooooooooooooooooooool!

Elmer Güity abre el marcador al minuto 8 del primer tiempo

Olimpia 1 - Real de Minas 0

¡Vamos Olimpia!

#ElMásGrandeDeCa https://t.co/iTrwycPNYy",90,13,2019,196452,103,0.05
1127,"Seguí la transmisión del amistoso Olimpia - Real de Minas a través de nuestro Facebook Live

https://t.co/56gsKJKPz1

¡Vamos Olimpia! https://t.co/MPwK8Yn0vp",21,8,2019,196452,29,0.01
1128,"Así salimos hoy:

¡Vamos Olimpia!

#ElMásGrandeDeCa https://t.co/HDNLFOwOc4",40,11,2019,196452,51,0.03
1129,"¡Comayagua recibe al León!

7:00 pm Estadio Carlos Miranda

Partido amistoso

Seguí los detalles y el minuto a minuto en las redes oficiales del Club Olimpia

¡Vamos Olimpia! https://t.co/YbDWsrzu17",24,6,2019,196452,30,0.02
1130,"Linda tarde en Comayagua

El Carlos Miranda esta listo

Sol 50 Lps Preferencia 70 Silla 100 

Niños menores de 12 años no pagan entrada a Sol acompañados de un adulto

¡Vamos Olimpia!

#ElMásGrandeDeCa https://t.co/J0P6OdytQv https://t.co/Ob0XMjE9XB",31,5,2019,196452,36,0.02
1131,"Rey de Copas te presenta: ""Al Ángulo"" con Donis Escober

Vía Canal de Youtube Club Olimpia https://t.co/UfdAL4oZk2",30,9,2019,196452,39,0.02
1132,"¡Comayagua! ¡El León llega el sábado!

¡Vamos Olimpia!

#ElMásGrandeDeCa https://t.co/AlxkvcmINp",80,26,2019,196452,106,0.05
1133,"Goleador del Apertura con 12 goles
Goleador del Clausura con 9 goles

¡Jerry Ricardo Bengston!! 

¡El Mejor Delantero del Fútbol Hondureño!

#ElMásGrandeDeCa https://t.co/L3qVt1Nqws",181,34,2019,196452,215,0.11
1134,"Te invitamos a que visites https://t.co/b3d7US0Ypk y adquieras la indumentaria oficial del Más Grande de Centroamérica

¡Somos Olimpia! ¡Somos Umbro!

#ElMásGrandeDeCa

REALIZAMOS LOS ENVÍOS PARA HONDURAS Y FUERA DEL PAÍS POR MEDIO DE UPS https://t.co/ff4DFwgKEw",54,9,2019,196452,63,0.03
1135,"Faltan muchas batallas y llegó el momento de apoyar hasta el último minuto.

¡Vamos Olimpia!

#ElMásGrandeDeCa https://t.co/EXwuMe9EL6",105,24,2019,196452,129,0.07
1136,"¡Feliz Cumpleaños Ídolo Eterno!

Jose Luís ""El Flaco"" Pineda esta de cumpleaños.

¡Esta es tu casa siempre Flaco querido!

#CumpleañosAlbo 
#ElMásGrandeDeCa 

@flacopineda8 https://t.co/vf4g3D2nrs",388,58,2019,196452,446,0.23
1137,"¡Feliz Dia del Padre Hondureño!

A todos los papás de nuestro país el Club Olimpia Deportivo les extiende un saludo inmenso.

¡Gracias por herederar esta pasión y este amor por el blanco mas hermoso que existe

Felicidades Papá Olimpia!

#PapáOlimpia
#ElMásGrandeDeCa https://t.co/u95J2FsW9k",146,35,2019,196452,181,0.09
1138,"Feliz semana a todos los Olimpistas en el mundo entero.

Nos volvemos a encontrar el domingo 31 de marzo en el hermoso Puerto Cortés.

¡Vamos Olimpia!

#HastaElÚltimoMinuto
#ElMásGrandeDeCa https://t.co/n9UNcmavfP",101,22,2019,196452,123,0.06
1139,"¡El Clásico tambien nuestro en reservas!

Olimpia 3 - Marathon 1

David Contreras 
Josman Figueroa 
Andrew Cónnor

¡Vamos Olimpia!

#ElMásGrandeDeCa 
#LaReserva https://t.co/BynZDXHcle",77,16,2019,196452,93,0.05
1140,"Felicidades a Ever Alvarado,Deiby Flores y Jorge Alvarez por su convocatoria a la H. 

¡Vamos muchachos! https://t.co/kICUQGlRys",173,28,2019,196452,201,0.1
1141,"¡Feliz viernes Olimpistas!

Disfrutamos a lo grande el triunfo de ayer pero el camino recién comienza.

¡Puerto Cortés nos vemos pronto!

¡Vamos Olimpia!

#ElMásGrandeDeCa https://t.co/ebU8HWHWYK",106,17,2019,196452,123,0.06
1142,"¡El Clásico una vez mas es nuestro!

La postal de la noche

¡Vamos Olimpia!

#HastaElÚltimoMinuto 
#ElMásGrandeDeCa https://t.co/lgAkvJT0yb",527,143,2019,196452,670,0.34
1143,"¡Final en el Nacional! 

Olimpia da un recital y golea

Olimpia 3 - Marathon 

Jerry Bengston(16,23,37)

¡Vamos Olimpia!

#ElMásGrandeDeCa https://t.co/io5nqhAOyq",259,98,2019,196452,357,0.18
1144,"Tercer cambio en Olimpia a los 81' minutos:

Sale:Jerry Bengston
Entra:Junior Lacayo https://t.co/X9j0LeqXI1",18,4,2019,196452,22,0.01
1145,"Segundo cambio en Olimpia a los 73' minutos:

Sale:Leandro sosa
Entra:Alejandro Reyes

¡Vamos Olimpia!",18,0,2019,196452,18,0.01
1146,"Tarjeta amarilla para Leandro Sosa a los 67' minutos

¡Vamos Olimpia!",11,0,2019,196452,11,0.01
1147,"Primer cambio en Olimpia a los 65' minutos

Sale:Edwin Rodriguez
Entra:Guillermo Chavasco 

¡Vamos Olimpia! https://t.co/F5oCxwDASG",26,0,2019,196452,26,0.01
1148,"56' minutos del segundo tiempo en el Nacional

Olimpia 3 - Marathon 

Jerry Bengston(16,23,37)

¡Vamos Olimpia!

#ElMásGrandeDeCa",29,2,2019,196452,31,0.02
1149,"Tarjera amarilla para Edwin Rodriguez a los 51' minutos 

¡Vamos Olimpia!",10,0,2019,196452,10,0.01
1150,"Comienza el segundo tiempo en el Nacional

Olimpia 3 - Marathon 

Jerry Bengston(16,23,37)

¡Vamos Olimpia!

#ElMásGrandeDeCa",36,3,2019,196452,39,0.02
1151,"El 1-0 de Jerry Bengston a los 16' minutos

¡Vamos Olimpia! https://t.co/Z1T2I7xZ5M",98,13,2019,196452,111,0.06
1152,"Final del primer tiempo en el Nacional

Olimpia 3 - Marathon 

Jerry Bengston(16,23,37)

¡Vamos Olimpia!

#ElMásGrandeDeCa https://t.co/DmFxiEMpln",41,10,2019,196452,51,0.03
1153,"Tarjeta amarilla para Elmer Güity a los 44' minutos

¡Vamos Olimpia!",8,0,2019,196452,8,0.0
1154,"Goooooooooooooooooooool
Goooooooooooooooooooool

¡Triplete del Goleador!

Jerry Bengston a los 36' minutos del primer tiempo

Olimpia 3 -Marathon 0

¡Vamos Olimpia!

#ElMásGrandeDeCa https://t.co/30yGDB8gF4",174,46,2019,196452,220,0.11
1155,"26' minutos del primer tiempo 

Olimpia 2 - Marathon 0

Jerry Bengston (16,23)

¡Vamos Olimpia!

#ElMásGrandeDeCa",35,7,2019,196452,42,0.02
1156,"Goooooooooooooooooool
Goooooooooooooooooool

¡El mejor delantero de Honduras!

Doblete de Jerry Ricardo Bengston

Olimpia 2 - Marathon 0 

¡Vamos Olimpia!

#ElMásGrandeDeCa https://t.co/jQCW8jt3CI",114,33,2019,196452,147,0.07
1157,"Gooooooooooooooooool
Gooooooooooooooooool

El Goleador Jerry Bengston a los 16' minutos

Olimpia 1 - Marathon 0

¡Vamos Olimpia!

#ElMásGrandeDeCa https://t.co/BzR1LMQ76r",106,25,2019,196452,131,0.07
1158,"10' minutos del primer tiempo

Olimpia 0 - Marathon 0

¡Vamos Olimpia!",11,1,2019,196452,12,0.01
1159,"Inicia el Clásico en el Nacional!

Olimpia 0 - Marathon 0

¡Vamos Olimpia!

#ElMasGrandeDeCa https://t.co/dFOlDFbJUm",21,2,2019,196452,23,0.01
1160,"Ganadores de boletos para Olimpia-Marathon

Pueden reclamar su boleto a partir de las 5:30 pm en el portón 2 sector de camerinos.

Llevar su identificación para reclamar boleto https://t.co/bULl1qbcb2",20,4,2019,196452,24,0.01
1161,"¡Olimpista! A partir de hoy vamos a apoyar hasta el final.

Este es el mensaje que los muchachos le mandan a su gente.

De aca hasta el final unidos,sin excusas ni condiciones.

La ruta hacia la 31 la construimos todos.

#HastaElÚltimoMinuto
#ElMásGrandeDeCa https://t.co/Eo70iXKcNJ",239,88,2019,196452,327,0.17
1162,"¡Saquen sus banderas! ¡Saquen sus camisas! 

¡Hoy juega Olimpia!

🏆 Liga Nacional
📅 Fecha 12
🏟 Estadio Nacional
⏰ 19:00 hrs
📺 TSI

#ElMásGrandeDeCa

Precios Sol 60 Sombra 100 Silla 250

Disponibles en todos los puntos Tengo

NO HABRÁ VENTA DE BOLETOS EN EL ESTADIO https://t.co/YEsaYT8VPk",117,37,2019,196452,154,0.08
1163,"¡Olimpia listo para el Clásico!

Nos vemos en el Nacional mañana

Recuerden sacar su bandera y colocarla en sus carros particulares o cualquier medio de transporte

¡Vamos Olimpia!

#ElMásGrandeDeCa https://t.co/OefI4bk7j7 https://t.co/r0WgP1DuJ4",73,17,2019,196452,90,0.05
1164,"¡Vamos a regalar más boletos!

Estaremos por las calles de Tegucigalpa y las autos que nos encontremos con banderas de Olimpia les regalamos pases para el Clásico.

¡Vamos Olimpia!

#ElMásGrandeDeCa https://t.co/9x9Pp4sOhn",159,33,2019,196452,192,0.1
1165,"¡Olimpista! Mañana a llenar el Nacional.

¡Hasta el último minuto!

#ElMásGrandeDeCa https://t.co/FgcR3J6a4M",115,37,2019,196452,152,0.08
1166,"Dia de medios:Declaraciones DT Manuel Keosseian.
Vía Canal de Youtube Club Olimpia Deportivo https://t.co/8O1LAGWz5P",24,5,2019,196452,29,0.01
1167,"Sesión de entrenamiento alistandonos para el Clásico

¡Unidos hasta el final!

#ElMásGrandeDeCa https://t.co/oKerkHVH7v",99,15,2019,196452,114,0.06
1168,"Ya podes visitar la galeria de fotos con los mejores momentos del triunfo contra Honduras Progreso en la página oficial del Club

https://t.co/VQG4aSDRwC https://t.co/IGl0vdrWW0",56,8,2019,196452,64,0.03
1169,"¡Lo jugamos juntos,lo ganamos juntos!

Sorteamos boletos para el Clásico.

Subí tu foto con la camisa del más grande de Centroamérica desde tu trabajo y ganá pases dobles para el jueves.

¡A llenar el Nacional!

#ElMásGrandeDeCa https://t.co/HjnQINvfoU",105,17,2019,196452,122,0.06
1170,"¡El Clásico Nacional lo jugamos todos!

🏆 Liga Nacional
📅 Fecha 12
🏟 Estadio Nacional
⏰ 19:00 hrs
📺 Televicentro 

#ElMásGrandeDeCa

Precios Sol 60 Sombra 100 Silla 250

Disponibles en todos los puntos Tengo

NO HABRÁ VENTA DE BOLETOS EN EL ESTADIO https://t.co/7MV87khBjJ",85,29,2019,196452,114,0.06
1171,Comunicado Club Olimpia Deportivo https://t.co/zNULmQICtB,98,30,2019,196452,128,0.07
1172,"¡La figura de la jornada!

Jorge Bengúche

¡Doblete y tres puntos para el más grande! https://t.co/dmAIbG43fv",100,17,2019,196452,117,0.06
1173,"¡Atención estudiantes de periodismo y comunicación!

¡Gran oportunidad para que podas trabajar con el más grande!

#ElMásGrandeDeCa https://t.co/DPd5iHwOzS",88,44,2019,196452,132,0.07
1174,"¡Feliz semana Olimpistas!

¡El Clásico Nacional lo jugamos todos y a casa llena!

❤ Si vas a apoyar a Olimpia desde cualquier rincón del planeta

Juegan once...¡Apoyamos millones!

#ElMásGrandeDeCa https://t.co/9FtqjFDchE",96,18,2019,196452,114,0.06
1175,Comunicado Junta Directiva - Club Olimpia Deportivo https://t.co/GHzyh5hQqy,79,17,2019,196452,96,0.05
1176,"El 0-1 en el Humberto Michelleti

Jorge Bengúche a los 32' minutos del primer tiempo 

#ElMásGrandeDeCa https://t.co/kKrJUxuMOQ",49,8,2019,196452,57,0.03
1177,"¡Final en el Humberto Michelleti!

Honduras Progreso 1 - Olimpia 2

Jorge Bengúche (32,69)

¡A llenar nuestra casa para el Clásico Nacional!

#ElMásGrandeDeCa https://t.co/M7VjOSLQ4K",147,42,2019,196452,189,0.1
1178,"Gol de Honduras Progreso a los 85' minutos

¡Vamos Olimpia!

Honduras Progreso 1 - Olimpia 2",16,0,2019,196452,16,0.01
1179,"Último cambio en Olimpia a los 79' minutos:

Sale:Jerry Bengston
Entra:Emiliano Bonfigli

¡Vamos Olimpia!

#ElMásGrandeDeCa https://t.co/mA4gftxTV6",16,1,2019,196452,17,0.01
1180,"Gooooooooooooooooooool
Gooooooooooooooooooool

Jorge Bengúche a los 69' minutos

Honduras Progreso 0 - Olimpia 2

¡Vamos Olimpia!

#ElMásGrandeDeCa https://t.co/WlIy5jv5oe",65,18,2019,196452,83,0.04
1181,"Segundo cambio en Olimpia a los 67' minutos del segundo tiempo:

Sale: Jorge Alvarez
Entra:Germán Mejia

¡Vamos Olimpia! https://t.co/KCjE8Mj9ID",14,0,2019,196452,14,0.01
1182,"Cambio en Olimpia a los 66' minutos:

Sale:Leandro Sosa
Entra:Alejandro Reyes

¡Vamos Olimpia! https://t.co/HUvmyOYBaM",20,2,2019,196452,22,0.01
1183,"60' minutos del segundo tiempo

Honduras Progreso 0 - Olimpia 1

¡Vamos Olimpia!

#ElMásGrandeDeCa",13,1,2019,196452,14,0.01
1184,"Inicia el segundo tiempo

Honduras Progreso 0 - Olimpia 1 

¡Vamos Olimpia!

#ElMásGrandeDeCa",8,0,2019,196452,8,0.0
1185,"Final del primer tiempo en el Humberto Michelleti:

Honduras Progreso 0 - Olimpia 1 

Jorge Bengúche(32)

¡Vamos Olimpia!

#ElMásGrandeDeCa https://t.co/pJdxbr6paB",21,4,2019,196452,25,0.01
1186,"Gooooooooooooooooool
Gooooooooooooooooool

Jorge Benguche a los 32' minutos del primer tiempo

Honduras Progreso 0 - Olimpia 1 

¡Vamos Olimpia!

#ElMásGrandeDeCa https://t.co/VkNAz4DgDk",69,13,2019,196452,82,0.04
1187,"10' minutos del primer tiempo

Honduras Progreso 0 - Olimpia 0

¡Vamos Olimpia!

#ElMásGrandeDeCa",7,1,2019,196452,8,0.0
1188,"Inicia el partido en el Humberto Michelleti:

Honduras Progreso 0 - Olimpia 0

¡Vamos Olimpia!

#ElMásGrandeDeCa https://t.co/71l0eep8dQ",14,1,2019,196452,15,0.01
1189,"Así juega el León hoy: Donis Escober,Maylor Nuñez,Ever Alvarado,Jonathan Paz,Elmer Güity,Deiby Flores,Jorge Alvarez,Leandro Sosa,Edwin Rodriguez,Jorge Bengúche,Jerry Bengston https://t.co/eFQxMib0o1",64,16,2019,196452,80,0.04
1190,"¡El León sale de cacería!

La Perla del Ulúa recibe al más popular esta tarde en nuestra ruta hacia la 31

¡Hoy juega Olimpia!    
                       
🏆 Liga Nacional
📅 Fecha 11
🏟 Humberto Michelleti
⏰ 16:00 hrs
📺 Canal 5 

 #ElMásGrandeDeCa https://t.co/CjftGKDvWq",77,23,2019,196452,100,0.05
1191,"El 3-0 de Edwin Rodriguez

#ElMásGrandeDeCa https://t.co/gwvoV60gAE",64,8,2019,196452,72,0.04
1192,"¡Felicidades Matador!

Ídolo eterno,el auténtico 9

¡Matador,Olimpia es tu casa!

#CumpleañosAlbo 

@juanfloresDT9 https://t.co/tycJSJdBNC",203,41,2019,196452,244,0.12
1193,"El 2-0 obra del número 10

Leandro Sosa ¡Vamos Olimpia!

#ElMásGrandeDeCa https://t.co/eE8kfL680I",81,18,2019,196452,99,0.05
1194,"¡Que tengan un excelente viernes Leones! 

Repasamos los goles que nos dejó el partido ante el Vida.

Jorge Bengúche anotaba el primero

¡Vamos mi León!

#ElMásGrandeDeCa https://t.co/Zfpb7RYdXV",85,20,2019,196452,105,0.05
1195,"Por segundo mes consecutivo en Instagram Club Olimpia Deportivo referencia en redes sociales del país.

¡Vamos Olimpia!

#ElMásGrandeDeCa https://t.co/WtMeCEbVaC",87,14,2019,196452,101,0.05
1196,"🎶Somos el pueblo y el carnaval🎶

¡Vamos Olimpia!

#ElMásGrandeDeCa https://t.co/OHs7yfrLbz",102,21,2019,196452,123,0.06
1197,"La ruta a la 31 nos lleva a el Progreso

¡Olimpista! ¡El Más Popular te convoca!

🏆 Liga Nacional
📅 Fecha 11
🏟 Estadio Humberto Michelleti
⏰ 16:00 hrs

#ElMásGrandeDeCa https://t.co/bPy0J70NPc",47,11,2019,196452,58,0.03
1198,"⏱️ Final del Partido, Jugando hermoso y Goleando! Vamos Olimpia! #elmasgrandedeca https://t.co/FAk66Lstf6",145,38,2019,196452,183,0.09
1199,"⏱️89"" Gooollll del Olímpia! Alejandro Reyes de tiro libre para el 4-0 https://t.co/SJlHd0NAJO",83,15,2019,196452,98,0.05
1200,"Último cambio en Olimpia a los 76 minutos:

Sale:Leandro Sosa
Entra: Alejandro Reyes https://t.co/Nxkkt2sdpk",18,4,2019,196452,22,0.01
1201,"Doble cambio en Olimpia a los 74' minutos:

Sale:Jerry Bengston
Entra:Junior Lacayo

Sale:Jorge Alvarez
Entra:Guillermo Chavasco

¡Vamos Olimpia! https://t.co/KAoDm2TyFH",14,4,2019,196452,18,0.01
1202,"60' minutos del segundo tiempo

Olimpia 3 - Vida 0

¡Vamos Olimpia!

#ElMásGrandeDeCa",18,8,2019,196452,26,0.01
1203,"Inicia el segundo tiempo en el Nacional

Olimpia 3 - Vida 0

¡Vamos Olimpia!

#ElMásGrandeDeCa",21,5,2019,196452,26,0.01
1204,"Final del primer tiempo en el Nacional

Olimpia 3 - Vida 0

Jorge Bengúche
Leandro Sosa
Edwin Rodriguez

¡Vamos Olimpia!

#ElMásGrandeDeCa https://t.co/bXoVx1m9un",26,8,2019,196452,34,0.02
1205,"Goooooooooooooooool
Goooooooooooooooool

Edwin Rodriguez a los 44' minutos

Olimpia 3 - Vida 0

¡Vamos Olimpia!

#ElMásGrandeDeCa https://t.co/1bYulCD1Vd",55,13,2019,196452,68,0.03
1206,"40' minutos del primer tiempo

Olimpia 2 - Vida 0

Jorge Bengúche
Leandro Sosa

¡Vamos Olimpia!

#ElMásGrandeDeCa",12,6,2019,196452,18,0.01
1207,"30' minutos del primer tiempo

Olimpia 2 - vida 0

Jorge Bengúche
Leandro Sosa

¡Vamos Olimpia!

#ElMásGrandeDeCa",17,6,2019,196452,23,0.01
1208,"Gooooooooooooooooool
Gooooooooooooooooool

Leandro Sosa a los 22' minutos del primero tiempo

Olimpia 2 - Vida 0

¡Vamos Olimpia!

#ElMásGrandeDeCa https://t.co/jfoMsRHLce",82,25,2019,196452,107,0.05
1209,"Gooooooooooooooool
Gooooooooooooooool

Jorge Bengúche a las 15' del primer tiempo

Olimpia 1 - Vida 0

¡Vamos Olimpia!

#ElMásGrandeDeCa https://t.co/NUKPEUIrMB",62,18,2019,196452,80,0.04
1210,"12' minutos del primer tiempo

Olimpia 0 - Vida

¡Vamos Olimpia!

#ElMásGrandeDeCa",11,1,2019,196452,12,0.01
1211,"Inicia el partido en el Nacional

Olimpia 0 - Vida 0

¡Vamos Olimpia!

#ElMásGrandeDeCa https://t.co/sCRoswugdB",16,4,2019,196452,20,0.01
1212,"¡Así sale el León esta noche!

#ElMásGrandeDeCa https://t.co/NdvFdPcy33",42,21,2019,196452,63,0.03
1213,"¡La casa del León ya esta lista!

Nos vemos a las 7:00 pm

¡Vamos Olimpia!

#ElMásGrandeDeCa https://t.co/uolwieYxPY",38,10,2019,196452,48,0.02
1214,"Ganadores de pases dobles para el juego de hoy Vrs Vida

Reclamarlo con tarjeta de identidad en el portón número 2 area de camerinos a partir de las 6:00 pm

¡Vamos Olimpia! https://t.co/LxePt5St9D",27,3,2019,196452,30,0.02
1215,"¡¡Hoy juega Olimpia! 👏COD

🏆 Liga Nacional
📅 Fecha 10
🏟 Estadio Nacional
⏰ 19:00 hrs
📺 Telecadenahn 

#ElMásGrandeDeCa

Precios Sol 60 Sombra 100 Silla 200

Disponibles en todos los puntos Tengo

NO HABRÁ VENTA DE BOLETOS EN EL ESTADIO",62,14,2019,196452,76,0.04
1216,"Ya podes ingresar a https://t.co/SFZYqR91x9 y disfrutar de las mejores imágenes del domingo

https://t.co/cE9hNwCZyK https://t.co/d3Xz1iVYjs",42,6,2019,196452,48,0.02
1217,"Con el ánimo a tope para empezar la segunda vuelta

¡Sómos Olimpia!

#ElMásGrandeDeCa https://t.co/TNrr6aSDvA",70,15,2019,196452,85,0.04
1218,"Entrenamiento previo a juego contra  Vida

 ¡Vamos Olimpia!

#ElMásGrandeDeCa https://t.co/3hx7HTwjLs",51,7,2019,196452,58,0.03
1219,"¡Vámonos a ver al León! 

Entradas dobles para ver el Olimpia-Vida del miercoles

¡Vamos Olimpia!

#ElMásGrandeDeCa https://t.co/2uNvTksPT2",74,17,2019,196452,91,0.05
1220,"¡Olimpista! Ahora mas que nunca a darle el apoyo al León.

¡Pintemos de blanco el Nacional!

¡Abandonarte jamás!

#ElMásGrandeDeCa https://t.co/A9O7qV8zAd",84,24,2019,196452,108,0.05
1221,"Olimpia siempre vuelve,Olimpia siempre compite hasta el final

¡Hasta el último minuto!

¡Vamos Olimpia!

#ElMásGrandeDeCa https://t.co/52WRwlz2fx",83,12,2019,196452,95,0.05
1222,"Caemos juntos,nos levantamos juntos.

Nos vemos el miércoles en el Nacional.

¡Vamos Olimpia!

#ElMásGrandeDeCa https://t.co/Du3r0HfxHo",108,27,2019,196452,135,0.07
1223,"⏱️94"" Final del partido. Olímpia 1 - Lobos UPN 2.",58,16,2019,196452,74,0.04
1224,"⏱️79 Gol para la UPN, Franco Guity para el 2 a 1.",9,2,2019,196452,11,0.01
1225,"⏱️77 "" cambio para el Olímpia. Entra Carlos Will Mejía por Leandro Sosa",6,0,2019,196452,6,0.0
1226,"⏱️75"" Penal a favor de Lobos UPN",4,0,2019,196452,4,0.0
1227,"⏱️72"" Gol Empata Lobos UPN 1 - Olímpia 1 ⚽",7,1,2019,196452,8,0.0
1228,"⏱️47"" Fin del primer tiempo Club Olímpia Deportivo 🦁 1 - Lobos UPN 0. https://t.co/nik0MGuUsn",20,4,2019,196452,24,0.01
1229,Gooollll del Olímpia! 1-0 Jerry Bengston desde el punto penal. #ElMásGrandeDeCa https://t.co/aHBw4dhSOm,66,20,2019,196452,86,0.04
1230,Minuto 33. Penal a favor  del Olímpia. Falta a Pinto. #elmasgrandedeca,11,2,2019,196452,13,0.01
1231,Minuto 28...seguimos 0-0 en el nacional de Tegucigalpa frente a Lobos UPN  #elmasgrandedeca,4,0,2019,196452,4,0.0
1232,Inicia el partido en Tegucigalpa... Vamos Olimpia! Por los 3 puntos hoy! #elmasgrandedeca https://t.co/Aay33QWCVl,16,0,2019,196452,16,0.01
1233,Así dale el león hoy! #elmasgrandedeca https://t.co/ffhcGG9KW2,21,7,2019,196452,28,0.01
1234,"¡Ya estamos listos!

¡Vamos Olimpia!

#ElMásGrandeDeCa https://t.co/gM8prGpO06",47,10,2019,196452,57,0.03
1235,"¡Campeones!

Hoy en El Salvador la Categoría U-12 de FBO Gano el torneo Centroamericano para asistir a la Donosti Cup en San Sebastián, España.

En la final derrotó a Fesa de El Salvador 2- 3 

#ElMásGrandeDeCa #FBO https://t.co/GWBHh06Ne2",89,31,2019,196452,120,0.06
1236,"Comprá la camiseta conmemorativa en apoyo a la Fundación Hondureña Para El Niño Con Cáncer en Diunsa.
Tu compra sera destinada al tratamiento oncológico.

#SalvaMiVida #ElMásGrandeDeCa https://t.co/zVJ5sAS0Jy",115,28,2019,196452,143,0.07
1237,"Ganadores pases dobles para asistir hoy al Nacional.

Reclamar cortesias en el portón 2 del sector de camerino del estadio.

¡Vamos Olimpia! https://t.co/1mEwim4Alb",21,2,2019,196452,23,0.01
1238,"¡Hoy juega Olimpia! 

¡Olimpista! El Nacional nos espera para apoyar al León hasta el último minuto.

Precios: Sol 70 Sombra 120 Silla 250

Disponibles en:Circle K, Pronto, Stop &amp; GO, Kioskos TENGO en Multiplaza y Metromall de Tegucigalpa y Multiplaza y City Mall en SPS https://t.co/twu1aqC6DA",60,12,2019,196452,72,0.04
1239,"¡Mañana te vemos Olimpia!

¡Unidos hasta el final!

#ElMásGrandeDeCa https://t.co/UVCneqrODh",112,15,2019,196452,127,0.06
1240,El ganador de la camiseta de Leandro Sosa conmemorativa a la lucha del niño con Cáncer: @esau161_  @10leososa https://t.co/ShtB6Z0ymC,27,4,2019,196452,31,0.02
1241,Comunicado Club Olimpia Deportivo https://t.co/jIME3dobmX,63,18,2019,196452,81,0.04
1242,"¡Olimpista! ¡Vamos a pintar de blanco el Nacional!

Lleva a tu familia,tu esposa(o),tus amigos(as),los del barrio,en caravana hacia nuestra casa y seguir la ruta a la 31.

¡Abandonarte jamas!

#ElMásGrandeDeCa https://t.co/ETQHZK8lfG",119,22,2019,196452,141,0.07
1243,"Dia de medios previo a juego vrs @LobosUpnfm

Entrevista a Martín Bonjour

Vía canal del Youtube Club Olimpia

https://t.co/2TvaHFZ8dp",21,4,2019,196452,25,0.01
1244,"¡Felicidades Edrick!

¡Esta es tu casa!

#CumpleañosAlbo https://t.co/GjuYQqoyhp",71,11,2019,196452,82,0.04
1245,"El domingo el Club Olimpia rendirá homenaje a nuestro máximo referente.

300 partidos en Liga Nacional con una sola camiseta.

🎶Donis Querido,está hinchada jamas te olvidara🎶

#ElMásGrandeDeCa https://t.co/uPKm2DRDoT",318,95,2019,196452,413,0.21
1246,"¡Feliz viernes Olimpistas!

Vamos a llenar el Nacional y seguir el camino hacia la 31

¡Vamos Olimpia!

#ElMásGrandeDeCa https://t.co/5l89pA7u9D",96,21,2019,196452,117,0.06
1247,"¡En Olimpia las familias son primero!

Dale ❤ y deja tu mensaje de apoyo con el hashtag #ElMásGrandeDeCa y participá en el sorteo de entradas dobles para el domingo en el Nacional https://t.co/9HLuXXtKmZ",210,29,2019,196452,239,0.12
1248,"Vamos a sortear la camiseta del ""10"" @10leososa 

Paso 1: Dale ❤ y 🔄
Paso 2: Mencioná tres amigos
Paso 3:Subí una foto de tu boleto para el juego del domingo en el Nacional con el hashtag #ElMásGrandeDeCa

Sorteo se realizará sabado a mediodia.

¡Vamos Olimpia! https://t.co/4a3cUqcJAP",183,57,2019,196452,240,0.12
1249,"¿Quienes a ver al León el domingo ?
🖐🖐🖐🖐🖐

Pendientes con la dinámica para el sorteo de boletos y apoyar a #ElMásGrandeDeCa

¡Vamos Olimpia! ¡El Orgullo Nacional! https://t.co/klaWSWdyZO",108,19,2019,196452,127,0.06
1250,"¡Olimpista! El Nacional nos espera para apoyar al León hasta el último minuto.

Disponibles en:Circle K, Pronto, Stop &amp; GO, Kioskos TENGO en Multiplaza y Metromall de Tegucigalpa y Multiplaza y City Mall en San Pedro Sula.

NO HABRÁ VENTA DE BOLETOS EN EL ESTADIO. https://t.co/fCG3NwtIpg",77,22,2019,196452,99,0.05
1251,"0 - 3 y doblete del mejor delantero de la Liga Nacional.

#ElMásGrandeDeCa https://t.co/NyLPalOYTk",98,16,2019,196452,114,0.06
1252,"¡Catedra de contragolpe!

El 0 - 2 de Jerry Bengston 

#ElMásGrandeDeCa https://t.co/66p1AUTapF",170,36,2019,196452,206,0.1
1253,"El 0-1 de Elmer Güity 

#ElMásGrandeDeCa https://t.co/7YA5EBu5mg",85,11,2019,196452,96,0.05
1254,"Resumen Real De minas 1 - Olimpia 3 🦁🦁🦁 Jornada #8 Torneo Clausura 2019 Via Canal de Youtube Club Olimpia 

#ElMásGrandeDeCa

https://t.co/NN3gncA02z",18,6,2019,196452,24,0.01
1255,"Dia de medios entrevista a DT Manuel Keosseian vía Canal de Youtube 

#ElMásGrandeDeCa

https://t.co/XTOasoe693",15,6,2019,196452,21,0.01
1256,"¡A llenar el Nacional!

📅 Domingo 03/03/19
⏱ 5:00 pm
🏟 Estadio Nacional de Tegucigalpa
📺 Tigo Sport

¡Abandonarte jamas!

#ElMásGrandeDeCa

🦁💪👊

#ElMásGrandeDeCa https://t.co/5qKa04Hkvk",61,16,2019,196452,77,0.04
1257,"Resultado Torneo de Reservas estadio El Birichiche:

Real de Minas 0 - Olimpia 1

Jorge Almendarez

#LaReserva 

¡Vamos Olimpia! https://t.co/gdeV8JOEAE",37,6,2019,196452,43,0.02
1258,"¡El domingo vamos a llenar el Nacional!

¡Somos Olimpia! El equipo de las familias

#ElMásGrandeDeCa

❤ Si vas a ir con tu familia
🔄 Regalamos entradas para el domingo https://t.co/7RiF9bh8AU",256,100,2019,196452,356,0.18
1259,"Y el Oscar al mejor jugador es para:

¡Jerry Ricardo Bengston!

¡Vamos Olimpia!

#ElMásGrandeDeCa https://t.co/5XIC1kcvxX",131,22,2019,196452,153,0.08
1260,"Elijan al jugador del partido 

Real de Minas 1 - Olimpia 3

#ElMásGrandeDeCa",27,4,2019,196452,31,0.02
1261,"¡Finaaal! Victoria en el Marcelo Tinoco de Danli

Real de Minas 1 - Olimpia 3

Elmer Güity (22)
Jerry Bengston(36,53)

¡Vamos Olimpia!

#ElMásGrandeDeCa https://t.co/BJU6ojjHzk",147,40,2019,196452,187,0.1
1262,"Gol de Real de Minas a los 81' minutos del segundo tiempo

Diego Rodriguez

Real de Minas 1 - Olimpia 3 

¡Vamos Olimpia!

#ElMásGrandeDeCa",21,1,2019,196452,22,0.01
1263,"Tercer y último cambio en Olimpia a los 75' minutos:

Sale:Deiby Flores
Entra:Jonathan Paz https://t.co/YhVCHrt0Bg",10,1,2019,196452,11,0.01
1264,"Segundo cambio en Olimpia a los 57' minutos del segundo tiempo:

Sale:Leandro sosa
Entra:Guillermo Chavasco

¡Vamos Olimpia!

#ElMásGrandeDeCa https://t.co/WUfPrFbNJu",22,3,2019,196452,25,0.01
1265,"Primer cambio en Olimpia a los 55 minutos del segundo tiempo:

Sale:Jose Mario Pinto
Entra:Edwin Rodriguez https://t.co/rKutmaw5k7",10,2,2019,196452,12,0.01
1266,"Goooooooooooool Goooooooooool

El mejor delantero del país Jerry Bengston hace el 0 - 3 a los 53 minutos del segundo tiempo

Real de Minas 0 - Olimpia 3

¡Vamos Olimpia!

#ElMásGrandeDeCa https://t.co/fT20Sh796t",66,17,2019,196452,83,0.04
1267,"50' minutos del segundo tiempo

Real de Minas 0 - Olimpia 2

Elmer Güity (22')
Jerry Bengston(36)

¡Vamos Olimpia!

#ElMásGrandeDeCa",14,0,2019,196452,14,0.01
1268,"Inicia el segundo tiempo en el Marcelo Tinoco de Danli:

Real de Minas 0 - Olimpia 2

Elmer Güity (22')
Jerry Bengston(36)

¡Vamos Olimpia!

#ElMásGrandeDeCa",19,1,2019,196452,20,0.01
1269,"Final del primer tiempo en el Marcelo Tinoco de Danli:

Real de Minas 0 - Olimpia 2

Elmer Güity (22')
Jerry Bengston(36)

¡Vamos Olimpia!

#ElMásGrandeDeCa https://t.co/cYDHD8UvM9",27,5,2019,196452,32,0.02
1270,"41' minutos del primer tiempo

Real de Minas 0 - Olimpia 2

Elmer Güity (22')
Jerry Bengston(36)

¡Vamos Olimpia!

#ElMásGrandeDeCa",24,6,2019,196452,30,0.02
1271,"Goooooooooooool Gooooooooooool

Jerry Bengston a los 36' minutos del primer tiempo 

Real de Minas 0 - Olimpia 2

#ElMásGrandeDeCa https://t.co/Z0qroCZid7",102,22,2019,196452,124,0.06
1272,"30' minutos del primer tiempo

Real de Minas 0 - Olimpia 1 

Elmer Güity (22')

¡Vamos Olimpia!

#ElMásGrandeDeCa",19,2,2019,196452,21,0.01
1273,"Goooooooooooool Gooooooooooool

Elmer Güity a los 22' minutos del primer tiempo 

Real de Minas 0 - Olimpia 1 

#ElMásGrandeDeCa https://t.co/vxUtmf05Zk",80,18,2019,196452,98,0.05
1274,"10' minutos del primer tiempo 

Real de Minas 0 - Olimpia 0

¡Vamos Olimpia!

#ElMásGrandeDeCa",14,3,2019,196452,17,0.01
1275,"¡Inicia el partido en el Marcelo Tinoco de Danli!

Real de Minas 0 - Olimpia 0

¡Vamos Olimpia!

#ElMásGrandeDeCa https://t.co/ZzmmGnjLHO",20,8,2019,196452,28,0.01
1276,"Así jugamos hoy

¡Vamos Olimpia!

#ElMásGrandeDeCa https://t.co/XUa5DpJh1i",70,23,2019,196452,93,0.05
1277,"¡Unidos hasta el último minuto!

🎶Voy a dejarlo todo,por ver a los Leones,porque sus jugadores me van a demostrar,que salen a ganar,que quieren salir campeón,que lo llevan adentro,como lo llevo yo🎶

¡Locales en todos lados!

#ElMásGrandeDeCa https://t.co/x19Q1euCkb",80,17,2019,196452,97,0.05
1278,"¡Hoy juega Olimpia!

Los invitamos esta tarde al Marcelo Tinoco de Danli para la presentación del 30 veces Campeón Nacional.

¡Vamos Olimpia!

#ElMásGrandeDeCa https://t.co/MaWWajwUcS",84,19,2019,196452,103,0.05
1279,"⠀

                Seremos breves: 

          Mañana juega La Pimpa
                🦁🦁🦁💪💪💪

⠀",380,81,2019,196452,461,0.23
1280,"¡Cada vez falta menos!

¡Vamos Olimpia!

#ElMásGrandeDeCa https://t.co/eCQTKrjVgA",80,16,2019,196452,96,0.05
1281,Dia de medios previo a juego contra Real de Minas Declaraciones AT Mario Beata Via Canal de Youtube Club Olimpia https://t.co/pAMo9hGELA,35,7,2019,196452,42,0.02
1282,"¡Es viernes y los Olimpistas lo sabemos!

Dos dias nos separan para ver nuevamente a nuestro amado León.

Completa la frase:

🎶Yo te sigo a todas partes a donde vas___________________🎶 https://t.co/lHjyJEv2Q6",103,13,2019,196452,116,0.06
1283,"¡Somos Olimpia! ¡El equipo de las familias!

Nos vemos en Danli el próximo domingo

¡Locales en todos lados!

#ElMásGrandeDeCa https://t.co/4GQy7Nnqnc",146,18,2019,196452,164,0.08
1284,"Visitá https://t.co/b3d7US0Ypk Encontrarás toda la indumentaria oficial del más popular.

Envios a Estados Unidos y cualquier parte del mundo.
#SomosOlimpia #SomosUmbro 
#ElMásGrandeDeCa https://t.co/eWXyEUPaAu",55,13,2019,196452,68,0.03
1285,"¡Leyenda del Olimpismo!

Un ❤ un RT y le hacemos una entrevista

#ElMásGrandeDeCa https://t.co/AJW2qKjlH0",422,135,2019,196452,557,0.28
1286,"¡Olimpista! El Más Popular se presenta en Danli.

Nos vemos el domingo para seguir apoyando al León en la ruta hacia la 31.

¡Locales en todos lados!

#ElMásGrandeDeCa https://t.co/UT9F1N84tj",50,7,2019,196452,57,0.03
1287,"En juego disputado el dia de ayer por el torneo de reservas Olimpia y Real España empataron a cero.

#LaReserva https://t.co/AZCA8oGyVF",24,3,2019,196452,27,0.01
1288,"Ya puedes ver el resumen del Olimpia 0 - Real España 0

Fecha #7 Torneo Clausura

Via Canal de Youtube Club Olimpia Deportivo 

#ElMásGrandeDeCa https://t.co/MsdeU9FXSE",13,3,2019,196452,16,0.01
1289,"Ya podes ver la galería completa del Olimpia-Real España del domingo en la página oficial del Club.

https://t.co/EKc99rtfBi https://t.co/Vy5FDmwz5v",52,6,2019,196452,58,0.03
1290,"🎶 Venimos todos unidos por estos colores 🎶

¡Feliz martes a todos los Olimpistas!

La ruta hacia la 31 nos lleva a Danli el próximo domingo.

¡Vamos Olimpia!

#ElMásGrandeDeCa https://t.co/1yT4jpqldC",156,22,2019,196452,178,0.09
1291,"Elige al jugador del partido 

¡Vamos Olimpia!",31,6,2019,196452,37,0.02
1292,"Final en el Nacional

Olimpia 0 - Real España 0

¡Vamos Olimpia! https://t.co/Zshb1bFTCc",24,9,2019,196452,33,0.02
1293,"86' minutos del segundo tiempo

Olimpia 0 - Real España 0

¡Vamos Olimpia!

#ElMásGrandeDeCa",7,1,2019,196452,8,0.0
1294,"78' minutos del segundo tiempo

Olimpia 0 - Real España 0

¡Vamos Olimpia!

#ElMásGrandeDeCa",8,0,2019,196452,8,0.0
1295,"Tercer cambio en Olimpia a los 72 minutos:

Entra:José Mario Pinto
Sale: Jorge Bengúche

¡Vamos Olimpia!

#ElMásGrandeDeCa",7,0,2019,196452,7,0.0
1296,"Segundo cambio en Olimpia a los 63 minutos:

Entra:Alejandro Reyes
Sale: Guillermo Chavasco

¡Vamos Olimpia!

#ElMásGrandeDeCa",8,0,2019,196452,8,0.0
1297,"Primer cambio en Olimpia a los 56' minutos:

Entra: Junior Lacayo
Sale: Leandro Sosa

¡Vamos Olimpia!

#ElMásGrandeDeCa",16,2,2019,196452,18,0.01
1298,"55' minutos del segundo tiempo

Olimpia 0 - Real España 0

¡Vamos Olimpia!

#ElMásGrandeDeCa",4,1,2019,196452,5,0.0
1299,"Inicia el segundo tiempo en el Nacional

Olimpia 0 - Real España 0

¡Vamos Olimpia!

#ElMásGrandeDeCa",10,1,2019,196452,11,0.01
1300,"Final del primer tiempo en el Nacional

Olimpia 0 - Real España 0

¡Vamos Olimpia!

#ElMásGrandeDeCa https://t.co/SWm0bK2Frw",19,5,2019,196452,24,0.01
1301,"40' minutos del primer tiempo

Olimpia 0 - Real España 0

¡Vamos Olimpia!

#ElMásGrandeDeCa",10,0,2019,196452,10,0.01
1302,"25' minutos del primer tiempo

Olimpia 0 - Real España 0

¡Vamos Olimpia!

#ElMásGrandeDeCa",15,1,2019,196452,16,0.01
1303,"10' minutos del primer tiempo

Olimpia 0 - Real España 0

¡Vamos Olimpia!

#ElMásGrandeDeCa",14,2,2019,196452,16,0.01
1304,"Comienza el partido en el Nacional

Olimpia 0 - Real España 0 

¡Vamos Olimpia!

#ElMásGrandeDeCa https://t.co/vGvU2q5dqf",22,2,2019,196452,24,0.01
1305,"Asi salimos hoy 

¡Vamos Olimpia! 

#ElMásGrandeDeCa https://t.co/l9lKDsv63L",65,17,2019,196452,82,0.04
1306,"¡Hoy juega La Pimpa!

📅 Domingo 17/02/19
⏱ 4:00 pm
🏟 Estadio Nacional de Tegucigalpa
📺 Canal 5

¡Vamos a llenar el Nacional!

Precios: Silla 250 sombra 120 y Sol 70

Niños menores de 12 años en Sol entran gratis en compañía de un adulto.

🦁💪👊

#ElMásGrandeDeCa https://t.co/1L6rBAb2JR",95,29,2019,196452,124,0.06
1307,"¡Olimpista! El Nacional nos espera mañana

¡Vamos Olimpia!

#ElMásGrandeDeCa https://t.co/Pl4NEBIEPQ",143,34,2019,196452,177,0.09
1308,Dia de medios entrevista a PF Alejandro Martinez Vía Canal de Youtube Club Olimpia Deportivo https://t.co/e5OBGNf8My,24,6,2019,196452,30,0.02
1309,"¡Gracias Olimpistas del mundo entero!

El Club con mas interacciones de Honduras también en Twitter.

#ElMásGrandeDeCa 

@DeporFinanzas https://t.co/kqBLei9lTC",121,31,2019,196452,152,0.08
1310,"Ya podes disfrutar del resumen del juego de anoche entre Juticalpa y Olimpia en el Juan Ramon Brevé.

Juticalpa 0 - Olimpia 4 

Vía canal de Youtube Club Olimpia Deportivo

 https://t.co/7ZJszyo8YC",44,6,2019,196452,50,0.03
1311,"Hoy es el Dia Internacional de la Lucha contra El Cáncer Infantil y el Club Olimpia Deportivo de la mano con la Fundación Hondureña Para La Lucha Del Niño Con Cáncer invita a todo el pueblo hondureño a unirse a esta causa de amor y superación.

Visitá https://t.co/LbxNJ5r3aj https://t.co/FLSY9CAfaH",60,19,2019,196452,79,0.04
1312,"¡Olimpista! ¡Vamos a llenar el Nacional!

Venta de boletos solo en puntos Tengo. 

¡Abandonarte jamas!

Precios: Silla 250 sombra 120 y Sol 70

Niños menores de 12 años en Sol entran gratis en compañía de un adulto.

#ElMásGrandeDeCa https://t.co/uFV19xjXx9",76,28,2019,196452,104,0.05
1313,Elegí al jugador del partido entre Juticalpa - Olimpia,22,4,2019,196452,26,0.01
1314,"¡Finaaaaaaal! 

Victoria contundente en Juticalpa

Juticalpa 0 - Olimpia 4

Jorge Bengúche (10,23)
Jerry Bengston (14)
Elmer Güity (76)

#ElMásGrandeDeCa https://t.co/PaIjqBVAiF",166,63,2019,196452,229,0.12
1315,"Tercer y último cambio en Olimpia a los 80' minutos del segundo tiempo

Sale:Jorge Bengúche
Entra: Carlos Will Mejia

¡Vamos Olimpia!

#ElMásGrandeDeCa",14,0,2019,196452,14,0.01
1316,"¡Que bueno que es Jorge Alvarez!

¡Vamos Olimpia!

#ElMásGrandeDeCa",42,13,2019,196452,55,0.03
1317,"Segundo cambio en Olimpia a los 77' minutos del segundo tiempo

Sale:Leandro Sosa
Entra: Axel Gomez

¡Vamos Olimpia!

#ElMásGrandeDeCa",12,0,2019,196452,12,0.01
1318,"¡Goooooooooooooooool!
¡Goooooooooooooooool!

¡Elmer Güity a los 76 minutos del segundo tiempo!

Juticalpa 0 - Olimpia 4

¡Vamos Olimpia!

#ElMásGrandeDeCa https://t.co/819zB6gJVW",85,21,2019,196452,106,0.05
1319,"72' minutos del segundo tiempo en el Juan Ramón Brevé de Juticalpa:

Juticalpa 0 - Olimpia 3

¡Vamos Olimpia!

#ElMásGrandeDeCa",17,0,2019,196452,17,0.01
1320,"Cambio en Olimpia a los 61' minutos del segundo tiempo

Sale:Alejandro Reyes
Entra: Guillermo Chavasco

¡Vamos Olimpia!

#ElMásGrandeDeCa",19,1,2019,196452,20,0.01
1321,"56' minutos del segundo tiempo en el Juan Ramón Brevé de Juticalpa:

Juticalpa 0 - Olimpia 3

¡Vamos Olimpia!

#ElMásGrandeDeCa",23,1,2019,196452,24,0.01
1322,"Inicia el segundo tiempo en el Juan Ramón Brevé de Juticalpa:

Juticalpa 0 - Olimpia 3

Jorge Bengúche (10,23)
Jerry Bengston.  (14)

¡Vamos Olimpia!

#ElMásGrandeDeCa",29,3,2019,196452,32,0.02
1323,"Final del primer tiempo en el Juan Ramón Brevé de Juticalpa:

Juticalpa 0 - Olimpia 3

Jorge Bengúche (10,23)
Jerry Bengston.  (14)

¡Vamos Olimpia!

#ElMásGrandeDeCa https://t.co/G2mJAhjNIo",33,11,2019,196452,44,0.02
1324,"35' minutos del primer tiempo

Juticalpa 0 - Olimpia 3 

Jorge Bengúche (2) Jerry Bengston

¡Vamos Olimpia!

#ElMásGrandeDeCa",33,6,2019,196452,39,0.02
1325,"¡Gooooooooooooool!
¡Gooooooooooooool!

¡Llegó el tercero! Jorge Renan Bengúche a los 23 minutos del primer tiempo

Juticalpa 0 - Olimpia 3

#ElMásGrandeDeCa https://t.co/Or76ZwW15D",81,22,2019,196452,103,0.05
1326,"¡Gooooooooooooooool!
¡Gooooooooooooooool!

El mejor delantero de Honduras

Jerry Bengston a los 14 minutos

Juticalpa 0 - Olimpia 2

#ElMásGrandeDeCa https://t.co/zoAJr2BMDn",67,18,2019,196452,85,0.04
1327,"¡Gooooooooooool!
¡Gooooooooooool!

Jorge Benguche abre el marcador a los 10 minutos.

Juticalpa 0 - Olimpia 1

#ElMásGrandeDeCa https://t.co/jqOadW5B5r",42,12,2019,196452,54,0.03
1328,"Inicia el partido en el Juan Ramón Brevé Vargas 

Juticalpa 0 - Olimpia 0

¡Vamos Olimpia! 

#ElMásGrandeDeCa https://t.co/VN8CezIhsr",18,1,2019,196452,19,0.01
1329,"Asi jugamos hoy

¡Vamos Olimpia!

#ElMásGrandeDeCa https://t.co/au2JD1EmyJ",44,12,2019,196452,56,0.03
1330,"Todavia quedan horas para que vayas por la promoción del dia San Valentín.

Boletos en puntos Tengo https://t.co/qIowbpNihC",20,3,2019,196452,23,0.01
1331,"Subí una foto con tu novia(o),esposa(o),amigo(a) con la camisa del Olimpia y a los mas acaremelados los mandamos al estadio gratis con pases dobles para el Clásico del domingo.

¡San Valentín Olimpista!

#ElMásGrandeDeCa https://t.co/Fhs7NoBj1E",112,25,2019,196452,137,0.07
1332,"¡Hoy juega el amor de nuestras vidas!

¡Hoy juega La Pimpa!

¡Olimpista! El camino a la 31 lo recorremos juntos

📅 Jueves 14/02/19
⏱ 7:00 pm
🏟 Estadio Juan Ramón Brevé Vargas

🦁💪👊

#ElMásGrandeDeCa https://t.co/PpE6mf56kB",76,20,2019,196452,96,0.05
1333,"¡Olimpista! Celebremos San Valentín el domingo en el Nacional.

Acercate a los puntos Tengo este 14 de febrero y por la compra de tu ticket para el partido Olimpia - Real España del domingo 17/02/19 adquirí el de tu pareja con el 50% de descuento en todas las localidades. https://t.co/gYde7S2fAg",76,18,2019,196452,94,0.05
1334,"¡Buen Miercoles Olimpistas!

¡Gracias a ustedes somos locales en todos lados siempre!

#ElMásGrandeDeCa https://t.co/xJMGnmwkNe",191,38,2019,196452,229,0.12
1335,"¡Nuestro León legionario esta de Cumpleaños!

¡Felicidades Albert Ellis! ¡Esta es tu casa!

#CumpleañosAlbo 
#ElMásGrandeDeCa https://t.co/fBmcswed7B",140,18,2019,196452,158,0.08
1336,"¡Olimpista! ¡El Más Popular te convoca!

La ruta hacia la 31 continúa y el próximo destino nos lleva a Juticalpa.

¡Vamos Olimpia!

#ElMásGrandeDeCa https://t.co/GdXWqvpZ6G",61,15,2019,196452,76,0.04
1337,"¡Buen inicio de semana para todos los Olimpistas del mundo entero!

Gracias por su compromiso y amor a este Club.

El Club Olimpia Deportivo peleara este campeonato hasta el final ¡Hasta El Último Minuto!

¡Locales en todos lados siempre!

#ElMásGrandeDeCa https://t.co/H4ZxoZRJiv",130,22,2019,196452,152,0.08
1338,"¡Final en el Nacional!

Lo empatamos al final

Motagua 1 - Olimpia 1

Elmer Güity al 93

¡Vamos Olimpia!

#ElMásGrandeDeCa https://t.co/5di6DrInsY",95,25,2019,196452,120,0.06
1339,"¡Goooooooooooooool!
¡Gooooooooooooooo! ¡Güity! ¡Güity! ¡Güity! ¡Vamos Olimpia!

Elmer Güity minuto 93'

Motagua 1 - Olimpia 1

#ElMásGrandeDeCa https://t.co/EQZ1QWqW1P",290,61,2019,196452,351,0.18
1340,"70' minutos del segundo tiempo

Motagua 1 - Olimpia 0

¡Vamos Olimpia!",4,1,2019,196452,5,0.0
1341,"Tercer y último cambio en Olimpia al 54' del segundo tiempo.

Sale: Guillermo Chavasco
Entra: Jerry Bengston

¡Vamos Olimpia!",10,1,2019,196452,11,0.01
1342,"Inicia el segundo tiempo en el Nacional

Motagua 1 - Olimpia 0

¡Vamos Olimpia!

#ElMásGrandeDeCa",3,0,2019,196452,3,0.0
1343,"Segundo cambio en Olimpia:

Sale:Edwin Rodriguez
Entra:Alejandro Reyes

¡Vamos Olimpia!",6,0,2019,196452,6,0.0
1344,"Final del primer tiempo

Motagua 1 - Olimpia 0 

¡Vamos Olimpia! 

#ElMásGrandeDeCa https://t.co/8RPJvGty02",8,3,2019,196452,11,0.01
1345,"33 minutos del primer tiempo

Motagua 1- Olimpia 0

¡Vamos Olimpia!

#ElMásGrandeDeCa",4,1,2019,196452,5,0.0
1346,"Primer cambio en Olimpia a los 22' minutos:

Sale:Jonathan Paz
Entra: Elmer Güity

¡Vamos Olimpia!",12,2,2019,196452,14,0.01
1347,"Minuto 16 gol de Motagua

¡Vamos Olimpia! 

#ElMásGrandeDeCa",7,2,2019,196452,9,0.0
1348,"14' minutos penal para Motagua

¡Vamos Olimpia!

#ElMásGrandeDeCa",4,1,2019,196452,5,0.0
1349,"12' minutos del primer tiempo

Motagua 0 - Olimpia 0

¡Vamos Olimpia!

#ElMásGrandeDeCa",9,1,2019,196452,10,0.01
1350,"¡Arranca el Superclásico en el Nacional!

Motagua 0 - Olimpia 0

¡Vamos Olimpia!

#ElMásGrandeDeCa https://t.co/5CSsJK2TMO",14,2,2019,196452,16,0.01
1351,"¡Hoy hay carnaval ¡Hoy juega Olimpia!

🎶Somos el pueblo y el carnaval,Olimpia te llevo en el alma y cada dia te quiero más🎶

#ElMásGrandeDeCa https://t.co/dKxJ59qIB1",126,36,2019,196452,162,0.08
1352,"¡Olimpista! Danos tu resultado para el Superclásico de mañana.

#ElMásGrandeDeCa https://t.co/yGIHZV54FD",62,11,2019,196452,73,0.04
1353,"¡Un dia nos separa de ver al Más Grande!

¡Vamos Olimpia! 

#ElMásGrandeDeCa https://t.co/DsqvqKHz9o",123,21,2019,196452,144,0.07
1354,"¡El referente vuelve al marco! 

¡Donis querido!

#ElMásGrandeDeCa https://t.co/f6nPdpH6WT",212,33,2019,196452,245,0.12
1355,"El Club Olimpia Deportivo se solidariza con toda la afición,directiva y cuerpo técnico del @Flamengo por la perdida irreparable de jugadores reservistas y personal del Club.

#ForcaFlamengo 
#FuerzaFlamengo https://t.co/K5PFvdtIxN",195,74,2019,196452,269,0.14
1356,Dia de medios viernes 08/02/19 Entrevista a Leandro Sosa vía Canal de Youtube Club Olimpia  https://t.co/fh2psPRPhz,25,8,2019,196452,33,0.02
1357,"Ustedes le dan el color a nuestra gradería.

¡Olimpista! El domingo es el Superclásico y tu apoyo es vital para sacar los tres puntos.

¡Nos vemos en el Nacional!

#AbandonarteJamas 
#ElMásGrandeDeCa https://t.co/SvRDYr9AFg",87,14,2019,196452,101,0.05
1358,"Olimpista únete en apoyo a la Fundación Para El Niño Con Cáncer y adquiére la camiseta conmemorativa que utiliza el Club Olimpia Deportivo en el mes de febrero 💛🦁

Disponible en toda las tiendas Diunsa del país.

#ElMásGrandeDeCa https://t.co/IabGXrQ7ru",78,17,2019,196452,95,0.05
1359,"¡Olimpista! Tu apoyo partido a partido es de vital importancia.

¡El Superclásico lo jugamos juntos!
¡La mejor afición de Centroamerica!

#AbandonarteJamas
#ElMásGrandeDeCa https://t.co/I9NEFAMggh",103,28,2019,196452,131,0.07
1360,"En Olimpia respetamos al adulto mayor.
50 % de descuento en todos los partidos de local de nuestro Club junto con otras promociones.

#ElMásGrandeDeCa https://t.co/SjEaELKv1W",42,14,2019,196452,56,0.03
1361,"¡Olimpista! El Superclásico lo jugamos juntos.

📅 Domingo 10/02/19
⏱ 4:00 pm
🏟 Estadio Nacional

🦁💪👊 https://t.co/xTnuIW08r0",124,29,2019,196452,153,0.08
1362,Entrevista Dt Manuel Keosseian dia de medios Vía Canal de Youtube Club Olimpia Deportivo https://t.co/8r9uYjh8KR,31,7,2019,196452,38,0.02
1363,"Gracias a todos los aficionados del Club Más Grande de Centroamérica por seguir haciendo crecer a esta Institución.

¡Somos Olimpia!

#ElMásGrandeDeCa https://t.co/C8u4pkTiaB",127,32,2019,196452,159,0.08
1364,"Entrega de donación por parte del Club Olimpia Deportivo a la Fundación Hondureña Para El Niño Con Cáncer.

Febrero,mes de la Lucha Contra el Cáncer de Niño.

🎗🎗🎗🎗🎗🎗🎗🎗🎗🎗🎗🎗

 #ElMásGrandeDeCa https://t.co/QodFMJthu6",81,14,2019,196452,95,0.05
1365,"¡Olimpista! El domingo se juega el Superclásico!

Tu apoyo desde cada rincón del mundo es fundamental en el camino hacia la 31.

¡Vamos Olimpia!

#ElMásGrandeDeCa https://t.co/52x8r0IiNR",82,21,2019,196452,103,0.05
1366,"Nuestro referente dejó un mensaje de agradecimiento a todos por motivo de su cumpleaños previo al juego de ayer.

¡Donis Querido! https://t.co/PQ8lj8G9zy",193,20,2019,196452,213,0.11
1367,"¡Grito de Gol!

¡Así hasta el final!

#ElMásGrandeDeCa https://t.co/zp5AfgbXC5",77,14,2019,196452,91,0.05
1368,"Dale ""Me Gusta"" y Compartí a Chavasco para que tengas una gran semana https://t.co/qnrwJEgxCS",221,44,2019,196452,265,0.13
1369,"¡En este abrazo estamos todos!

¡Buen inicio de semana para todos los Olimpistas en el mundo!

¡Vamos Olimpia!

#ElMásGrandeDeCa https://t.co/cqMo8Q63hw",99,25,2019,196452,124,0.06
1370,"¡Feliz Cumpleaños ídolo!

Nuestro referente,16 veces campeón de Liga,una Liga de Concacaf,dos mundiales de fútbol.

¡Esta es tu casa!

#CumpleañosAlbo https://t.co/tNeziqRmvV",250,51,2019,196452,301,0.15
1371,Votá por el mejor jugador del partido,29,5,2019,196452,34,0.02
1372,"¡Final en el Nacional!

Olimpia 2 - Platense 1

Emiliano Bonfigli y Junior Lacayo

¡Vamos Olimpia!

#ElMásGrandeDeCa https://t.co/vPCANRYpvS",109,44,2019,196452,153,0.08
1373,"¡Gooooooooooool! ¡Gooooooooooool del Más Grande!

¡Junior Lacayo al 86!

Olimpia 2 - Platense 1

¡Vamos Olimpia!

#ElMásGrandeDeCa https://t.co/WurrVrHXmY",129,30,2019,196452,159,0.08
1374,"Gol de Platense al 84

Autogol de Martín Bonjour

Olimpia 1 - Platense 1 

¡Vamos Olimpia!",22,3,2019,196452,25,0.01
1375,"Tercer cambio en Olimpia al 73:

Entra:German Mejia
Sale:Edwin Rodriguez

¡Vamos Olimpia!

#ElMásGrandeDeCa",12,1,2019,196452,13,0.01
1376,"Segundo cambio en Olimpia al 68:

Entra:Alejandro Reyes
Sale:Guillermo Chavasco

¡Vamos Olimpia!

#ElMásGrandeDeCa",13,3,2019,196452,16,0.01
1377,"66 minutos del segundo tiempo 

Olimpia 1 - Platense 0

¡Vamos Olimpia!

#ElMásGrandeDeCa",8,2,2019,196452,10,0.01
1378,"Primer cambio en Olimpia al 58:

Entra:Junior Lacayo
Sale:Emiliano Bonfigli

¡Vamos Olimpia!

#ElMásGrandeDeCa",14,1,2019,196452,15,0.01
1379,"57 minutos del segundo tiempo 

Olimpia 1 - Platense 0

¡Vamos Olimpia!

#ElMásGrandeDeCa",9,2,2019,196452,11,0.01
1380,"Inicia el segundo tiempo en el Nacional

¡Vamos Olimpia!

#ElMásGrandeDeCa",13,4,2019,196452,17,0.01
1381,"Final del primer tiempo 

Olimpia 1 - Platense 0

Emiliano Nicolás Bonfigli 7'

¡Vamos Olimpia!

#ElMásGrandeDeCa https://t.co/OlQCAWuCb4",23,8,2019,196452,31,0.02
1382,"37 minutos del primer tiempo 

Olimpia 1 - Platense 0

¡Vamos Olimpia!

#ElMásGrandeDeCa",11,2,2019,196452,13,0.01
1383,"25 minutos del primer tiempo 

Olimpia 1 - Platense 0

¡Vamos Olimpia!

#ElMásGrandeDeCa",14,2,2019,196452,16,0.01
1384,"10 minutos del primer tiempo

Olimpia 1 - Platense 0

Emiliano Bonfigli 7'

#ElMásGrandeDeCa",19,4,2019,196452,23,0.01
1385,"¡Goooooooooooool! ¡Goooooooooooool!

¡Emiliano Bonfigli se estrena con el más grande!

¡Vamos Olimpia!

#ElMásGrandeDeCa https://t.co/utcX4s82Mc",149,45,2019,196452,194,0.1
1386,"¡Arranca en el Nacional! 

Olimpia 0 - Platense 0 

¡Vamos Olimpia!

#ElMásGrandeDeCa https://t.co/xHajKYdAac",15,6,2019,196452,21,0.01
1387,Asi jugamos hoy https://t.co/mbzO2g2X14,31,10,2019,196452,41,0.02
1388,"¡El León sale de cacería! ¡Hoy juega el Tetracampeón!

Sol Lps. 60 Lps Sombra Lps.100  Silla Lps. 200.

Niños menores de 12 años en Sol entran gratis en compañía de un adulto.

Venta de boletos solo en puntos Tengo. 

¡Abandonarte jamas! https://t.co/KzKFDVzx1u",82,16,2019,196452,98,0.05
1389,"¡Olimpista! Nos vemos mañana en el Nacional para apoyar a nuestro amado León.

Sol Lps. 60 Lps Sombra Lps.100  Silla Lps. 200.

Niños menores de 12 años en Sol entran gratis en compañía de un adulto.

Venta de boletos solo en puntos Tengo. 

¡Abandonarte jamas! https://t.co/gxtU9io2Tr",129,22,2019,196452,151,0.08
1390,Comunicado Club Olimpia Deportivo https://t.co/61BrQ8oPTT,75,19,2019,196452,94,0.05
1391,Galeria partido de reservas Marathon-Olimpia https://t.co/lNIHPUf1kF,41,3,2019,196452,44,0.02
1392,"Adivinen que pasó una fecha como hoy y ganate entradas para el Olimpia-Platense del domingo.

#AbandonarteJamas https://t.co/XWwWNYs7QE",149,32,2019,196452,181,0.09
1393,Palabras de Leandro Sosa para toda la afición de Olimpia https://t.co/133xiEW60S,196,39,2019,196452,235,0.12
1394,¡Leandro Sosa ya luce la de Olimpia! https://t.co/Ejz0M24Ych,94,31,2019,196452,125,0.06
1395,"¡Tenemos boletos para el próximo domingo!

Subí tu foto con la camiseta conmemorativa en apoyo a la Fundación Para El Niño Con Cáncer y ganate un boleto para ver al nuevo León

#AbandonarteJamas https://t.co/i9xO1sKbbk",32,7,2019,196452,39,0.02
1396,"¡Llegó el Díez!! 

¡Vamos Olimpia! https://t.co/Zdj4U3Eg8Y",123,22,2019,196452,145,0.07
1397,"¡Ya tenemos al Díez!
💪👊🦁 https://t.co/uFRPNCtj9S",238,57,2019,196452,295,0.15
1398,"¡Felicidades Ever Alvarado y Jorge Alvarez!

¡Esta es su casa!

#CumpleañosAlbo https://t.co/NR8JRKC4rZ",114,8,2019,196452,122,0.06
1399,"¡Final en el Yankel! Marathon 3 - Olimpia 3 en reservas

Daniel Durón,Andrew Connor y Jorge Almendarez anotaron por los nuestros

¡Vamos Olimpia!

#LaReserva https://t.co/4H5EZO1kSh",29,7,2019,196452,36,0.02
1400,"Final del primer tiempo en el Yankel Rosenthal: Marathon 1 - Olimpia1

Daniel Durón anotó por los nuestros a los 26 minutos.

#LaReserva",19,3,2019,196452,22,0.01
1401,https://t.co/GWV4WO6adv,34,4,2019,196452,38,0.02
1402,Ya calienta Olimpia en el Yankel Rosenthal para el Clásico en el Torneo de Reservas https://t.co/t7sqRPM7uq,17,4,2019,196452,21,0.01
1403,"¡Olimpista! ¡Caemos juntos nos levantamos juntos!

Sol Lps. 60 Lps Sombra Lps.100  Silla Lps. 200.

Niños menores de 12 años en Sol entran gratis en compañía de un adulto.

Venta de boletos solo en puntos Tengo 

¡Abandonarte jamas! https://t.co/yZQvKfNtwg",76,18,2019,196452,94,0.05
1404,"El Clásico Nacional también se juega en reservas.

📅 miercoles 30/01/19
⏱ 3:00 pm
🏟 Yankel Rosenthal

Transmisión en vivo por Facebook Live https://t.co/iV2uDklCGG https://t.co/AfCZWV8XvM",14,4,2019,196452,18,0.01
1405,"Leandro Sosa Toranza el nuevo jugador de Olimpia

¡Vamos Olimpia! https://t.co/cPWzKst5dX",97,23,2019,196452,120,0.06
1406,"El Club Olimpia deportivo da la bienvenida al mediocentro ofensivo de 24 años: Leandro Sosa(Uruguay) proveniente del Atletico Venezuela de la primera división de ese país.

¡Bienvenido al Más Grande de Centroamérica! https://t.co/KLh6mAKyao",181,58,2019,196452,239,0.12
1407,"Entrevista DT Manuel Keosseian dia de medios via Canal de Youtube Club Olimpia.

https://t.co/3cfvKZEqkb",11,4,2019,196452,15,0.01
1408,"Entrevista Guillermo Chavasco dia de medios via Canal de Youtube Club Olimpia

https://t.co/bmkrle9KBF",26,9,2019,196452,35,0.02
1409,"""No existe el fracaso definitivo, solo pequeños tropiezos que te acercan un poco más al éxito.""

¡Vamos Olimpia! https://t.co/Z7bPfzunMY",104,14,2019,196452,118,0.06
1410,"¡Olimpista! Suscribite a nuestro canal de Youtube y encontrá  vídeos,información y todos los detalles del Club Olimpia. https://t.co/EPs6oHNhgm",37,6,2019,196452,43,0.02
1411,"¡Feliz inicio de semana a todo el pueblo Olimpista! 

¡Vamos Olimpia! https://t.co/2jb6ECPJeJ",202,34,2019,196452,236,0.12
1412,"Finalizó el partido en el Yankel Rosenthal.

Marathón 1-0 Olimpia

#ElMásGrandeDeCa https://t.co/ob4DJfNWm3",59,13,2019,196452,72,0.04
1413,Tarjeta roja para Ellmer Guity al minuto '92.,12,2,2019,196452,14,0.01
1414,"Tercer y último cambio en Olimpia al 89'

Sale: Jorge Álvarez 
Entra: Emiliano Bonfigli 

¡Vamos Olimpia!",7,0,2019,196452,7,0.0
1415,"Gol de Marathón al minuto '85

Marathón 1-0 Olimpia",9,1,2019,196452,10,0.01
1416,"Min. 80 |  Sigue sin moverse el marcador en el Yankel Rosenthal.

Marathon 0-0 Olimpia 

¡Vamos Olimpia!

#ElMásGrandeDeCa",10,3,2019,196452,13,0.01
1417,"Segundo cambio en Olimpia al 73'

Sale: Chavasco 
Entra: Lacayo

¡Vamos Olimpia!",10,0,2019,196452,10,0.01
1418,"Primer cambio en Olimpia al 59'

Sale: Mario Pinto 
Entra: José Alejandro Reyes

¡Vamos Olimpia!",7,0,2019,196452,7,0.0
1419,"Min. 45 |  Arranca el segundo tiempo en el Yankel Rosenthal.

Marathon 0-0 Olimpia 

¡Vamos Olimpia!

#ElMásGrandeDeCa",10,1,2019,196452,11,0.01
1420,"Final del primero tiempo en San Pedro Sula.

Marathón 0-0 Olimpia https://t.co/nlyf7fSfpu",18,4,2019,196452,22,0.01
1421,"Min. 32 |  Duro encuentro el que se vive en San Pedro Sula.

Marathon 0-0 Olimpia 

¡Vamos Olimpia!

#ElMásGrandeDeCa",15,2,2019,196452,17,0.01
1422,"Se cumplen 10 minutos del encuentro y el marcador aún no se mueve.

Marathon 0-0 Olimpia 

¡Vamos Olimpia!

#ElMásGrandeDeCa",13,2,2019,196452,15,0.01
1423,"¡Inicia el partido en el Yankel Rosenthal!
Marathon - Olimpia 

¡Vamos Olimpia!

#ElMásGrandeDeCa https://t.co/SFeccQIYc9",16,3,2019,196452,19,0.01
1424,Asi jugamos hoy https://t.co/hM2NReCzE4,60,23,2019,196452,83,0.04
1425,"🎶 Ya van a ver...al Olimpia campeón otra vez 🎶  🎶Ya van a ver...al Olimpia campeón otra vez🎶

#ElMásGrandeDeCa https://t.co/AqODoGM5eg",178,38,2019,196452,216,0.11
1426,"¡Hoy juega Olimpia! 

Alienta a nuestro León desde cada rincon del mundo y hagamos sentir a los nuestros el amor por estos colores y esta camiseta.

¡Olimpia nunca jugará solo! Siempre estaremos alli.

⚽ Vs. Marathon
📅 Sábado 26/01/19
⏱ 3:00 pm
🏟 Yankel Rosenthal https://t.co/loEKx5XLqJ",73,26,2019,196452,99,0.05
1427,"¡Feliz Dia De La Mujer Hondureña! 

Piedra angular de las familias y del desarrollo del país. ¡Para todas ustedes mujeres!

#ElMásGrandeDeCa https://t.co/rF2ibFuFAf",98,28,2019,196452,126,0.06
1428,"¡El Goleador! El mejor delantero del país en atención a medios este dia

¡Vamos Olimpia!

#ElMásGrandeDeCa https://t.co/9wZz0uSjrt",122,29,2019,196452,151,0.08
1429,"Visitá https://t.co/b3d7US0Ypk Encontrarás toda la indumentaria oficial del más popular.

Envios a Estados Unidos y cualquier parte del mundo.
#SomosOlimpia #SomosUmbro 
#ElMásGrandeDeCa https://t.co/gLnPMUCXz3",62,10,2019,196452,72,0.04
1430,"""En la costa nos quieren porque somos el mejor""

¡Vamos Olimpia! ¡Esta campaña volveremos a estar contigo!

#ElMásGrandeDeCa https://t.co/A0ct7yTrCg",137,33,2019,196452,170,0.09
1431,"Olimpista únete en apoyo a la Fundación Para El Niño Con Cáncer y adquiére la camiseta conmemorativa que utilizará el equipo Club Olimpia Deportivo en el mes de febrero 💛🦁

Disponible en toda las tiendas Diunsa del país.

#ElMásGrandeDeCa https://t.co/2nNmKvaEEp",85,22,2019,196452,107,0.05
1432,Entrenamiento https://t.co/weDdB1uHzR,108,11,2019,196452,119,0.06
1433,"¡Buen martes para todos los olimpistas del mundo entero! ¡La mejor afición de Centroamerica!

#ElMásGrandeDeCa https://t.co/pZQXpUP4XC",168,25,2019,196452,193,0.1
1434,"Galeria: Triunfo 2 - 1 en casa sobre Honduras Progreso.

Doblete del mejor goleador de la Liga Nacional Jerry Bengston.

¡Esta campaña volveremos a estar contigo! 

#ElMásGrandeDeCa https://t.co/uk4PMCxbCy",92,19,2019,196452,111,0.06
1435,"Clásico nacional a la vista!

¡Olimpista! Seguimos en la ruta hacia  la 31 y el próximo sábado tu aliento desde cualquier parte del mundo sera vital.

¡Vamos Olimpia!

#ElMásGrandeDeCa https://t.co/auobAGhaqp",78,27,2019,196452,105,0.05
1436,¿Quién fue el jugador más destacado de esta jornada?,32,11,2019,196452,43,0.02
1437,"Triunfo importante en el Nacional

Olimpia 2 (Jerry Bengston)- Honduras Progreso 1

¡Vamos Olimpia! https://t.co/8STPPxgQ9F",141,53,2019,196452,194,0.1
1438,"Tercer y último cambio en Olimpia al 82'

Sale: Jerry Bengston
Entra German Mejia

¡Vamos Olimpia!",20,1,2019,196452,21,0.01
1439,"Segundo cambio en Olimpia al 75'

Entra: Carlos Will Mejia
Sale: Guillermo Chavasco

¡Vamos Olimpia!",19,6,2019,196452,25,0.01
1440,Jerry Bengston anota el 2 - 1 https://t.co/5XcoiwXLeT,56,15,2019,196452,71,0.04
1441,"¡Goooooooooool! ¡Goooooooool de Olimpia! Doblete del goleador de penal 

Jerry Bengston al 68 

Olimpia 2 - Honduras Progreso 1 

#ElMásGrandeDeCa https://t.co/uzjxzfEqfq",96,19,2019,196452,115,0.06
1442,"Primer cambio en Olimpia al 62' 

Sale Mario Pinto 
Entra Alejandro Reyes

¡Vamos Olimpia!",11,1,2019,196452,12,0.01
1443,"56 minutos continúa el empate

Olimpia 1 - Honduras Progreso 1

¡Vamos Olimpia!",5,0,2019,196452,5,0.0
1444,"Arranca el segundo tiempo 

Olimpia 1 - Honduras Progreso 1 

¡Vamos Olimpia! 

#ElMásGrandeDeCa",10,1,2019,196452,11,0.01
1445,"Final del primer tiempo en el Nacional

Olimpia 1 - Honduras Progreso 1 

Jerry Bengston a los 32 minutos https://t.co/xn88XRppxK",19,3,2019,196452,22,0.01
1446,Jerry Bengston anota el empate en el Nacional https://t.co/PZpGPBa2Zk,81,21,2019,196452,102,0.05
1447,"¡Goooooooooo de Olimpia! El goleador Jerry Bengston a los 32 minutos anota el empate.

Olimpia 1 - Honduras Progreso 1 

¡Vamooooos Olimpia! https://t.co/WnF9Px0Jc2",87,23,2019,196452,110,0.06
1448,"¡Penaaaaaaal! ¡Clara falta sobre Jerry Bengston al 30'! 

¡Vamos Olimpia!",21,0,2019,196452,21,0.01
1449,"15 minutos del primer tiempo 

Olimpia 0 - Honduras Progreso 1

¡Vamos Olimpia!",6,0,2019,196452,6,0.0
1450,"Gol del Honduras Progreso minuto 6'

Olimpia 0 - Honduras Progreso 1 

!Vamos Olimpia!",14,1,2019,196452,15,0.01
1451,"¡Inicia el partido en el Nacional! 
Olimpia - Honduras Progreso

 ¡Vamos Olimpia!

#ElMásGrandeDeCa https://t.co/UhdLxVbMEj",18,2,2019,196452,20,0.01
1452,Asi salimos hoy ante Honduras Progreso https://t.co/MuXFWgVNrS,37,10,2019,196452,47,0.02
1453,En el camerino el recordatorio ¡Sómos Olimpia! https://t.co/MfUwQuTlHf,124,26,2019,196452,150,0.08
1454,"¡Hoy juega Olimpia! Nos vemos en nuestra casa,nos vemos en El Nacional.

📅 Domingo 20/01/19
⏱ 5:00 pm
🏟 Nacional de Tegucigalpa

#ElMásGrandeDeCa 👊 https://t.co/I9pPXupzvY",91,17,2019,196452,108,0.05
1455,"¡Olimpia de mundial! Un día como hoy Olimpia sellaba su pase al Mundial De Clubes que se realizaría en España al vencer 4-0 a Pachuca @Tuzos 

El equipo de Edwin Pavón(QEPD) hacía historia al ser el primer Club Centroamericano en lograr esa hazaña.

#ElMásGrandeDeCa https://t.co/KYeZFtO6PR",317,100,2019,196452,417,0.21
1456,"¡Olimpista! Un dia nos separa de ver al más popular en casa.

@AlboDeSombraSur ¿Están listos? 

¡Vamos Olimpia!  Sol 60 Lps. Sombra 100 Lps Silla 200 Lps.
Boletos disponibles solo en puntos Tengo.

#ElMásGrandeDeCa https://t.co/YexTK60GLf",96,19,2019,196452,115,0.06
1457,Entrevista a Maylor Nuñez previo a juego contra Honduras Progreso https://t.co/d6nNH5LgVu,44,10,2019,196452,54,0.03
1458,"¡Muchas Gracias Carlo! ¡Este pueblo,la afición más grande de Centroamérica te recordará siempre!

@carlocostly31 #ElMásGrandeDeCa https://t.co/OTjkNxahim",459,122,2019,196452,581,0.3
1459,"¡Tenemos boletos para ver el debut del más popular este domingo a las 5:00 pm en El Nacional! 

Dejá tu frase apoyo con el Hashtag #ElMásGrandeDeCa y podrás ganar pases para el domingo

¡Vamos Olimpia! https://t.co/Kt6dPw8uJy",181,28,2019,196452,209,0.11
1460,Comunicado Club Olimpia Deportivo https://t.co/IczeMerJT3,37,12,2019,196452,49,0.02
1461,"Olimpista únete en apoyo a la Fundación Para El Niño Con Cáncer y adquiére la camiseta conmemorativa que utilizará el equipo Club Olimpia Deportivo en el mes de febrero 💛🦁

Disponible en toda las tiendas Diunsa del país.

#ElMásGrandeDeCa https://t.co/fTvMxYAFkr",87,31,2019,196452,118,0.06
1462,"¡Olimpista! ¡El Más Popular Te Convoca! 

#ElMásGrandeDeCa https://t.co/x7aEZR48vg",143,42,2019,196452,185,0.09
1463,"16 de enero 2001 Fullerton,California.

Cuartos de Final Olimpia 1 - Toluca 0
Gol de Robert Lima @Rlima5dt 

¡Nuestra historia nos define!

¡Sómos El Más Grande de Centroamérica!

#ElMásGrandeDeCa https://t.co/FiaFdhD58l",334,114,2019,196452,448,0.23
1464,"Venta de boletos en Puntos Tengo

NO HABRÁ VENTA DE BOLETOS EN EL ESTADIO.

PRECIOS EN PUNTOS TENGO
SOL: L 60 / Niños menores de 12 entran GRATIS a localidad SOL acompañados de un adulto
SOMBRA: L 100
SILLA: L 200

*Boletos para TERCERA EDAD obtienen el descuento correspondiente. https://t.co/yKBwToeBQd",46,9,2019,196452,55,0.03
1465,"¡Olimpista tomá nota a este cambio! 

A llenar el Nacional y darle la bienvenida al Más Grande de Centroamérica en casa.

Sol Lps. 60 Lps Sombra Lps.100  Silla Lps. 200

Niños menores de 12 años en Sol entran gratis en compañía de un adulto.

Venta de boletos solo en puntos Tengo https://t.co/7GgAM0lHEY",124,36,2019,196452,160,0.08
1466,"Podrán cambiar las formas y las generaciones pero el amor a este escudo crece todos los días.

#TenYearChallenge 
#ElMásGrandeDeCa https://t.co/PABHDcAzp3",340,116,2019,196452,456,0.23
1467,"¡Olimpista! Vamos a llenar el Nacional y darle la bienvenida al Más Grande de Centroamérica en casa.

Sol Lps. 60 Lps Sombra Lps.100  Silla Lps. 200.

Niños menores de 12 años en Sol entran gratis en compañía de un adulto.

Venta de boletos solo en puntos Tengo https://t.co/1iEsy5z6OC",140,32,2019,196452,172,0.09
1468,"¡Feliz inicio de semana Olimpistas! 

El domingo es el reencuentro con nuestro amado León y vamos a llenar el Nacional.

🎶 Te alentaremos de corazón 🎶 

#ElMásGrandeDeCa https://t.co/35LFbCHRSy",148,24,2019,196452,172,0.09
1469,"¡Final en La Ceiba! Debut con triunfo

Vida 0 - Olimpia 1 

Alejandro Reyes minuto 66 

Tegucigalpa nos vemos en una semana en casa

#ElMásGrandeDeCa https://t.co/raWJxdH9oT",164,68,2019,196452,232,0.12
1470,"Se cumple el tiempo en La Ceiba.

El arbitro añade 4 minutos mas",12,3,2019,196452,15,0.01
1471,"Tercer y último cambio en Olimpia al 86: Sale Jhon Paul Suazo Entra : Maylor Nuñez

¡Vamos Olimpia!",13,2,2019,196452,15,0.01
1472,"Segundo cambio en Olimpia: Sale Jorge Bengoche Entra : Carlos Will Mejia

¡Vamos Olimpia!",13,1,2019,196452,14,0.01
1473,"80 minutos de juego en La Ceiba 0-1 lo gana Olimpia

#ElMásGrandeDeCa",8,1,2019,196452,9,0.0
1474,¡Goooooooooool de Olimpia!! ¡Gooooooooooool del más grande! Alejandro Reyes al 66 pone el 0 - 1 en el Municipal Ceibeño https://t.co/ZWsuWmvmny,179,43,2019,196452,222,0.11
1475,"Olimpia realizó cambio: Sale Mario Pinto Entra: Alejandro Reyes

¡Vamos Olimpia!",19,4,2019,196452,23,0.01
1476,"¡Arranca el segundo tiempo en el Municipal Ceibeño! 

Vida 0 - Olimpia 0

¡Vamos Olimpia!

#ElMásGrandeDeCa",10,1,2019,196452,11,0.01
1477,"Medio tiempo en La Ceiba 

Vida 0 - Olimpia 0

Salió expulsado Junior Lacayo al 45

¡Vamos Olimpia! https://t.co/krXkzqVpwn",17,4,2019,196452,21,0.01
1478,"Tarjeta roja para Junior Lacayo al minuto 45.

¡Vamos Olimpia!",13,2,2019,196452,15,0.01
1479,"35 minutos de juego continúa el empate 0-0 entre Vida y Olimpia en La Ceiba

#ElMásGrandeDeCa",10,3,2019,196452,13,0.01
1480,"18 minutos de juego continúa el empate 0-0 entre Vida y Olimpia en La Ceiba

#ElMásGrandeDeCa",11,1,2019,196452,12,0.01
1481,"¡Arranca en el Municipal Ceibeño! 

Vida 0 - Olimpia 0

¡Vamos Olimpia!

#ElMásGrandeDeCa https://t.co/H7ze9SOjej",27,7,2019,196452,34,0.02
1482,"La alineacion para hoy: Edrick Menjivar,Jhon Paul Suazo,Ever Alvarado,Jonathan Paz,Elmer Güity,Deiby Flores,Jorge Alvarez,Mario Pinto,Junior Lacayo,Jorge Benguche,Jerry Bengston

#ElMásGrandeDeCa https://t.co/oXxT5GDS7Z",60,28,2019,196452,88,0.04
1483,"El titular hoy contra el Vida: Edrick Menjivar

#ElMásGrandeDeCa https://t.co/Ggnw2VGkFG",65,10,2019,196452,75,0.04
1484,"Hoy inicia la ruta hacia la 31.

¡Hoy juega el más campeón,el más popular,El Más Grande de Centroamérica!

¡Bienvenidos al Clausura 2019!

⚽ Vs. Vida
📅 Domingo 13/01/19
⏱ 3:15 pm
🏟 Municipal Ceibeño

#ElMásGrandeDeCa 👊 https://t.co/G3kjiIW84I",132,46,2019,196452,178,0.09
1485,#NuevaFotoDePerfil https://t.co/gg65I2i8ne,176,27,2019,196452,203,0.1
1486,Club Olimpia Deportivo https://t.co/qPzBpXXxId,88,18,2019,196452,106,0.05
1487,"Trabajo físico con el PF Alejandro Martínez @entramoscondiez 

¡Vamos Olimpia! https://t.co/LRucnE49Pd",128,18,2019,196452,146,0.07
1488,Entrenamiento previo a viaje a La Ceiba para debut en el torneo Clausura 2019 Vrs Vida https://t.co/V3Dq9XHjXo,100,17,2019,196452,117,0.06
1489,"Lanzamiento campaña de apoyo a la Fundación Para El Niño Con Cancer.

El Club Olimpia Deportivo utilizará la camiseta con distintivos amarillos el mes de Febrero.

A la venta en todas las tiendas Diunsa de todo el país. https://t.co/m2kEbJvPy1",195,51,2019,196452,246,0.13
1490,"-2 dias

¡Olimpista! ¡El Más Popular te convoca al Clausura 2019!

⚽ Vs. Vida
📅 Domingo 13/01/19
⏱ 3:15 pm
🏟 Municipal Ceibeño

#ElMásGrandeDeCa 👊 https://t.co/5ncAyTI1Zb",105,30,2019,196452,135,0.07
1491,"¡Feliz jueves Olimpistas del mundo entero!

¡Faltan 3 dias para ver al Más Grande de Centroamérica de nuevo!

¡La Ceiba hermosa,allá va el León!

#ElMásGrandeDeCa https://t.co/Zjase6GO56",140,31,2019,196452,171,0.09
1492,"Reglamento de prensa Club Olimpia Deportivo.

https://t.co/IWpMT1v520",44,20,2019,196452,64,0.03
1493,"Firma de contrato Guillermo Chavasco y Martín Bonjour.

¡Bienvenidos al Más Grande de Centroamérica! https://t.co/XmtV4OoDPe",176,49,2019,196452,225,0.11
1494,"¡Olimpista! ¡El Más Popular te convoca al Clausura 2019!

⚽ Vs. Vida
📅 Domingo 13/01/19
⏱ 3:15 pm
🏟 Municipal Ceibeño

#ElMásGrandeDeCa 👊 https://t.co/HxgytCoE03",102,27,2019,196452,129,0.07
1495,"¡Bonjour, Martín! ¡Bienvenido al Más Grande de Centroamérica!

#ElMásGrandeDeCa https://t.co/Y7dD5ez03e",143,39,2019,196452,182,0.09
1496,Declaraciones del D.T. Manuel Keosseian https://t.co/9hdBb9cSic,57,19,2019,196452,76,0.04
1497,Comunicado acreditaciones para prensa Torneo Clausura 2019 https://t.co/6PiDGsknmB,45,19,2019,196452,64,0.03
1498,"¡Felicidades Jesus Marcelo Canales! 

¡Esta es tu casa! 

#CumpleañosAlbo https://t.co/XSvGjrOcTv",133,19,2019,196452,152,0.08
1499,"Se viene el torneo Clausura y no  podés quedarte sin la indumentaria oficial Umbro.
Visitá https://t.co/b3d7US0Ypk y adquirí los productos oficiales del Más Grande de Centroamérica.

#SomosOlimpia #SomosUmbro 
#ElMásGrandeDeCa https://t.co/4xqAM11NTo",63,9,2019,196452,72,0.04
1500,"Un nuevo torneo comienza.Los mismos colores, el mismo escudo, la misma pasión, una nueva historia.

¡Somos Olimpia! ¡El Más Grande de Centroamérica!

#ElMásGrandeDeCa https://t.co/FurqzPFYBM",880,160,2019,196452,1040,0.53
1501,"¡Bienvenido Guillermo Chavasco al mas grande de Centroamérica! 

#ElMásGrandeDeCa https://t.co/ytgw1X0GYU",212,73,2019,196452,285,0.15
1502,Comunicado https://t.co/v9oXJ1L9V5,127,55,2019,196452,182,0.09
1503,thanks for results @resultsports https://t.co/vfne5jwPUf,73,21,2019,196452,94,0.05
1504,"Las plataformas digitales del Club Olimpia Deportivo entran al Global Digital Football Benchmark.

Las 200 plataformas digitales mas importantes del mundo 💪💪💪💪 https://t.co/vfne5jwPUf",171,50,2019,196452,221,0.11
1505,"Firma de contrato Emiliano Nicolás Bonfigli con el Club Olimpia Deportivo.

¡Esta es tu casa!

#ElMásPopular https://t.co/2ILUQbuH1e",182,55,2019,196452,237,0.12
1506,"!Disponible la camisa manga larga del más popular! Visitá https://t.co/b3d7US0Ypk y adquirí la indumentaria oficial del Club Olimpia
#SomosOlimpia #SomosUmbro https://t.co/TD8tP15vRb",119,22,2019,196452,141,0.07
1507,"¡Feliz año nuevo les desea el Club Olimpia Deportivo! 

A todos los aficionados del más popular les deseamos muchos éxitos en el 2019.

Con el compromiso de luchar hasta el final para volver a estar en el sitial que nos corresponde.

¡Feliz 2019 para todos!

#ElMasGrandeDeCa https://t.co/BcMbJNGAZB",259,68,2018,196452,327,0.17
1508,"El Club Olimpia Deportivo hace oficial la contratación del delantero argentino Emiliano Nicolás Bonfligi a quien le damos la mas cordial bienvenida.

¡Bienvenido al más popular!

#HastaElÚltimoMinuto
#ElMásPopular https://t.co/N9FEVadCI0",296,96,2018,196452,392,0.2
1509,"Descanse en paz Edwin Pavón el DT que nos clasificó por primera y única vez a un mundial de Clubes. Logró un título nacional,dos subcampeonatos,subcampeonato de Concacaf y el record de diez victorias consecutivas. QDDG https://t.co/HeRYOdXdOh",181,51,2018,196452,232,0.12
1510,"Artículo del Doctor Elmer López Lutz médico del Club Olimpia Deportivo para la página oficial del Club.
 https://t.co/t3n07JLZ9E",29,6,2018,196452,35,0.02
1511,"¡Inicio de pretemporada!

Trabajos físicos a cargo del Profesor Alejandro Martínez P.F.

#HastaElÚltimoMinuto 
#ElMásPopular https://t.co/OBL4nNWxib",114,25,2018,196452,139,0.07
1512,"¡Hoy inicia la ruta hacia la 31!

Juntos de principio a fin ¡Hasta el último minuto!

#ElMásPopular 
#HastaElÚltimoMinuto https://t.co/TkLh8vBwlD",211,35,2018,196452,246,0.13
1513,"Feliz navidad a todos les desea el Club Olimpia Deportivo.

#HastaElÚltimoMinuto
#ElMásPopular https://t.co/C9AMI5GvrZ",248,75,2018,196452,323,0.16
1514,Comunicado Club Olimpia Deportivo https://t.co/eewyKbGMEM,104,29,2018,196452,133,0.07
1515,"30 años del bicampeonato de Concacaf.

Olimpia 2 - Defende Force 0
21 de diciembre 1988
Estadio Nacional de Tegucigalpa

Dos ídolos históricos anotaron esa noche: Juan Carlos Contreras y Juan Flores https://t.co/fCYihQlRyw",154,50,2018,196452,204,0.1
1516,"Un dia como hoy en 1988 El Más Popular nos regalaba una noche única e irrepetible y se convertía en campeón de Concacaf.
 
Olimpia derrotaba 4-0 (global) al Defence Force de Trinidad y Tobago logrando asi su segundo titulo de rey de Concacaf.

#ElOrgulloNacional
#ElMasGrandeDeCa https://t.co/B9USxbMCJt",285,108,2018,196452,393,0.2
1517,"¡Somos Olimpia!

#HastaElÚltimoMinuto 
#ElMásPopular https://t.co/mcGwMfTp0l",293,64,2018,196452,357,0.18
1518,"Disponible camiseta manga larga Club Olimpia.Entra a la página de https://t.co/b3d7US0Ypk y regalá en esta navidad a tu ser querido la indumentaria oficial del Club Olimpia
#SomosOlimpia #SomosUmbro https://t.co/SVSvEw8vsz",92,13,2018,196452,105,0.05
1519,"Galeria de fotos Gran Final
Motagua 0 - Olimpia 1 

#HastaElÚltimoMinuto https://t.co/7U1IaBWyiv",92,17,2018,196452,109,0.06
1520,"¡Muchas gracias Olimpistas! 

¡Ganamos juntos,perdemos juntos,nos levantamos juntos! 

Lo intentamos y lo volveremos a hacer porque Somos Olimpia.

#HastaElÚltimoMinuto #OlimpiaPositivo
#ElMásPopular https://t.co/5ybaBl6lJX",606,219,2018,196452,825,0.42
1521,"Finalizó el partido en el Nacional. Luchamos hasta el último minuto. 

Marcador global: Motagua 2-1 Olimpia

#RugeLeón #YoSoyOlimpia https://t.co/VCBhLIRL2o",148,42,2018,196452,190,0.1
1522,"¡Gooool! ...  Olimpia pone el marcador 1-0 al minuto 77. 

Marcador global: Motagua 2-1 Olimpia

#RugeLeón #YoSoyOlimpia https://t.co/e09bOVSKjW",145,42,2018,196452,187,0.1
1523,"Min. 75 - El marcador permanece empatado sin goles. 

Marcador global: Motagua 2-0 Olimpia 

#RugeLeón #YoSoyOlimpia",6,1,2018,196452,7,0.0
1524,"Nos vamos al descanso con el marcador empatado. Seguiremos luchando, ...hasta el último minuto 💪

Marcador global: Motagua 2-0 Olimpia

#YoSoyOlimpia #ElMásPopular #RugeLeón https://t.co/8Szwoaa8Vj",41,11,2018,196452,52,0.03
1525,"Min. 20  - El marcador permanece empatado sin goles. 

Marcador global: Motagua 2-0 Olimpia 

#RugeLeón #YoSoyOlimpia",15,4,2018,196452,19,0.01
1526,"Inició el partido en el Nacional. Vamos a darlo todo, 💪...hasta el último minuto.

#YoSoyOlimpia #ElMásPopular https://t.co/pTvOFo6ZPX",34,6,2018,196452,40,0.02
1527,"¡Hoy es el dia! ¡Ya lo hemos hecho antes lo vamos a intentar una vez más! 

Lo vamos a jugar juntos,en la grada y en la cancha ¡Vamos Olimpia! 

#HastaElÚltimoMinuto
#OlimpiaPositivo https://t.co/PDOHRtm6uP",244,92,2018,196452,336,0.17
1528,"¡Olimpista! ¡Envianos tu video al inbox!

#OlimpiaPositivo #CREER https://t.co/QmptYWAQ7Q",55,11,2018,196452,66,0.03
1529,Invitación a Misas de Novenario https://t.co/Izd2On5xpB,61,10,2018,196452,71,0.04
1530,Homenaje del Club Olimpia en el Sepelio del Eterno Presidente Lic. Jose Rafael Ferrari https://t.co/VXMClLGf16,445,98,2018,196452,543,0.28
1531,"¡Olimpista! ¡Vamos a apoyar las reservas en la final!

⚽ Vs. Vida
📅 Sabado 15/12/18
⏱ 2:00 pm
🏟 Estadio Ceibeño

#OlimpiaPositivo  #LaReserva 👊 https://t.co/q1b1VQytTA",58,10,2018,196452,68,0.03
1532,https://t.co/9ETiiflyQ7,145,30,2018,196452,175,0.09
1533,Acuerdo de duelo Club Olimpia Deportivo: https://t.co/LVTXDGjj3x,125,31,2018,196452,156,0.08
1534,#NuevaFotoDePerfil https://t.co/NrLXijWLzQ,505,141,2018,196452,646,0.33
1535,"Nuestras plegarias a Dios por el eterno descanso del alma de Don José Rafael Ferrari Sagastume, que brille para él la luz perpetua y por el consuelo a toda su familia. Que el recuerdo del Licenciado Ferrari quede grabado,  permanentemente, en los Olimpistas y la familia Hondureña https://t.co/COgL1aOxbV",1301,433,2018,196452,1734,0.88
1536,"¡Felíz miércoles Olimpistas! ¡remontamos juntos!

#CREER #ElMásPopular ¡Hasta el último minuto! https://t.co/KxlWoKtcbn",275,90,2018,196452,365,0.19
1537,"¡Hasta el último minuto! 

#CREER #HastaElÚltimoMinuto https://t.co/21ieBdDT08",424,179,2018,196452,603,0.31
1538,¡Somos Olimpia!  #ElMásPopular #OlimpiaPositivo #YoSoyOlimpia https://t.co/2LmjUUoEdt,132,27,2018,196452,159,0.08
1539,Comunicado Club Olimpia Deportivo https://t.co/CmUnU9oQQl,60,9,2018,196452,69,0.04
1540,"¡Somos el más popular! ¡Vamos por la remontada! Lo hemos hecho muchas veces lo intentaremos una vez más. 
¡Juntos jugamos la final!

#OlimpiaPositivo https://t.co/vqdPdPW6sd",261,73,2018,196452,334,0.17
1541,Comunicado Club Olimpia Deportivo https://t.co/8ohMufMqr1,198,52,2018,196452,250,0.13
1542,"¿Están listos para la remontada? 

#OlimpiaPositivo #YoCreo https://t.co/MZeKTnZnvc",227,70,2018,196452,297,0.15
1543,A medios de comunicación el Club Olimpia Deportivo informa: https://t.co/8PgoQiYvRZ,70,12,2018,196452,82,0.04
1544,"¡Olimpista! Nuestra historia ha hecho de lo imposible posible.
Vamos a hacernos un puño,vamos a pintar de blanco el Nacional,vamos a CREER.

Falta una batalla y la vamos a jugar juntos.

#OlimpiaPositivo #CREER https://t.co/MjJllNElZn",323,115,2018,196452,438,0.22
1545,"Fin del partido. Esto se decidirá el próximo domingo. ¡Vamos leones!

Olimpia 0-2 Motagua

#OlimpiaPositivo #YoSoyOlimpia #ElMásPopular https://t.co/06fiayQtWD",87,27,2018,196452,114,0.06
1546,"Min. 70 -  Olimpia 0-2 Motagua

#OlimpiaPositivo #YoSoyOlimpia #ElMásPopular",19,9,2018,196452,28,0.01
1547,"Min. 64 - Caemos en el marcador, ¡vamos leones! 

Olimpia 0-1 Motagua

#OlimpiaPositivo #YoSoyOlimpia #ElMásPopular",12,3,2018,196452,15,0.01
1548,"Nos vamos al descanso con el marcador empatado sin goles.

Olimpia 0-0 Motagua

#OlimpiaPositivo #YoSoyOlimpia #ElMásPopular https://t.co/FgXJo1N8a5",23,6,2018,196452,29,0.01
1549,"Min. 32 - Sale expulsado Jonathan Paz. 

#OlimpiaPositivo #YoSoyOlimpia #ElMásPopular",14,4,2018,196452,18,0.01
1550,"Min. 18 - El partido continúa empatado sin goles. ¡Vamos Olimpia! 

#OlimpiaPositivo #YoSoyOlimpia #ElMásPopular",19,5,2018,196452,24,0.01
1551,"Inició  el partido en el Nacional. ¡Vamos por el primer paso!

#OlimpiaPositivo #YoSoyOlimpia #ElMásPopular https://t.co/fT4EMxsq2q",26,16,2018,196452,42,0.02
1552,"¡Juntos jugamos la final! Albert Ellis tambien envia su mensaje de apoyo.

¡Vamos Olimpia! 

#OlimpiaPositivo #ElMásPopular https://t.co/utqnJxHJ8E",125,42,2018,196452,167,0.09
1553,"Romell Quioto manda su mensaje de apoyo al más popular.

#YoSoyOlimpia #OlimpiaPositivo https://t.co/BhYzPzVvMd",139,51,2018,196452,190,0.1
1554,"¡Hoy juega el más popular! ¡El Más Grande de Centroamerica te convoca para llenar el Nacional!

¡La final la jugamos todos! 

⚽ Vs. Motagua
📅 Domingo 09/12/18
⏱ 4:00 pm
🏟 Estadio Nacional
💵 Sol:100, Niños Sol: 50  Sombra 200 y Silla 400 

Boletos solo en puntos Tengo https://t.co/QRDUMGjkTH",156,40,2018,196452,196,0.1
1555,"¡El Club Olimpia Deportivo dice presente en la Teletón!

¡Todos somos Teletón!

#OlimpiaPositivo https://t.co/0dzxlwU4K3",160,30,2018,196452,190,0.1
1556,"Marcador final en el Birichiche

Olimpia 1 - Vida 1 Final de reservas

Próximo sábado la Gran Final desde La Ceiba

#OlimpiaPositivo #LaReserva https://t.co/ctxST3opue",35,11,2018,196452,46,0.02
1557,"¡Felicidades Oscar! ¡Esta es tu casa!

#OlimpiaPositivo #CumpleañosAlbo https://t.co/7gsdga8Unp",134,20,2018,196452,154,0.08
1558,"¡Hoy jugamos! 

¡Olimpista! ¡Vamos a apoyar las reservas en la final!

⚽ Vs. Vida
📅 Sabado 08/12/18
⏱ 6:00 pm
🏟 Estadio El Birichiche
💵 30 Lps

#OlimpiaPositivo  #ElMásPopular 👊 https://t.co/OlnnTjDkNa",54,14,2018,196452,68,0.03
1559,"¡Cada vez falta menos para verte León!

A un dia de la Gran Final,Olimpia esta listo.

#OlimpiaPositivo #ElMásPopular https://t.co/EBguaxOTIl",147,45,2018,196452,192,0.1
1560,"¡Locura en la firma de autógrafos del Club Olimpia! 

#OlimpiaPositivo #ElMásPopular https://t.co/cUX756t3DS",103,17,2018,196452,120,0.06
1561,"Firma de autografos desde Diunsa Los Proceres

#ElMásPopular #OlimpiaPositivo https://t.co/eOx2zJQCEr",181,44,2018,196452,225,0.11
1562,"¡Un diciembre asi! 

Motagua 0 - Olimpia 1 
23/12/95

#OlimpiaPositivo #YoSoyOlimpia https://t.co/CSLOIq4rB5",226,70,2018,196452,296,0.15
1563,Declaraciones Manuel Keosseian previo a la Gran Final https://t.co/FFQX2Hz4ks,73,23,2018,196452,96,0.05
1564,Comunicado Club Olimpia Deportivo https://t.co/hxqQ87pXp9,78,15,2018,196452,93,0.05
1565,"¡Olimpista! Gran firma de autografos del más popular.
Lugar: Diunsa Los Proceres
Hora: 4:00 pm

#OlimpiaPositivo #SomosOlimpia
#SomosUmbro https://t.co/hIGk39vcDm",91,24,2018,196452,115,0.06
1566,Ya se realiza la reunión de seguridad para la Gran Final del domingo. https://t.co/H6I9bqoHvD,59,16,2018,196452,75,0.04
1567,"¡Figuras! ¡Olimpia es alegría! Dejale un mensaje a Carlo Costly @carlocostly31 y a Jerry Bengston @JerryBengtson de cara a la final del domingo.

#OlimpiaPositivo #YoSoyOlimpia https://t.co/QEwvvTzRSN",269,47,2018,196452,316,0.16
1568,"Ya los boletos están disponibles en comercios Circle K, Pronto, Stop &amp; Go y Punto Farma a nivel nacional, y en Kioscos TENGO de Multiplaza y Metromall en Tegucigalpa, y Multiplaza y Citymall de SPS

NO HABRÁ VENTA DE BOLETOS EN EL ESTADIO

SOL:100/Niños50 -SOMBRA 200
SILLA  400 https://t.co/limTJMVO14",75,24,2018,196452,99,0.05
1569,El Club Olimpia les recuerda que para obtener y retirar su credencial para la Gran Final deberan presentar su carné vigente de La Liga Nacional. https://t.co/oOIA7041dO,33,6,2018,196452,39,0.02
1570,"El amor a Olimpia no tiene edades

#OlimpiaPositivo #YoSoyOlimpia https://t.co/DzFUK4RCQW",287,65,2018,196452,352,0.18
1571,"¡Olimpista! ¡Vamos a apoyar las reservas en la final!

⚽ Vs. Vida
📅 Sabado 08/12/18
⏱ 6:00 pm
🏟 Estadio Los Angeles

#OlimpiaPositivo  #ElMásPopular 👊 https://t.co/dtaVQNMa6q",58,14,2018,196452,72,0.04
1572,"Le recordamos a todos lo medios de comunicación que mañana es el último dia para las acreditaciones del juego de la Gran Final: Olimpia - Motagua.
Las acreditaciones se estaran entregando el dia viernes en las oficinas del Club Olimpia.

https://t.co/uQ4vN6xa81",50,13,2018,196452,63,0.03
1573,"Un dia como hoy hace 30 años Nahun Espinoza nos regalaba uno de los mejores goles de nuestra historia en el Alejandro Morera Soto ante La Liga Deportiva Alajuelense y nos clasificaba a la final de la Concacaf.

#ElMasGrandeDeCa #OlimpiaPositivo #30AñosConcacaf https://t.co/0kIeyzmyxM",297,109,2018,196452,406,0.21
1574,"No hay otra forma ¡unidos hasta el final! ¡Somos el más popular! ¡Somos el más grande de Centroamerica!

#OlimpiaPositivo https://t.co/ykzyJsjIIT",295,62,2018,196452,357,0.18
1575,Comunicado Club Olimpia deportivo. Para las acreditaciones de la gran final dirigirse a la página oficial del Club:https://t.co/Id7GKgbIzW https://t.co/9G6Za1Kd3w,51,19,2018,196452,70,0.04
1576,"Galeria de fotos semifinales Olimpia- Real España

#OlimpiaPositivo https://t.co/XadgJjtk9S",63,12,2018,196452,75,0.04
1577,"Felicitamos a nuestras reservas que jugaran una nueva final luego de derrotar 4-2 al Marathon en el Yankel Rosenthal.

¡Vamos Olimpia! 

#OlimpiaPositivo #LaReserva https://t.co/PgauYkuAec",97,19,2018,196452,116,0.06
1578,"¡La final la jugamos todos! 

⚽ Vs. Motagua
📅 Domingo 09/12/18
⏱ 4:00 pm
🏟 Estadio Nacional
💵 Sol:100, Niños Sol: 50  Sombra 200 y Silla 400 

Los boletos se venderán únicamente en los Puestos Tengo en todo el pais.

#YoSoyOlimpia  #ElMásPopular 👊 https://t.co/RZDXnjGExg",186,76,2018,196452,262,0.13
1579,"¡Estamos en la final! Gracias a todos los aficionados que llenaron el Nacional y a cada Olimpista que apoyó en el mundo entero.

¡Sigamos juntos,sigamos positivos!

#OlimpiaPositivo #ElMásPopular https://t.co/oYgp0sSVCa",202,46,2018,196452,248,0.13
1580,"¡La postal! ¡Felicidades a todos los Olimpistas! A disfrutar de una nueva gran final.

#OlimpiaPositivo #YoSoyOlimpia
#ElMásPopular https://t.co/uAp750zoSY",391,93,2018,196452,484,0.25
1581,"¡A la final! ¡Vaaaaaaamos Olimpia! 
#OlimpiaPositivo #YoSoyOlimpia https://t.co/XXOx7iOKtN",111,41,2018,196452,152,0.08
1582,"Los campeones Sub16 nos acompañan esta noche en el Nacional.
¡Felicidades muchachos! 

#OlimpiaPositivo #YoSoyOlimpia
#Fbo https://t.co/sJwamDRFGr",86,12,2018,196452,98,0.05
1583,"¡Goooooooool de Olimpia! David Contreras anota el 1 - 3 en el Yankel Rosenthal 
#OlimpiaPositivo #ElMásPopular https://t.co/Id8PHC5uNl",36,8,2018,196452,44,0.02
1584,"¡Goooooooooool de Olimpia! Jorge Almendarez pone el 0 - 2 para Olimpia reservas al minuto 41 del primer tiempo.

Global Olimpia 3 - Marathon 1 

#OlimpiaPositivo #YoSoyOlimpia https://t.co/fisgqg2gBE",20,6,2018,196452,26,0.01
1585,"¡Gooooooool de Olimpia! En reservas Sebastian Paredes pone a ganar a las reservas.
Marathon 0 - Olimpia 1 
#YoSoyOlimpia https://t.co/4KhGJo15ZZ",38,8,2018,196452,46,0.02
1586,"Ganadores de entradas para el clásico @_davehunter_ @eperalta89 @esau16_RM @nathyAC12 @ricard9004 @J_sandoval_17 @GiseCruzM @carivera2208

Reclamar entrada en porton 11 del estadio Nacional

¡Vamos apoyar al más popular! https://t.co/Jssx4lIRC2",22,2,2018,196452,24,0.01
1587,"¡Las reservas se juegan el pase a la final!
 
⚽ Vs. Marathon
📅 Sabado 01/12/18
⏱ 3:00 pm
🏟 Estadio Yankel Rosenthal
💵 30 Lps sector de Silla

#YoSoyOlimpia #RugeLeón #ElMásPopular 👊 https://t.co/9JAykMnz3C",21,6,2018,196452,27,0.01
1588,"¡Hoy juega Olimpia! ¡Hoy juega el más popular! 

Todos positivos y con buenas vibras para los once leones que saldrán a darlo todo

¡Somos Olimpia! ¡Somos Positivos!

#OlimpiaPositivo #YoSoyOlimpia https://t.co/2HJYPmL09J",113,57,2018,196452,170,0.09
1589,"¡Olimpista! Tu apoyo siempre es importante.
Te dejamos las siguientes recomendaciones y seamos aficionados responsables.

#OlimpiaPositivo #YoSoyOlimpia https://t.co/VHDwc1m70X",146,45,2018,196452,191,0.1
1590,Entrevista Manuel Keosseian https://t.co/VMTtMBOpYp,25,8,2018,196452,33,0.02
1591,"Se realiza en este momento la reunión de seguridad entre la policía nacional y representantes de @lnphonduras @LaUltraFiel_ Club Olimpia y Real España.

Rivales en la cancha,familias en las gradas

#OlimpiaPositivo https://t.co/q48qhpbbfl",60,14,2018,196452,74,0.04
1592,"Comunicado Club Olimpia Deportivo: Para nuevo reglamento de prensa dirigirse a link de la página oficial https://t.co/SFZYqR91x9 
 https://t.co/IWpMT1v520 https://t.co/G7SFFqO6jn",49,8,2018,196452,57,0.03
1593,"¡Olimpia hoy! ¡Olimpia siempre! 

#OlimpiaPositivo #YoSoyOlimpia
#ElMásPopular https://t.co/i8juGJTDKz",246,79,2018,196452,325,0.17
1594,"¿Querés ganarte entradas para ver al más popular este sabado en las semifinales de la Liga? 🎫⚽🏟😍

☝Hacé esto: 
1⃣ Dale me gusta a esta publicación
2⃣ Dale RT 
3⃣ Dejale un mensaje de apoyo al equipo con el hashtag #OlimpiaPositivo

¡Se sortean este Sábado! https://t.co/ryvchU3RTr",379,176,2018,196452,555,0.28
1595,"¡Somos Olimpia! Sacá tu camisa,ponetela desde hoy,besá el escudo,sentite orgulloso del equipo más popular y más grande de Centroamérica.

""Yo soy Olimpia,es un sentimiento,no puedo parar"" 

#OlimpiaPositivo #YoSoyOlimpia
#ElMásPopular #ElMasGrandeDeCa https://t.co/0SvDqJMb6f",195,60,2018,196452,255,0.13
1596,"¡Olimpistas! Compren su boleto YA para la SEMIFINAL del Olimpia, vs Real España, boletos disponibles en comercios Circle K, Pronto, Stop &amp; Go y Punto Farma y también en kioscos TENGO de Multiplaza y Metromall en Tegucigalpa; Multiplaza y City Mall en San Pedro Sula. https://t.co/Otm5TODabU",68,22,2018,196452,90,0.05
1597,"¡Feliz miercoles Albos! ¡Somos Olimpia! ¡Somos Positivos!

Queremos el Nacional a reventar

Precios: Sol 70,Sombra 120 y Silla 300
Los niños menores de 12 años entran gratis a Sol acompañados de un adulto.

#OlimpiaPositivo #YoSoyOlimpia https://t.co/W2u0Tg7s5I",181,42,2018,196452,223,0.11
1598,Declaraciones del asistente técnico Mario Beata https://t.co/wf7dmoRIms,56,14,2018,196452,70,0.04
1599,"Un dia como hoy hace 30 años Olimpia empataba con la Liga Deportiva Alajuelense en las semifinales de la Copa de Campeones de la Concacaf.

Conmemoramos a ese grupo de jugadores que nos dió luego nuestro último titulo como los mejores del área.

#OlimpiaPositivo #ElMasGrandeDeCa https://t.co/YhYhBGF4zw",83,23,2018,196452,106,0.05
1600,"Galeria de fotos semifinales

#OlimpiaPositivo #YoSoyOlimpia
#RugeLeón #ElMásPopular https://t.co/JIy2mLxEBc",52,9,2018,196452,61,0.03
1601,"¡Final! Semifinal torneo de reservas.
#YoSoyOlimpia #ElMásPopular #LaReserva https://t.co/BrcmTZHC5L",48,8,2018,196452,56,0.03
1602,"¡Olimpista! ¡El más popular te convoca! Vamos a llenar el estadio Nacional y apoyar de principio a fin.

Semifinales vuelta
 
⚽ Vs. Real España
📅 Sábado 01/12/18
⏱ 7:00 pm
🏟 Estadio Nacional

#OlimpiaPositivo #RugeLeón #ElMásPopular #YoSoyOlimpia 👊 https://t.co/kRbq6wEr5I",150,46,2018,196452,196,0.1
1603,"Camiseta Olimpia segunda equipación.  
Disponible en https://t.co/b3d7US0Ypk 
Adquirí la indumentaria oficial del Club Olimpia 
#SomosOlimpia #SomosUmbro https://t.co/JK9jJ8gwaW",73,13,2018,196452,86,0.04
1604,"¡Gooooooooooool! ¡Goooooooooool!
Bryan Moya a los 6' minutos del primer tiempo
Real España 1 - Olimpia 1 
#OlimpiaPositivo #YoSoyOlimpia #ElMásPopular https://t.co/6H4jWtyEIc",66,8,2018,196452,74,0.04
1605,"¡Final! Real España 2 - Olimpia 2
#OlimpiaPositivo #ElMásPopular https://t.co/TLn7qyarVw",48,14,2018,196452,62,0.03
1606,"¡Goooooooooool! ¡Gooooooooool! 
¡Kevin Alvarez! A los 60 minutos
Real España 2 - Olimpia 2 
#OlimpiaPositivo #YoSoyOlimpia
#RugeLeón https://t.co/fZGrbLzQkh",55,10,2018,196452,65,0.03
1607,"Último cambio en Olimpia: Entra German Mejia sale Diego Reyes minuto 86'
#OlimpiaPositivo #YoSoyOlimpia",8,2,2018,196452,10,0.01
1608,"Cambio en Olimpia: Entra Alejandro Reyes sale Bryan Moya minuto 75
#OlimpiaPositivo #YoSoyOlimpia",6,0,2018,196452,6,0.0
1609,"Segundo cambio en Olimpia: Entra Junior Lacayo sale Carlos Will Mejia a los 80 minutos
#OlimpiaPositivo #YoSoyOlimpia",3,0,2018,196452,3,0.0
1610,"Inicia el segundo tiempo
¡Vamos Olimpia! #OlimpiaPositivo #YoSoyOlimpia",14,2,2018,196452,16,0.01
1611,21 minutos del primer tiempo Real España 1 - Olimpia 0 #OlimpiaPositivo #YoSoyOlimpia,9,2,2018,196452,11,0.01
1612,"¡Ídolo y capitán! Los nuestros mandan su apoyo al más popular
#OlimpiaPositivo #YosoyOlimpia https://t.co/7SR8bzHhNM",166,52,2018,196452,218,0.11
1613,"¡Uno de los nuestros manda su apoyo! ¡Somos Olimpia,somos positivos! @rrojasl #OlimpiaPositivo #YosoyOlimpia https://t.co/fF7rs2vcIH",162,50,2018,196452,212,0.11
1614,"¡Hoy juega La Pimpa! Nos hacemos un solo nudo para apoyar al mas grande de Centroamérica.

Ponete la blanca y subí una imagen con un mensaje de apoyo a los jugadores con el hashtag #OlimpiaPositivo

¡Somos Olimpia! ¡Somos positivos! 
#OlimpiaPositivo #ElMásPopular https://t.co/Ey9sMZdUaB",123,42,2018,196452,165,0.08
1615,"Disponible Chumpa Club Olimpia. Visitá https://t.co/b3d7US0Ypk y adquirí la indumentaria oficial del Club Olimpia
#SomosOlimpia #SomosUmbro https://t.co/NTWkTSQxQH",59,16,2018,196452,75,0.04
1616,"¡Las reservas en semifinales! 
 
⚽ Vs. Marathon
📅 Lunes 26/11/18
⏱ 3:30 pm
🏟 Estadio Los Angeles

#YoSoyOlimpia #RugeLeón #ElMásPopular 👊 https://t.co/aC7Pq0vL3G",33,9,2018,196452,42,0.02
1617,Semifinales Clausura 2004 Real España 1 - Olimpia 4 Estadio Olimpico Metropolitano Suscribite al canal de Youtube del Club Olimpia Deportivo #OlimpiaPositivo https://t.co/8VUiOWaeBe https://t.co/ofwN0onK1a,102,24,2018,196452,126,0.06
1618,¡Vamooooos Olimpia! #OlimpiaPositivo  #YoSoyOlimpia https://t.co/UbDUY7imXp,159,64,2018,196452,223,0.11
1619,"Genio y figura. Unico e Irrepetible.
Campeonisimo en el 92,Campeón en el 97 y 2003.
El Club Deportivo Olimpia felicita hoy en su cumpleaños a uno de los suyos. ¡Felicidades Maestro Chelato Ucles! #OlimpiaPositivo #YoSoyOlimpia #ElMásPopular #CumpleañosAlbo https://t.co/s5Vh6gJL3P",208,44,2018,196452,252,0.13
1620,"¡El más popular se prepara! Entrenamiento de hoy en las canchas Tio Dolmo 
#OlimpiaPositivo #ElMásPopular #RugeLeón #YoSoyOlimpia https://t.co/qPvaGlCXCv",92,23,2018,196452,115,0.06
1621,"Disponible camiseta entrenamiento. Visitá https://t.co/b3d7US0Ypk y adquirí la indumentaria oficial del Club Olimpia
#SomosOlimpia #SomosUmbro https://t.co/BWVtiR2LHU",66,12,2018,196452,78,0.04
1622,"¡Cada vez falta menos para verte Olimpia querido! 

El sábado nos vemos en el Olímpico🏟 ¡Buen miércoles!

#OlimpiaPositivo #YoSoyOlimpia
 #ElMásPopular https://t.co/lhFHUBZo4p",160,35,2018,196452,195,0.1
1623,"¡Somos Olimpia! #OlimpiaPositivo #YoSoyOlimpia #ElMásPopular 
#ClásicoModerno #RugeLeón https://t.co/y0lxey3bUv",171,43,2018,196452,214,0.11
1624,"Esteban Espindola y Ever Alvarado en declaraciones hoy antes de salir hacia la ciudad de Tela.
#OlimpiaPositivo #ElMásPopular #RugeLeón https://t.co/eVqc3tNEgL",54,15,2018,196452,69,0.04
1625,"¡Ser Olimpia es CREER!
Dejá un video corto con un mensaje de apoyo a los jugadores con el hashtag #OlimpiaPositivo 
¡El clásico lo ganamos juntos! Ser Olimpia es ser POSITIVO #OlimpiaPositivo https://t.co/2XeP0LNEPI",92,28,2018,196452,120,0.06
1626,¡Nuestro orgullo! Felicidades a Axel Gomez y Edwin Rodriguez jugadores del más popular que clasificaron al mundial de Polonia en el 2019 #RugeLeón #YoSoyOlimpia https://t.co/v91xrdeTva,82,21,2018,196452,103,0.05
1627,¡Felicidades muchachos! La selección nacional Sub-20 de Honduras estara en el mundial de Polonia 2019 https://t.co/tgosPTuVIE,186,52,2018,196452,238,0.12
1628,!Somos Olimpia! ¡En Olimpia creemos! Nuestra historia nos invita a CREER #YoSoyOlimpia #ElMásPopular #ClasicoModerno https://t.co/7Y3WPx3yen,235,69,2018,196452,304,0.15
1629,"¡Albo! ¡El más popular te convoca! 

¡Somos el más popular! 
⚽ Vs. Real España
📅 Sábado 24/11/18
⏱ 7:00 pm
🏟 Olimpico Metropolitano 

#YoSoyOlimpia #RugeLeón #ElMásPopular 👊 https://t.co/0fkBL5tgiW",131,36,2018,196452,167,0.09
1630,Comunicado Club Olimpia Deportivo https://t.co/8zk4X4Smg7,35,7,2018,196452,42,0.02
1631,!la galeria de los campeones! ¡Olimpia campeón en Sub-16! Olimpia 2 -Motagua 1 #RugeLeón #YoSoyOlimpia #ElMásPopular https://t.co/2MxqBbuMDJ https://t.co/sK5qEnJzj9,55,17,2018,196452,72,0.04
1632,Comunicado Club Olimpia Deportivo https://t.co/LyvdlZ9vpu,116,31,2018,196452,147,0.07
1633,¡Vamooooos Olimpia! #ElMásPopular #YoSoyOlimpia https://t.co/NMsEXZY6uu,247,73,2018,196452,320,0.16
1634,¡Campeones! !Olimpia es campeón en categoría Sub-16! #RugeLeón #YoSoyOlimpia #ElMásPopular https://t.co/OqyYC0qN46,154,41,2018,196452,195,0.1
1635,"¡Se juega la final en Sub-16! 

¡Somos el más popular! 
⚽ Vs. Motagua
📅 Sabado 17/11/18
⏱ 10:00 am
🏟 El Birichiche 

#YoSoyOlimpia #RugeLeón #ElMásPopular 👊 https://t.co/wB6vVKhW5O",33,9,2018,196452,42,0.02
1636,"!disponible la camisa manga larga del más popular! Visitá https://t.co/b3d7US0Ypk y adquirí la indumentaria oficial del Club Olimpia
#SomosOlimpia #SomosUmbro https://t.co/dBErnQkO9Z",100,19,2018,196452,119,0.06
1637,¡Somos Olimpia! !El Más Popular! ¡Unidos hasta el final! #RugeLeón #YoSoyOlimpia https://t.co/50uW4F5zgp,112,34,2018,196452,146,0.07
1638,"¡Visitá https://t.co/b3d7US0Ypk! Encontrarás todos la indumentaria oficial del más popular.
Envios a Estados Unidos y cualquier parte del mundo.
#SomosOlimpia #SomosUmbro 
#YoSoyOlimpia #ElMásPopular https://t.co/kc0XCK0d3O",53,11,2018,196452,64,0.03
1639,"¡Olimpia femenino campeón regional! Olimpia derrotó 3 - 0 a Fénix de Choluteca coronandose campeonas del torneo regional y disputaran la final nacional contra el equipo ganador de la zona norte.
Goles:Miriam Valladares,Fatima Mena y Magda Guifarro. #RugeLeón #YoSoyOlimpia https://t.co/RDIeLhsHME",67,15,2018,196452,82,0.04
1640,"En el Torneo de reservas Vida y Olimpia empataron a cero en el municipal Ceibeño.
Con este resultado Olimpia clasifica como segundo con 32 puntos y se enfrentará a Juticalpa en semifinales. #RugeLeón #YoSoyOlimpia #ElMásPopular https://t.co/u00YWyrAlJ",25,5,2018,196452,30,0.02
1641,"Adquirí los productos oficiales de Olimpia en la tienda oficial: https://t.co/b3d7USizgS 

#SomosOlimpia #SomosUmbro #LaNuevaBlanca #YoSoyOlimpia #ElMásPopular https://t.co/yQG2R9EISr",63,18,2018,196452,81,0.04
1642,"¡Feliz inicio de semana Olimpistas! Viene la etapa mas importante del torneo y no hay espacio para dudas.
Creer y amar estos colores siempre es el legado mas grande que nos dejaron las glorias pasadas.
¡Somos Olimpia! !Somos el más popular! 
#RugeLeón #YoSoyOlimpia #ElMásPopular https://t.co/OHWpCLbquK",179,27,2018,196452,206,0.1
1643,"Final en La Ceiba: Vida 2 - Olimpia 0
#RugeLeón #YoSoyOlimpia https://t.co/5rUHbgKyFy",31,12,2018,196452,43,0.02
1644,"Gol del Vida minuto 86:
Vida 2 - Olimpia 0 
#RugeLeón #VamosOlimpia",7,1,2018,196452,8,0.0
1645,Penal para el Vida minuto 85 segundo tiempo,5,1,2018,196452,6,0.0
1646,Tercer cambio en Olimpia: Entra Rony Martinez sale Carlo Costly a los 26 minutos del segundo tiempo #RugeLeón #YoSoyOlimpia,7,0,2018,196452,7,0.0
1647,Segundo cambio en Olimpia: Entra Marcelo Canales sale Hendry Thomas a los 15 del segundo tiempo #RugeLeón #YoSoyOlimpia,5,1,2018,196452,6,0.0
1648,"Inicia el segundo tiempo en La Ceiba: Vida 1 - Olimpia 0
#RugeLeón #YoSoyOlimpia",6,1,2018,196452,7,0.0
1649,Primer cambio en Olimpia:Sale Oscar Salas entra Diego Reyes #RugeLeón #YoSoyOlimpia,14,1,2018,196452,15,0.01
1650,"Final del primer tiempo en La Ceiba:
Vida 1 - Olimpia 0
#RugeLeón #YoSoyOlimpia https://t.co/BIwv7mIzWy",11,4,2018,196452,15,0.01
1651,"Gol del Vida minuto 45 Javier Portillo: Vida 1 - Olimpia 0 
# RugeLeón #YoSoyOlimpia",11,4,2018,196452,15,0.01
1652,27 minutos tiempo de hidratación,4,0,2018,196452,4,0.0
1653,20 minutos del primer tiempo y continua el empate: Vida 0 - Olimpia 0 #RugeLeón #YoSoyOlimpia,5,0,2018,196452,5,0.0
1654,"¡Inicia el partido en el municipal Ceibeño! Vida 0 - Olimpia 0
#RugeLeón #YoSoyOlimpia https://t.co/WAfdMpogWz",31,7,2018,196452,38,0.02
1655,Llegada del Olimpia https://t.co/o84YCUBKzB,44,8,2018,196452,52,0.03
1656,"¡La Ceiba esta de fiesta porque hoy juega Olimpia! ¡Ponete la blanca y vamos al municipal Ceibeño! ¡Somos el más popular! 👉 Liga Nacional Profesional
⚽ Vs. Vida
📅 Sábado 11/11/18
⏱ 10:00 am
📌 Municipal Ceibeño

#YoSoyOlimpia #RugeLeón #ElMásPopular 👊 https://t.co/wLaw7Exn5T",21,6,2018,196452,27,0.01
1657,Damos la bienvenida al profesor Anibal Gabriel Alcoba quien trabajará en conjunto al profesor Carlos Chang en la parte física del Club https://t.co/9HtiJsKGpJ,57,13,2018,196452,70,0.04
1658,"¡Ponete la blanca y vamos al municipal Ceibeño! ¡Somos el más popular! 👉 Liga Nacional Profesional
⚽ Vs. Vida
📅 Domingo 11/11/18
⏱ 10:00 am
📌 Municipal Ceibeño

#YoSoyOlimpia #RugeLeón #ElMásPopular 👊 https://t.co/zGJDcUAFDB",28,12,2018,196452,40,0.02
1659,Comunicado oficial junta directiva Club Olimpia Deportivo https://t.co/183yedmo8N,49,13,2018,196452,62,0.03
1660,https://t.co/gxOTopcJ5v,17,12,2018,196452,29,0.01
1661,Oficial: Se suspende el partido entre Vida y Olimpia en el municipal Ceibeño por la falla de dos torres de luz https://t.co/PlgWq0S5FF,56,23,2018,196452,79,0.04
1662,"https://t.co/b3d7US0Ypk la tienda oficial del más popular.

#SomosOlimpia #SomosUmbro #LaNuevaBlanca #YoSoyOlimpia #ElMásPopular https://t.co/2pKKSuSlfE",52,16,2018,196452,68,0.03
1663,"¡Ponete la blanca! Camiseta oficial Umbro Olimpia en https://t.co/b3d7US0Ypk

#SomosOlimpia #SomosUmbro #LaNuevaBlanca #YoSoyOlimpia #ElMásPopular https://t.co/5uiW5UGrGO",72,25,2018,196452,97,0.05
1664,"¡La Ceiba esta de fiesta porque hoy juega Olimpia! ¡Ponete la blanca y vamos al municipal Ceibeño! ¡Somos el más popular! 👉 Liga Nacional Profesional
⚽ Vs. Vida
📅 Sábado 10/11/18
⏱ 19:00
📌 Municipal Ceibeño

#YoSoyOlimpia #RugeLeón #ElMásPopular 👊 https://t.co/ZK8IWmwYfg",60,22,2018,196452,82,0.04
1665,"Se cumplen 30 años del último título de campeón de Concacaf del más popular.
Revivi lo mejor del Cruz Azul 1 - Olimpia 2 en el canal de Youtube
El primer triunfo de un equipo Centroamericano en el estadio Azteca.
#RugeLeón #YoSoyOlimpia #ElOrgulloNacional https://t.co/h5xik1NPc6",105,50,2018,196452,155,0.08
1666,¡Somos Olimpia! ¡Somos Umbro! Comprá la camiseta del Más Popular en tiendas Diunsa de todo el país. ¡Ponete la blanca! #RugeLeón #ElMásPopular #OlimpiaUmbro https://t.co/apahu5NgcM,140,37,2018,196452,177,0.09
1667,https://t.co/MX649YqSUK ¡Seguí el canal de Youtube del Club Olimpia! Los mejores videos y grandes sorpresas en el canal del más popular. #RugeLeón #ElMásPopular,48,14,2018,196452,62,0.03
1668,"Resultado torneo de reservas:
Olimpia 5 - Honduras del Progreso 0 estadio El Birichiche #RugeLeón #YoSoyOlimpia #LaReserva https://t.co/K7b8b8VF4d",57,12,2018,196452,69,0.04
1669,¡Feliz martes Olimpistas! ¡Unidos hasta el final! #RugeLeón #YoSoyOlimpia #ElMásPopular https://t.co/vnhm67VCVw,168,36,2018,196452,204,0.1
1670,"¡Felicidades Rey! #CumpleañosAlbo 
¡Orgullo Nacional! https://t.co/9lZQlyHZtg",179,52,2018,196452,231,0.12
1671,"¡Olimpista! ¡El Más Popular te convoca! 
Sábado 10 de noviembre 7:00 pm
Estadio Ceibeño
#RugeLeón #YoSoyOlimpia #ElMásPopular https://t.co/f6VeBK80fm",41,8,2018,196452,49,0.02
1672,Final en el Nacional: Olimpia 2 - Honduras Progreso 2 Jerry Bengston anotó ambos goles para Olimpia #RugeLeón #YoSoyOlimpia #ElMásPopular https://t.co/do1c25Gg8O,52,22,2018,196452,74,0.04
1673,Tercer y último cambio en Olimpia: Entra Hendry Thomas #31 Sale por lesión Jonathan Paz #17,6,0,2018,196452,6,0.0
1674,¡Goooooooooooooool! ¡Goooooooool! ¡Jerry Bengston otra vez!!! Minuto 68 Olimpia 2 - Honduras Progreso 2 #RugeLeón #YoSoyOlimpia #ElMásPopular https://t.co/QragtytktT,30,12,2018,196452,42,0.02
1675,Segundo cambio en Olimpia: Entra Bryan Moya #23 Sale Diego Reyes #9 #RugeLeón #YoSoyOlimpia,7,0,2018,196452,7,0.0
1676,Gol del Honduras Progreso Fredys López Olimpia 1 - Honduras Progreso 2 minuto 57 #RugeLeón #YoSoyOlimpia,4,1,2018,196452,5,0.0
1677,Primer cambio en Olimpia: Entra Rony Martinez Sale Mayron Flores #RugeLeón #YoSoyOlimpia,6,1,2018,196452,7,0.0
1678,¡Inicia el segundo tiempo en el Nacional! Olimpia 1 - Honduras Progreso 1 #RugeLeón #YoSoyOlimpia #ElMásPopular,9,2,2018,196452,11,0.01
1679,Final del primer tiempo en el Nacional: Olimpia 1 - Honduras Progreso 1 Jerry Bengston anotó por el más popular #RugeLeón #YoSoyOlimpia https://t.co/tfZxSFbHT2,11,1,2018,196452,12,0.01
1680,Gol del Honduras Progreso al 47 empata Juan Delgado Olimpia 1 - Honduras Progreso 1 #RugeLeón #YoSoyOlimpia,5,0,2018,196452,5,0.0
1681,Penal para @ClubHProgreso,5,0,2018,196452,5,0.0
1682,¡Goooooooooooooool! ¡Goooooooool! Jerry Bengston anota al 44' de penal #RugeLeón #YoSoyOlimpia #ElMásPopular https://t.co/Zg5H7yoZub,16,8,2018,196452,24,0.01
1683,¡Penaaaaaal! Penal para Olimpia al 43' #RugeLeón #YoSoyOlimpia #ElMásPopular,13,0,2018,196452,13,0.01
1684,Minuto 40 del primer tiempo: Olimpia 0 - Honduras Progreso 0 #RugeLeón #YoSoyOlimpia,3,0,2018,196452,3,0.0
1685,Gol anulado a Olimpia por posición adelantada al 31' #RugeLeón #YoSoyOlimpia #ElMásPopular,14,1,2018,196452,15,0.01
1686,20 minutos del primer tiempo se mantiene el 0 -0 en el Nacional #RugeLeón #YoSoyOlimpia #ElMásPopular,4,0,2018,196452,4,0.0
1687,Tarjeta amarilla para Jerry Bengston a los 12 minutos #RugeLeón #YoSoyOlimpia,5,0,2018,196452,5,0.0
1688,Asi salimos hoy https://t.co/gBcLKsae4B,21,6,2018,196452,27,0.01
1689,¡Inicia el partido en el Nacional! Olimpia 0 - Honduras Progreso 0 https://t.co/Yzhg7oAEWM,11,3,2018,196452,14,0.01
1690,"Los ganadores de pases dobles 
Reclamar boletos en portón 11 https://t.co/eBazM4Sh4W",12,3,2018,196452,15,0.01
1691,"¡Hoy juega Olimpia! ¡Ponete la blanca y nos vamos al Nacional! ¡Somos el más popular!

👉 Liga Nacional Profesional
⚽ Vs. Honduras Progreso
📅 Domingo 4/11/18
⏱ 16:00
📌 Nacional
Precios: Sol 60 Sombra 100 Silla 200

#YoSoyOlimpia #RugeLeón #ElMásPopular 👊 https://t.co/TyQVWVoFbR",116,42,2018,196452,158,0.08
1692,¡Olimpista! ¡El más popular te convoca! #RugeLeón #YoSoyOlimpia #ElMásPopular https://t.co/kqTjDknon1,158,29,2018,196452,187,0.1
1693,¡Rey de Copas! ¡El programa del más popular! Domingo 1:00 pm por Tsi #RugeLeón #YoSoyOlimpia https://t.co/iikBm18Xp8,131,37,2018,196452,168,0.09
1694,"¡Olimpista! Acercáte a los puntos Tengo mas cercanos y comprá en preventa tu boleto para ver al más popular el domingo en el Nacional.
#RugeLeón #YoSoyOlimpia #ElMásPopular https://t.co/rao5OUtVxu",51,10,2018,196452,61,0.03
1695,¡Olimpista! Subí una foto con la camisa del más popular con una frase de apoyo a los jugadores y participá en el sorteo de entradas dobles para el domingo #RugeLeón #YoSoyOlimpia #ElMásPopular https://t.co/L4OxVZWdwO,108,27,2018,196452,135,0.07
1696,"Galeria de fotos Lobos UPN 2 - Olimpia 1 
¡Locales en todos lados! https://t.co/TO0NajO4UK",86,18,2018,196452,104,0.05
1697,"¡En San Pedro Sula y Choluteca! ¡Ahora en casa con nuestra gente!
¡Somos El Más Popular! El equipo de las masas,el fenómeno social.

Vamos a llenar el domingo nuestra casa ¡Porque el sueño sigue intacto!
#RugeLeón #YoSoyOlimpia #ElMásPopular https://t.co/VQbKp99jfG",109,22,2018,196452,131,0.07
1698,"¡Albo! ¡El Más Popular te convoca! 

👉 Liga Nacional Profesional
⚽ Vs. Honduras Progreso
📅 Domingo 4/11/18
⏱ 16:00
📌 Nacional
Precios: Sol 60 Sombra 100 Silla 200
Precios en preventa en puntos Tengo con descuento en las entradas.

#YoSoyOlimpia #RugeLeón #ElMásPopular 👊 https://t.co/Yz8o8E0yAC",61,20,2018,196452,81,0.04
1699,Final en el Emilio Williams de Choluteca: @LobosUpnfm 2 - Olimpia 1 #RugeLeón #YoSoyOlimpia #ElMásPopular https://t.co/AWvZc1XpVi,39,17,2018,196452,56,0.03
1700,¡Goooooooooooool del Olimpia! ¡! Junior Lacayo! ¡Vamoooooooooos Olimpia! #RugeLeón #YoSoyOlimpia 2-1 al 81 https://t.co/cmOWsK2yvf,32,13,2018,196452,45,0.02
1701,Gol de @LobosUpnfm 2-0 al 79',8,2,2018,196452,10,0.01
1702,Penal para la Upn al 77',5,0,2018,196452,5,0.0
1703,Tercer y último cambio en Olimpia al 75': Entra Carlo Costly Sale Rony Martinez #RugeLeón #YoSoyOlimpia,5,0,2018,196452,5,0.0
1704,"Segundo cambio en Olimpia al 65':
Entra Junior Lacayo Sale German Mejia #RugeLeón #YoSoyOlimpia",3,0,2018,196452,3,0.0
1705,Gol de la UPN al 55' 1-0 #RugeLeón #YoSoyOlimpia #ElMásPopular,7,3,2018,196452,10,0.01
1706,Tarjeta amarilla para Kevin Alvarez al 50',3,0,2018,196452,3,0.0
1707,Tarjeta amarilla para Oscar Salas al 47',5,3,2018,196452,8,0.0
1708,¡Inicia el segundo tiempo! En el Emilio Williams 0 - 0 #RugeLeón #YoSoyOlimpia #ElMásPopular,9,4,2018,196452,13,0.01
1709,Cambio en Olimpia: Entra Oscar Salas Sale Dabirson Castillo #RugeLeón #YoSoyOlimpia,6,0,2018,196452,6,0.0
1710,"! Final del primer tiempo! @LobosUpnfm 0 - Olimpia 0 
#RugeLeón #YoSoyOlimpia #ElMásPopular https://t.co/4DTuqeGGEV",13,1,2018,196452,14,0.01
1711,"40 minutos del primer tiempo @LobosUpnfm 0 - Olimpia 0
#RugeLeón #YoSoyOlimpia #ElMásPopular",3,0,2018,196452,3,0.0
1712,"32 minutos del primer tiempo @LobosUpnfm 0 - Olimpia 0
#RugeLeón #YoSoyOlimpia #ElMásPopular",6,0,2018,196452,6,0.0
1713,"15 minutos del primer tiempo @LobosUpnfm 0 - Olimpia 0
#RugeLeón #YoSoyOlimpia #ElMásPopular",8,0,2018,196452,8,0.0
1714,¡Asi salimos hoy! https://t.co/2D0Bhoz0SC,32,11,2018,196452,43,0.02
1715,¡Inicia el partido en Choluteca! UPN - Olimpia #RugeLeón #YoSoyOlimpia #ElMásPopular https://t.co/znhXl8Ipfi,12,3,2018,196452,15,0.01
1716,https://t.co/iRgwpDCVq9,22,4,2018,196452,26,0.01
1717,¡Vamos Olimpia! #RugeLeón #YoSoyOlimpia #ElMásPopular https://t.co/HT0DMSeWLX,97,18,2018,196452,115,0.06
1718,"¡Hoy juega Olimpia! ¡El más popular te convoca!

👉 Liga Nacional Profesional
⚽ Vs. @LobosUpnfm
📅 Miércoles 31/10
⏱ 19:00
📌 Emilio Williams

#YoSoyOlimpia #RugeLeón #ElMásPopular 👊 https://t.co/ayrGi7cGwP",121,39,2018,196452,160,0.08
1719,¡Albo! ¡Vamos a despedir el torneo regular llenando el Nacional! Acercate a los puntos Tengo mas cercanos a comprar tu boleto en preventa y darle el apoyo al más popular #RugeLeón #YoSoyOlimpia #ElMásPopular https://t.co/jurKxnIpd8,91,23,2018,196452,114,0.06
1720,¡Olimpista! ¿Con cuál de estas frases te identificas mas con el club?,51,24,2018,196452,75,0.04
1721,Declaraciones previo entrenamiento Manuel Keosseian https://t.co/8QTuiegDSj,86,19,2018,196452,105,0.05
1722,"Las mejores imágenes que nos dejó el triunfo 1-3 sobre Real España
#RugeLeón #YoSoyOlimpia #ElMásPopular https://t.co/7rrL7ZmAYb",90,20,2018,196452,110,0.06
1723,Comunicado oficial Junta Directiva Club Olimpia Deportiva https://t.co/aAmt9U0e9w,114,36,2018,196452,150,0.08
1724,"¡Olimpia en Choluteca!

👉 Liga Nacional Profesional
⚽ Vs. @LobosUpnfm
📅 Miércoles 31/10
⏱ 19:00
📌 Emilio Williams

#YoSoyOlimpia 👊 https://t.co/M5ufpMutaL",76,32,2018,196452,108,0.05
1725,¡Feliz semana Albos! ¡Unidos hasta el final! #RugeLeón #YoSoyOlimpia #ElMásPopular https://t.co/sa46WWrMnE,232,49,2018,196452,281,0.14
1726,"¡Gracias muchachos! 
""¡Yooooo soy Olimpia, es un sentimiento,no puedo parar!"" 
#RugeLeón #YoSoyOlimpia #ElMásPopular https://t.co/CnNVE5jLAL",459,133,2018,196452,592,0.3
1727,"¡Finaaaaaaaaaal! ¡El más popular! !El gigante! !Lo ganamos juntos! 

Real España 1- Olimpia 3 
#YoSoyOlimpia #RugeLeón #ElMásPopular https://t.co/K7bSQsEPcC",311,111,2018,196452,422,0.21
1728,¡Yoooooooo soy Olimpia!!!!!!,418,185,2018,196452,603,0.31
1729,Tercer y último cambio en Olimpia al 40: Entra Carlo Costly sale Jerry Bengston #RugeLeón #YoSoyOlimpia #ElMásPopular,24,3,2018,196452,27,0.01
1730,Segundo cambio de Olimpia al 36: Entra Dabirson Castillo sale Rony Martinez #RugeLeón #YoSoyOlimpia,17,0,2018,196452,17,0.01
1731,Olimpia realiza primer cambio a los 23 minutos: Entra Jhon Paul Suazo sale Diego Reyes,25,4,2018,196452,29,0.01
1732,"¡Gooooooooooooooolaaaaaaaaaaaazooooooooooo! ¡Golaaaaaaaaaaaaaaaaaaaazo! ¡El cañonero del Aguan pone el 1-3
¿Lo pueden creer todavia? #RugeLeón #YoSoyOlimpia #ElMásPopular https://t.co/Gy4xMOAnDT",110,35,2018,196452,145,0.07
1733,Gol de Real España 1-2,11,0,2018,196452,11,0.01
1734,"¡Goooooooooooooool! ¡Goooooooooool! ¡Jerry Bengston otra vez! Minuto 2 
Real España 0- Olimpia 2 
#RugeLeón #YoSoyOlimpia #ElMásPopular https://t.co/YHDzJz3IYN",75,27,2018,196452,102,0.05
1735,Inicia el segundo tiempo #RugeLeón #YoSoyOlimpia,14,1,2018,196452,15,0.01
1736,"¡Final del primer tiempo en San Pedro Sula! Real España 0- Olimpia 1 
Jerry Bengston #RugeLeón #YoSoyOlimpia #ElMásPopular https://t.co/xFm95ZDoiK",34,6,2018,196452,40,0.02
1737,"Tarjeta roja para Ever Alvarado.
Nos quedamos con diez jugadores
#RugeLeón #YoSoyOlimpia",27,8,2018,196452,35,0.02
1738,¡Goooooooooool! ¡Goooooooooool! ¡Jerry Bengston! ¡ 0-1 gana Olimpia a los 12 minutos #RugeLeón #YoSoyOlimpia #ElMásPopular https://t.co/zRHWxLehH1 https://t.co/wexubDIHdE,66,19,2018,196452,85,0.04
1739,¡Arranca el clásico! #RugeLeón #YoSoyOlimpia https://t.co/lMU0oc0u8j,20,1,2018,196452,21,0.01
1740,Se retrasa el partido por problemas de iluminación en una de las torres,31,7,2018,196452,38,0.02
1741,"Asi jugamos hoy: Edrick Menjivar,Ever Alvarado,Esteban Espindola,Jonathan Paz,Kevin Alvarez,Elmer Güity,Deybi Flores,German Mejia,Rony Martinez,Diego Reyes y Jerry Bengston https://t.co/hetseioGnu",99,33,2018,196452,132,0.07
1742,https://t.co/CAPlF2C8nw,107,27,2018,196452,134,0.07
1743,"¡Hoy juega Olimpia! El más popular llega hoy a San Pedro Sula a jugar el clásico mas apasionante del país.
¡Rivales en la cancha familias en las graderias! En paz y armonía a disfrutar del Clásico.
#RugeLeón #YoSoyOlimpia #ElMásPopular https://t.co/JmWsdVbzcU",146,49,2018,196452,195,0.1
1744,"¡El más popular ya esta en San Pedro Sula! entrevista de Manuel Keosseian para el programa ""Jorge Ramos y su Banda"" de Espn @ESPN_JorgeRamos @ESPN_CA https://t.co/rrTwx3SfF1",133,30,2018,196452,163,0.08
1745,"¡Albo! ¡La graderia Sur nos espera! En paz y respeto hacia el rival.
¡El clásico lo ganamos juntos! #RugeLeón #YoSoyOlimpia #ElMásPopular https://t.co/d4lLWqqdtP",148,43,2018,196452,191,0.1
1746,https://t.co/e9oVamXszV,46,11,2018,196452,57,0.03
1747,"!Buen dia Olimpistas! Un gran lider y ex-jugador se une al cuerpo técnico.
¡Bienvenido Mario Beata! https://t.co/79jQHamI2I",390,89,2018,196452,479,0.24
1748,¡Listo el profe Manolo! #RugeLeón #YoSoyOlimpia #ElMásPopular https://t.co/vsCjcZPd6Z,323,97,2018,196452,420,0.21
1749,Conferencia de prensa presentación Manuel Keosseian https://t.co/fNoQkOtzoe,37,13,2018,196452,50,0.03
1750,¡El profesor Manuel Keosseian se encuentra ya en el estadio Nacional previo a la conferencia de prensa para su presentación! #RugeLeón #YoSoyOlimpia https://t.co/qEZZAfbm3e,68,22,2018,196452,90,0.05
1751,"¡Gracias Nahun! Por tu compromiso, profesionalidad e incuestionable amor al equipo, que has demostrado en este período y a lo largo de los años como exitoso jugador y entrenador.
Te deseamos muchos éxitos en tus proyectos venideros. ¡Esta es tu casa! https://t.co/bAOtT2c6oV",223,69,2018,196452,292,0.15
1752,¡Bienvenido Prof. Manuel Keosseian al Club más grande y más popular! #RugeLeón #YoSoyOlimpia #ElMásPopular https://t.co/MMST8dr3q8,306,91,2018,196452,397,0.2
1753,Comunicado oficial junta directiva Club Olimpia Deportivo https://t.co/c79uiXU7E4,149,80,2018,196452,229,0.12
1754,Comunicado Junta Directiva Club Olimpia Deportivo https://t.co/tVFilTMpSJ,236,109,2018,196452,345,0.18
1755,"Resultado final: Olimpia 0- Platense 3 en el Birichiche.
#RugeLeón #YoSoyOlimpia",14,4,2018,196452,18,0.01
1756,"Gol de Platense al 84' 
Caemos 0-3 en el Birichiche
#RugeLeón #YoSoyOlimpia",6,1,2018,196452,7,0.0
1757,"Gol de Platense al 70.
Olimpia 0 - Platense 2 
#RugeLeón #YoSoyOlimpia",12,1,2018,196452,13,0.01
1758,Penal fallado por Daniel Duron de Olimpia continua 0-1 a favor del Platense reservas al 65 #RugeLeón #YoSoyOlimpia,5,1,2018,196452,6,0.0
1759,"Gol de Platense al 58 
0-1 pierde Olimpia en reservas
#RugeLeón #YoSoyOlimpia",5,1,2018,196452,6,0.0
1760,"Minuto 56 segundo tiempo en el Birichiche: Olimpia 0- Platense 0
Torneo de reservas
#RugeLeón #YoSoyOlimpia",9,0,2018,196452,9,0.0
1761,¡Nuestra U16! Clasificados a semifinales de la liga infantil San Jose.A la espera del ganador entre la UPN y Soledad.#RugeLeón #YoSoyOlimpia #LaReserva https://t.co/4GjGwVe2NY,17,10,2018,196452,27,0.01
1762,"¡La reserva por el liderato! 
¡Hoy juega Olimpia!

👉 Torneo de reservas
⚽ Vs. Platense
📅 Miercoles 24/10/2018
⏱ 18:00
📌 El Birichiche
 #RugeLeón 👊 
 Entrada gratis https://t.co/UhVKM9uvFG",30,4,2018,196452,34,0.02
1763,¡Felicidades Elmer! ¡Esta es tu casa! #CumpleañosAlbo https://t.co/mjMFU3Q3MX,78,12,2018,196452,90,0.05
1764,Carlos Pineda-Alejandro Reyes-Daniel Durón #RugeLeón #YoSoyOlimpia https://t.co/bA9gHuhGtB,72,11,2018,196452,83,0.04
1765,"¡Se viene el clásico mas apasionante del país! ¡El más popular en San Pedro Sula!  
Real España-Olimpia sábado 27 de octubre estadio Morazán 7:00 pm
¡El clásico de la era moderna lo ganamos juntos! #RugeLeón #YoSoyOlimpia #ElMásPopular https://t.co/mecAL2raj2",116,32,2018,196452,148,0.08
1766,"Fotos del partido entre Olimpia y Juticalpa por la Jornada 15.

Vea la galería completa en: https://t.co/38AlaSsWhM https://t.co/uaO9PHpd6L",35,5,2018,196452,40,0.02
1767,"¡Nuestras campeonas! Olimpia femenino derrotó 4-0 a Independiente de Siguatepeque en la final regional realizada ayer en la cancha del Birichiche.
#RugeLeón #YoSoyOlimpia #YoSoyOlimpia https://t.co/EcTrMPat8K",103,25,2018,196452,128,0.07
1768,"Con un partido menos, así se ubica Olimpia en la Tabla de Posiciones del Torneo Apertura 2018.

⚽ | #RugeLeón https://t.co/1J6km8CzqR",60,16,2018,196452,76,0.04
1769,¡Unidos hasta el final! Orgullosos de esta camiseta. ¡Feliz inicio de semana Olimpistas! #RugeLeón #YoSoyOlimpia #ElMásPopular https://t.co/AGyBoWTU14,133,39,2018,196452,172,0.09
1770,Conferencia de prensa Nahun Espinoza https://t.co/ZwFRZ2jQW4,37,8,2018,196452,45,0.02
1771,"Finaliza el partido en Tegucigalpa con un empate.

⚽️ | Olimpia 1-1 Juticalpa 
🦁 | #RugeLeón https://t.co/pOg4trlQoS",19,15,2018,196452,34,0.02
1772,"¡Final en el Nacional! Olimpia empata con Juticalpa 1-1 

Jerry Bengston anotó por el más popular #RugeLeón #YoSoyOlimpia",40,13,2018,196452,53,0.03
1773,Tarjeta amarilla para Jonathan Paz camiseta número 17,4,0,2018,196452,4,0.0
1774,"Gol del Juticalpa minuto 76 James Cabezas anota el penal.
Olimpia 1- Juticalpa 1 #RugeLeón #YoSoyOlimpia",6,0,2018,196452,6,0.0
1775,Penal para Juticalpa al 74',3,0,2018,196452,3,0.0
1776,Tercer y último cambio en Olimpia: Entra Diego Reyes sale Rony Martinez #RugeLeón #YoSoyOlimpia,5,0,2018,196452,5,0.0
1777,Segundo cambio en Olimpia a los 71': Entra Deybi Flores sale Elmer Güity,5,0,2018,196452,5,0.0
1778,"Cambio en Olimpia al 69': Entra Junior Lacayo sale Jhon Paul Suazo.
Olimpia 1- Juticalpa 0 #RugeLeón",5,1,2018,196452,6,0.0
1779,Tarjeta amarilla para Esteban Espindola a los 16' del segundo tiempo,7,0,2018,196452,7,0.0
1780,¡Goooooooooooool del Olimpia! ¡Jerry Bengston da la ventaja al más popular! Olimpia 1- Juticalpa 0 #RugeLeón #YoSoyOlimpia https://t.co/t9Xwrlb4Sk,28,9,2018,196452,37,0.02
1781,!Penaaaal! A favor del albo a los 4 minutos del segundo tiempo #RugeLeón #YoSoyOlimpia,12,1,2018,196452,13,0.01
1782,¡Inicia el segundo tiempo en el Nacional! #RugeLeón #YoSoyOlimpia,6,0,2018,196452,6,0.0
1783,"¡Final del primer tiempo! En el Nacional: Olimpia 0- Juticalpa 0
#RugeLeón #YoSoyOlimpia",13,3,2018,196452,16,0.01
1784,"En la final del torneo femenino regional primer tiempo estadio el Birichiche:

Olimpia 3- Independiente de Siguatepeque 0   #RugeLeón #YoSoyOlimpia",13,0,2018,196452,13,0.01
1785,25 minutos del primero tiempo y continua el empate entre Olimpia y Juticalpa #RugeLeón #YoSoyOlimpia,14,0,2018,196452,14,0.01
1786,¡Arranca en el Nacional! Olimpia-Juticalpa #RugeLeón #YoSoyOlimpia,15,4,2018,196452,19,0.01
1787,¡Asi jugamos hoy! https://t.co/zNlvjydgPg,14,6,2018,196452,20,0.01
1788,"¡Listos! La previa del juego ante @JuticalpaFC 
#RugeLeón #YoSoyOlimpia https://t.co/xigQnoLwDa",18,5,2018,196452,23,0.01
1789,https://t.co/0Bas7JXZ1n,20,3,2018,196452,23,0.01
1790,Llegada Club Olimpia https://t.co/7NzYCpQa3C,64,12,2018,196452,76,0.04
1791,Les presentamos nuestra nueva area de conferencia de prensa #RugeLeón #YoSoyOlimpia #ElMásPopular https://t.co/vVbiLbxktD,226,53,2018,196452,279,0.14
1792,¡La convocatoria para hoy! #RugeLeón #ElMásPopular https://t.co/XRJ2pXs56g,60,17,2018,196452,77,0.04
1793,"¡Olimpista! !Es domingo y hoy juega el más popular! #HoyJuegaOlimpia #RugeLeón #YoSoyOlimpia 
Precios: Silla 200 Sombra 100 Sol 60 https://t.co/vVuDlvM5fx",78,23,2018,196452,101,0.05
1794,¡Final! Olimpia 4- Juticalpa 0 en reservas #RugeLeón #YoSoyOlimpia,47,15,2018,196452,62,0.03
1795,"¡Gooooooool del Olimpia! Doblete de Alejandro Reyes.
En el Birichiche Olimpia 2- Juticalpa 0 #RugeLeón #YoSoyOlimpia https://t.co/KaHTKfqnuA",52,11,2018,196452,63,0.03
1796,"¡Gooooooooool del Olimpia! A los 15 minutos del primer tiempo Alejandro Reyes en el Birichiche 

Olimpia 1- Juticalpa 0 en reservas https://t.co/cU4f0PHASM",33,5,2018,196452,38,0.02
1797,"¡Olimpia reservas por un triunfo mas esta noche en el Birichiche! 

⚽ Olimpia-Juticalpa
🕖8:00 pm
Entrada gratis https://t.co/5LOSDsQ2l7",58,12,2018,196452,70,0.04
1798,"Olimpia se une a la campaña de concientización mundial para prevenir el cancer de mama.

La prevención es importante.

Cuidarte es quererte 
#DiaMundialDelCancerDeMama https://t.co/UpVgdxIReB",75,29,2018,196452,104,0.05
1799,¡Felicidades Bryan Moya! ¡Esta es tu casa! #CumpleañosAlbo #RugeLeón #YoSoyOlimpia @bryanmoya29 https://t.co/4xRt8ybR5s,95,11,2018,196452,106,0.05
1800,"¡Albo!
¡El más popular te convoca!! ⚽ 
🕔 4:00 pm 
🏟️ - Estadio Nacional de Tegucigalpa
🦁 - #RugeLeón #YoSoyOlimpia #ElMásPopular https://t.co/JTL1E3P6DC",83,34,2018,196452,117,0.06
1801,¡Las postales finales! ¡Patrick uno mas del plantel! #RugeLeón #YoSoyOlimpia #ElMásPopular https://t.co/Ddp3EQIsto,143,38,2018,196452,181,0.09
1802,"Finaliza el partido en el Nacional. El albo consigue tres puntos importantes. 

⚽️ | Olimpia 2-0 Real de Minas
🦁 | #RugeLeón https://t.co/X6f2br0HOp",68,42,2018,196452,110,0.06
1803,¡Final! Olimpia asume el liderato general al derrotar 2-0 al Real de Minas #RugeLeón #YoSoyOlimpia,94,32,2018,196452,126,0.06
1804,"Último cambio en Olimpia: Sale Jerry Bengston entra Deybi Flores.
#RugeLeón #YoSoyOlimpia",12,2,2018,196452,14,0.01
1805,"¡Gooooooooooool del Olimpia! ¡Oscar Salas! Minuto 83 
Olimpia 2 - Real de Minas 0 
#RugeLeón #YoSoyOlimpia",47,16,2018,196452,63,0.03
1806,"Minuto 77 Olimpia 1 Real de Minas 0
#RugeLeón #YoSoyOlimpia #ElOrgulloNacional",19,2,2018,196452,21,0.01
1807,Segundo cambio en Olimpia: Sale Rony Martinez e ingresa Diego Reyes #RugeLeón #YoSoyOlimpia,18,1,2018,196452,19,0.01
1808,Cambio en Olimpia:Sale Jhon Paul Suazo e ingresa Junior Lacayo #RugeLeón #YoSoyOlimpia,7,1,2018,196452,8,0.0
1809,https://t.co/2MniKU0pgp,34,10,2018,196452,44,0.02
1810,¡Goooooooool de Olimpia! Autogol de Esdras Padilla al 68' Olimpia ya lo gana 1-0 #RugeLeón #YoSoyOlimpia,29,7,2018,196452,36,0.02
1811,¡Inicia la segunda mitad en el Nacional! Olimpia 0- Real de Minas 0 #RugeLeón #YoSoyOlimpia,9,2,2018,196452,11,0.01
1812,Fin de la primera parte Olimpia empata 0-0 contra Real de Minas en el Nacional  #RugeLeón #YoSoyOlimpia,14,5,2018,196452,19,0.01
1813,¡Jerry! Donaldo al fondo detiene el primero para Olimpia #RugeLeón #YoSoyOlimpia,8,0,2018,196452,8,0.0
1814,¡Cercaaaa! Dabirson Castillo se incorpora al area y estuvo cerca de abrir el marcador #RugeLeón #YoSoyOlimpia,7,1,2018,196452,8,0.0
1815,¡Arranca en el Nacional! Olimpia-Real de Minas #RugeLeón #YoSoyOlimpia,12,5,2018,196452,17,0.01
1816,"¡La sorpresa para nuestros invitados esta noche! Jonathan y Patrick.
Los presentes a nombre de la junta directiva del Club Olimpia y Edrick Menjivar #RugeLeón #YoSoyOlimpia https://t.co/4zKVmQnDdY",215,81,2018,196452,296,0.15
1817,¡Sale a calentar el León! https://t.co/QZg7buo8kq,50,13,2018,196452,63,0.03
1818,Ganadores de entradas de Sombra para Olimpia-Real de Minas de esta noche:@calix1605 @carrivera2208 @wcampos25 @Saulgom88115519 @allanpaz8 @CarolaOrtiz07 @Leonard97873687 @Victor_ardon7 @poncexm13 @ikennethsamuel reclamar los boletos en la taquilla de Sombra sur #RugeLeón,28,6,2018,196452,34,0.02
1819,"¡Lo ganamos juntos! Dale Rt a esta publicación y gana entradas al sector de Sombra para el juego de hoy ante @RealMinasCD1
#RugeLeón #YoSoyOlimpia #ElMásPopular https://t.co/qgQcH3rFfL",83,82,2018,196452,165,0.08
1820,"Levantarse, ponerse la camiseta y saber que...¡Hoy juega Olimpia!
🕖 7:00 pm
Estadio Nacional de Tegucigalpa
Silla 200 Sombra 100 Sol 60 
#RugeLeón #YoSoyOlimpia
#ElMásPopular https://t.co/mLiHA0Zf43",107,49,2018,196452,156,0.08
1821,"Resultado final torneo de reservas en el Birichiche:
Real de Minas 1-Olimpia 1 
#RugeLeón #YoSoyOlimpia #ElMásPopular",40,6,2018,196452,46,0.02
1822,"!Final del primer tiempo en el Birichiche!
Real de Minas 1- Olimpia reservas 1
El Gol del Olimpia anotado por Almendarez #RugeLeón #YoSoyOlimpia #ElMásPopular",34,9,2018,196452,43,0.02
1823,Las reservas del más popular juegan hoy El Birichiche contra @RealMinasCD1 7:30 pm #RugeLeón #YoSoyOlimpia #ElMasPopular https://t.co/OWfzqvj6he,41,11,2018,196452,52,0.03
1824,Comunicado de agradecimiento a la mejor afición organizada del país @LaUltraFiel_ https://t.co/N0F83wfw2U,157,57,2018,196452,214,0.11
1825,Comunicado: https://t.co/A5Up2brhBL,70,23,2018,196452,93,0.05
1826,¡Felicidades al matador del bajo Aguan! Esta es tu casa #RugeLeón #YoSoyOlimpia #CumpleañosAlbo #RonyMartinez12 https://t.co/poBh4LS9cO,75,21,2018,196452,96,0.05
1827,"¡Albo! El más popular te convoca.
¡El jueves lo jugamos todos! Precios: Silla 200 Sombra 100 Sol 60 Lps.      
#RugeLeón #YoSoyOlimpia #ElMásPopular https://t.co/ADzhaJUpZA",84,35,2018,196452,119,0.06
1828,"Entrenamiento Club Olimpia
Declaraciones Dany Turcios #RugeLeón #YoSoyOlimpia #ElMásPopular https://t.co/WgxzKN3RYQ https://t.co/FbngoeMqCF",29,15,2018,196452,44,0.02
1829,"Entrenamiento Club Olimpia
Declaraciones Wilson Palacios #RugeLeón #YoSoyOlimpia #ElMásPopular https://t.co/WgxzKN3RYQ",70,18,2018,196452,88,0.04
1830,"Imágenes del partido entre Olimpia y Motagua por cortesía de @bancatlan

Vea la galería completa en: https://t.co/Ir7ZBIxtwj https://t.co/WURfkcFPHq",46,8,2018,196452,54,0.03
1831,"Con dos partido menos, así se ubica Olimpia en la Tabla de Posiciones del Torneo Apertura 2018.

⚽ | #RugeLeón https://t.co/vxs296lfoF",69,24,2018,196452,93,0.05
1832,¡Lideres invictos! Nos vemos el jueves en el Nacional #RugeLeón #YoSoyOlimpia #ElOrgulloNacional ¡El más popular! https://t.co/DtUrElwWaC,348,106,2018,196452,454,0.23
1833,"Finaliza el partido. Los leones empatan el clásico en el Nacional.

⚽️ | Olimpia 1-1 Motagua
🦁 | #RugeLeón https://t.co/tMKpdtHDb5",49,22,2018,196452,71,0.04
1834,"!!Final!! SuperClásico tablas.
Olimpia 1- Motagua 1 Rony Martinez y Rubilio Castillo",47,13,2018,196452,60,0.03
1835,Gooooooooooooooooooool!!!!!!!!!!!! Rony!!!! Rony!!!!! El mas popular!!!!! Olimpia 1- Motagua 1 al 84' https://t.co/bvyXhH7ejG,98,30,2018,196452,128,0.07
1836,"Doble cambio en el más popular Sale Diego Reyes y Entra Jerry Bengston.
Sale Carlos Pineda entra Rony Martinez al 68'",24,3,2018,196452,27,0.01
1837,"Minuto 63 gol de Motagua Rubilio Castillo.
Olimpia 0 Motagua 1 #RugeLeón #YoSoyOlimpia",5,1,2018,196452,6,0.0
1838,10 minutos de juego y continua el empate #RugeLeón #SuperClasicoHN,4,1,2018,196452,5,0.0
1839,Inicia el segundo tiempo en el Nacional Olimpia-0 Motagua 0 #SuperClásicoHN #RugeLeón #YoSoyOlimpia,13,1,2018,196452,14,0.01
1840,¡¡Final del primer tiempo!! Olimpia 0-Motagua #RugeLeón #YoSoyOlimpia,11,2,2018,196452,13,0.01
1841,35 minutos del primer tiempo Olimpia 0-Motagua 0 #RugeLeón #YoSoyOlimpia,6,1,2018,196452,7,0.0
1842,Tarjeta amarilla para Ever Alvarado al 19' continua el empate a cero #RugeLeón #YoSoyOlimpia,4,1,2018,196452,5,0.0
1843,15 minutos de juego 0-0 #SuperClásico #RugeLeon #YoSoyOlimpia,6,1,2018,196452,7,0.0
1844,Asi salimos hoy https://t.co/8uiP46d5el,31,6,2018,196452,37,0.02
1845,Arranca en el Nacional!! SuperClásico #RugeLeon,21,8,2018,196452,29,0.01
1846,¡Llegada Club Olimpia al SuperClásico! #RugeLeón #YoSoyOlimpia #ElOrgulloNacional ¡El más popular! https://t.co/wGsJlpnLRR,80,31,2018,196452,111,0.06
1847,¡Listos! #RugeLeón #YoSoyOlimpia ¡El más popular! #SuperClásico https://t.co/ZDKvODLeSF,138,49,2018,196452,187,0.1
1848,"Listas las entradas Tengo en los portones del estadio Nacional.
Si compraste tu boleto en los puntos Tengo acercate a validar tu pase.
#RugeLeón #YoSoyOlimpia ¡El más popular! https://t.co/EXdwAwX0iY",20,5,2018,196452,25,0.01
1849,Estos son los ganadores de boletos al superclásico. El boleto lo podes reclamar en el portón No. 11 frente a la Gasolinera Texaco. Antes de las 3 pm. #yosoyolimpia #rugeleon https://t.co/0RDm0HrMDI,19,7,2018,196452,26,0.01
1850,¡Olimpista! ¡Sacá tu camisa y tu bandera! ¡Hoy juega el más popular! Hoy es tarde de Súper Clásico en el nacional 4:00 pm. #RugeLeón #YoSoyOlimpia https://t.co/o6DkpXmD14,84,37,2018,196452,121,0.06
1851,"¡Final! Olimpia 0 - Motagua 0 en reservas.
#RugeLeón #YoSoyOlimpia",22,12,2018,196452,34,0.02
1852,https://t.co/rU2OMdNlN4,10,1,2018,196452,11,0.01
1853,80 minutos y el empate a cero se agranda en el marcador. #RugeLeon #YoSoyOlimpia,6,0,2018,196452,6,0.0
1854,A los 15 continua el empate a cero entre Olimpia y Motagua,14,0,2018,196452,14,0.01
1855,Arranca el segundo tiempo en el Birichiche,8,1,2018,196452,9,0.0
1856,¡¡Final del primer tiempo!!! Olimpia 0 Motagua 0 en reservas,8,2,2018,196452,10,0.01
1857,https://t.co/O8rwOYNbA4,24,11,2018,196452,35,0.02
1858,¡Casiiiiii!!!!! Olimpia cerca a los 5 minutos,17,3,2018,196452,20,0.01
1859,"Arranca en el Birichiche!!! Clásico en reservas Olimpia-Motagua.
Vamos Olimpia!!! https://t.co/XJSpmYDhYH",27,6,2018,196452,33,0.02
1860,¡Olimpista! Te invitamos a vivir el clásico con responsabilidad https://t.co/LrEBtIpYEp,60,29,2018,196452,89,0.05
1861,Comunicado de seguridad Junta Directiva Club Olimpia Deportivo y Policia Nacional https://t.co/XBv6UXUzdy,81,40,2018,196452,121,0.06
1862,¡Albo! Acercáte a los puntos Tengo y comprá tu boleto en preventa.Llegá temprano para tu mayor comodidad https://t.co/xRVq6izZUq,31,12,2018,196452,43,0.02
1863,#YoSoyOlimpia #YoSoyOlimpia #YoSoyOlimpia #YoSoyOlimpia #YoSoyOlimpia #YoSoyOlimpia https://t.co/XngY1Z8sEn,97,25,2018,196452,122,0.06
1864,"Acércate a tu kiosko Tengo mas cercano y adquirí tu boleto para el clásico.
Tu entrada puede ser enviada via email o impresa al hacer tu compra en el kiosko.
Presenta tu boleto electrónico  o físico al agente Tengo en el estadio.
#RugeLeon ¡El más popular! https://t.co/zLLxU70OhJ",53,20,2018,196452,73,0.04
1865,"Rivales en la cancha,familias en las gradas.El clásico lo jugamos todos en paz. #RugeLeon #YoSoyOlimpia El más popular https://t.co/S9tjJq1299",106,39,2018,196452,145,0.07
1866,"Cerveza SalvaVida te lleva al estadio! Entrá a la página de Facebook ""Cerveza Salvavida"" y seguí la dinamica para que te vayás al clásico Olimpia-Motagua https://t.co/EIQAPFdEd2",57,23,2018,196452,80,0.04
1867,"Las reservas se preparan para el clásico del sábado a las 8:00 pm en el Birichiche.
#RugeLeon #YoSoyOlimpia https://t.co/Ubh2g2vtj8 https://t.co/UqGltdjDG5",34,11,2018,196452,45,0.02
1868,"Se viene el Super Clásico y el más popular te convoca!! 
Preventa de boletos para el partido del domingo en el Nacional https://t.co/kNmhHOWKQw",91,29,2018,196452,120,0.06
1869,Sesión de entrenamiento martes 9/10/18 Rumbo al Super Clásico #rugeleon #cdolimpia #yosoyolimpia El Mas Popular!! https://t.co/COENXHCFZ4,67,15,2018,196452,82,0.04
1870,Dia de entrenamiento https://t.co/JML7JJ0fyK,68,12,2018,196452,80,0.04
1871,"Albo 🙌
Domingo de Super Clásico!!! 
El más popular te convoca!! ⚽ Locales en todo lados!!

🕔 4:00 pm 
🏟️ - Estadio Nacional de Tegucigalpa
🦁 - #RugeLeón https://t.co/VmKtYNNDd1 https://t.co/8HGxQRx06Q",89,39,2018,196452,128,0.07
1872,"Debido al temporal que azota nuestro país y en consecuencia con el comunicado emitido por COPECO decretando alerta roja para el departamento de Choluteca,el Club Olimpia Deportivo junto a la UPNFM y la Liga Nacional han decidido SUSPENDER el partido a realizarse el dia de hoy https://t.co/aeCFXg5fs4",88,59,2018,196452,147,0.07
1873,"No hay descanso 💪 El plantel de Olimpia trabajó arduamente este día pensando en su próximo compromiso. 

🦁 | #RugeLeón 
📷 | https://t.co/gfBlmmvkpI https://t.co/c0HsLNadbi",73,17,2018,196452,90,0.05
1874,"Albo 🙌
Este sábado jugamos en el sur del pais. ✈️⚽ Locales en todo lados!!

🕔 - 6:30pm
🏟️ - Emilio Williams Agasse - Choluteca
🦁 - #RugeLeón https://t.co/XLDY0osD5M",56,20,2018,196452,76,0.04
1875,"Imágenes del partido entre Olimpia y Marathón por cortesía de @bancatlan

Vea la galería completa en: https://t.co/D2UFerMtHQ https://t.co/z9BQhQvh0m",40,8,2018,196452,48,0.02
1876,"Palabras de Dani Turcios, asistente técnico de Olimpia, en la conferencia de prensa después del partido ante Marathón. https://t.co/rsrKU4xyE3",77,17,2018,196452,94,0.05
1877,"Excelente resultado para Olimpia. Los leones se quedan con los tres puntos en el Nacional.

⚽️ | Olimpia 2-1 Marathón
🦁 | #RugeLeón https://t.co/wnJy928GTk",151,47,2018,196452,198,0.1
1878,Gooool!!! 2 a 0 Jerry Bengtson con su segundo gol #RugeLeón https://t.co/CXxgn15K3V,64,25,2018,196452,89,0.05
1879,Gooool! Jerry Bengtson iniciando el partido!!! #RugeLeón https://t.co/wWaxLVQ0qU,93,25,2018,196452,118,0.06
1880,Así salimos hoy! Adelante muchachos con todo! #RugeLeón https://t.co/b6UvQ0cIs7,42,17,2018,196452,59,0.03
1881,"Ya listos para enfrentar al Marathón en el Estadio Nacional, vamos con todo! #RugeLeón #JuegoLimpio https://t.co/NDCLsHtoOj",30,7,2018,196452,37,0.02
1882,🙏 En la memoria de ambos esta tarde portaremos un listón negro y realizaremos un minuto de silencio previo al encuentro ante Marathón. https://t.co/HnXi4wWN6Z,50,18,2018,196452,68,0.03
1883,"Este domingo Olimpia vuelve al Nacional.  💪⚽

🕔 - 4:00 pm
🏟️ - Estadio Nacional - Tegucigalpa
🎟️ - Sol: L.70 | Sombra: L.100 | Silla: L.250
🦁 - #RugeLeón https://t.co/V7RFhWDZOH",105,26,2018,196452,131,0.07
1884,Olimpia queda fuera de la Copa Presidente al caer derrotado ante Real España. https://t.co/w4qS84fc5m,50,18,2018,196452,68,0.03
1885,El Club Olimpia Deportivo comunica: https://t.co/npnTyjN2kX,73,30,2018,196452,103,0.05
1886,"¡Vamos con todo!

🦁 | #RugeLeón https://t.co/7bf3PfKau9",96,26,2018,196452,122,0.06
1887,Olimpia enfrentará esta noche al Real España en San Pedro Sula por el pase a semifinales de la Copa Presidente | 💪 ¡Vamos con todo! #RugeLeón https://t.co/79nyANLaMO,66,19,2018,196452,85,0.04
1888,"Mañana en el Morazán de San Pedro Sula por la Copa Presidente: Real España vs Olimpia.

🦁 | #RugeLeón https://t.co/LryE8hTpgc",129,36,2018,196452,165,0.08
1889,"Repasemos las mejores imágenes del partido entre Platense y Olimpia del día de ayer. 

Vea la galería completa en  👉https://t.co/VnktKRCX1i https://t.co/0KotOyGv5c",43,8,2018,196452,51,0.03
1890,"Finaliza con empate el partido en Puerto Cortés. Los leones consiguen un punto de visita.

⚽️ | Platense 0-0 Olimpia
🦁 | #RugeLeón https://t.co/DiqvKhqPFp",61,13,2018,196452,74,0.04
1891,"La alineación inicial para enfrentar al Platense es E. Menjivar, E. Guity, D. Castillo, K. Alvarez, E. Espindola, J. Paz, G. Mejia, D. Flores, Canales, C. Costly y J. Bengtson #RugeLeón https://t.co/yh2982bV5v",50,10,2018,196452,60,0.03
1892,"¡Esta tarde vamos con todo! 💪

⚽ - Platense vs Olimpia
🕔 - 4:00 pm
🏟️ - Estadio Excélsior
🦁 - #RugeLeón https://t.co/B29RCRj3fI",71,22,2018,196452,93,0.05
1893,"La UNCAF este año 2018 realizará su tercer Campeonato de campeones de clubes femeninos, en el que Olimpia estará participando del 24 al 29 de septiembre.

| https://t.co/saRcCwezyY",56,13,2018,196452,69,0.04
1894,"El equipo femenil viajó hoy viernes vía terrestre a la competencia de UNCAF en Panamá. Ayer el Banco Atlántida les entregó los uniformes que lucirán en el torneo. La participación es gracias al apoyo de FENAFUTH, Fuerza Naval, @bancatlan y @cdolimpia Les deseamos éxitos #RugeLeón https://t.co/Y316ca2P0y",151,33,2018,196452,184,0.09
1895,"Los leones vuelven a la actividad del torneo local. Este domingo visitan a Platense en Puerto Cortés. 💪⚽

🕔 - 4:00 pm
🏟️ - Estadio Excélsior
🦁 - #RugeLeón https://t.co/PjOyvWDcRM",70,21,2018,196452,91,0.05
1896,Olimpia empató 1-1 ante DC United en partido amistoso jugado en Washington 💪 https://t.co/cCvHsSqM1Y,157,39,2018,196452,196,0.1
1897,Finalizó el primer tiempo en Washington. Olimpia empata 1-1 con DC United con gol de Diego Reyes.,87,13,2018,196452,100,0.05
1898,"Ya entrenamos en Washington. Mañana enfrentamos al DC United en partido amistoso en el Audi Field (8:00 pm hora de Washington).

🦁 | #RugeLeón https://t.co/P7gma9tND4",114,25,2018,196452,139,0.07
1899,Ya estamos en Washington para enfrentar éste miércoles en partido amistoso al @dcunited | #RugeLeón https://t.co/1oUMHQdIi8,101,15,2018,196452,116,0.06
1900,"Olimpia enfrentará este miércoles al DC United en partido amistoso en el Audi Field (8:00 pm hora de Washington).

🦁 | #RugeLeón https://t.co/7IXMaxxQdU",125,39,2018,196452,164,0.08
1901,"Finaliza el partido en New Orleans con triunfo 2-1 a favor de los leones. Goles de Carlo Costly y Paul Suazo. 💪

 🦁 #RugeLeón",133,39,2018,196452,172,0.09
1902,"Ya listos. En unos minutos Olimpia jugará la Copa Independencia ante el Club Nola en Nueva Orleans. 💪

🦁 #RugeLeón https://t.co/FimdOhTh6C",100,12,2018,196452,112,0.06
1903,Entrenamiento en New Orleans 💪#RugeLeón https://t.co/MM6zv4UJRs,103,24,2018,196452,127,0.06
1904,Repasemos las mejores imágenes del partido entre Olimpia y Vida del día de ayer. Vea la galería completa en  👉 https://t.co/DSoGProAi4 https://t.co/mlJtpUIoJ8,35,7,2018,196452,42,0.02
1905,"Los leones empatan de local en San Pedro Sula.

⚽️ | Olimpia 0-0 Vida 
🦁 | #RugeLeón https://t.co/zfnIzgxylc",47,17,2018,196452,64,0.03
1906,"Esta noche ¡vamos con todo!  💪⚽

🕔 - 7:00 pm
🏟️ - Estadio Morazán - San Pedro Sula
🎟️ - Sol: L.70 | Preferencia: L.120 | Silla: L.250
🦁 - #RugeLeón https://t.co/hLayrL0pzf",63,14,2018,196452,77,0.04
1907,"Tuvimos el placer de compartir con el equipo del programa ""Fuera de Juego"" de ESPN y otorgarles un obsequio de nuestra parte. https://t.co/aP2LTtgzFA",389,138,2018,196452,527,0.27
1908,"Mañana ante Vida de locales en San Pedro Sula 💪⚽

🕔 - 7:00 pm
🏟️ - Estadio Morazán
🦁 - #RugeLeón https://t.co/ePljTISg2W",88,22,2018,196452,110,0.06
1909,"📷 | Honduras Progreso 1-1 Olimpia [Apertura 2018]

Vea la galería completa en  👉 https://t.co/goSxG5JX1k https://t.co/VuzrMlTDnY",47,5,2018,196452,52,0.03
1910,"Este miércoles ¡los leones de local en San Pedro Sula! 💪⚽

🕔 - 7:00 pm
🏟️ - Estadio Morazán
🦁 - #RugeLeón https://t.co/x6vD1oEPWm",145,52,2018,196452,197,0.1
1911,"Celebrando la Independencia 🇭🇳️ y despidiendo a una leyenda, Olimpia jugará la Copa Independencia este domingo 16 de septiembre en Nueva Orleans. 💪

🦁 #RugeLeón https://t.co/k5EXsZpMRN",94,31,2018,196452,125,0.06
1912,"Los leones empatan en El Progreso. 

⚽️ | Honduras Progreso 1-1 Olimpia 
🦁 | #RugeLeón https://t.co/a1VrrXkA5N",78,18,2018,196452,96,0.05
1913,¡Vamos con todo! 💪#RugeLeón https://t.co/1o2r1blsDN,104,24,2018,196452,128,0.07
1914,"¡Esta noche vamos con todo! 💪⚽

🕔 - 7:15 pm
🏟️ - Estadio Humberto Micheletti - El Progreso
🦁 - #RugeLeón https://t.co/4OViOfRY7E",46,11,2018,196452,57,0.03
1915,"Mañana los leones visitan El Progreso 💪⚽

🕔 - 7:15 pm
🏟️ - Estadio Humberto Micheletti
🦁 - #RugeLeón https://t.co/u7mDIqGHsG",98,16,2018,196452,114,0.06
1916,El equipo aprovecha su visita a Roatán para pasar unos momentos de esparcimiento antes de viajar a San Pedro Sula para prepararse para el encuentro contra Honduras Progreso de este sábado. 💪🌴🦁 https://t.co/toMS1KNuAf,124,23,2018,196452,147,0.07
1917,Olimpia derrotó 1-0 al Galaxy FC de Roatán y avanza a cuartos de final de la Copa Presidente. | #RugeLeón https://t.co/75QU7KceyV,168,46,2018,196452,214,0.11
1918,"Olimpia enfrentará esta tarde al Galaxy FC en Roatán, por los octavos de final de la Copa Presidente a partir de las 3:00pm | 💪 ¡Vamos con todo! #RugeLeón https://t.co/o9Gmu1dDyc",52,12,2018,196452,64,0.03
1919,"📷 | Olimpia 2-1 Real España [Apertura 2018]

Vea la galería completa en  👉 https://t.co/VHITQQfIVM https://t.co/PG4UZ0zrll",73,7,2018,196452,80,0.04
1920,"Excelente resultado para los leones jugando en casa. 💪

⚽️ | Olimpia 2-1 Real España 
🦁 | #RugeLeón https://t.co/kgeds8230B",250,76,2018,196452,326,0.17
1921,"¡Vivamos un partido en paz! 💪#RugeLeón
 
🏳 #JuegoLimpio #Concacaf #Honduras https://t.co/CUVAtSUOZN",62,22,2018,196452,84,0.04
1922,"Atención: Hoy NO será permitido el ingreso al Estadio de la barra organizada del Real España.

🏳 #JuegoLimpio #Concacaf #Honduras https://t.co/3jwxMczghh",72,25,2018,196452,97,0.05
1923,"¡Mañana vamos con todo! 💪⚽
 
🕔 - 4:00 pm
🏟️ - Estadio Nacional - Tegucigalpa
🦁 - #RugeLeón https://t.co/apyGqlQCor",88,32,2018,196452,120,0.06
1924,"Congresillo entre Olimpia y Real España en preparativos para el partido de mañana. 👍#RugeLeón 

🏳 #JuegoLimpio #Concacaf #Honduras https://t.co/QQ5aff9MSm",74,16,2018,196452,90,0.05
1925,"Este domingo los leones vuelven al Nacional 💪⚽
 
🕔 - 4:00 pm
🏟️ - Estadio Nacional - Tegucigalpa
🎟️ - Sol: L.60 | Sombra: L.100 | Silla: L.200
(Niños menores de 12 años acompañados de un adulto entran gratis en Sol)
🦁 - #RugeLeón https://t.co/M9cvkPMJAp",77,25,2018,196452,102,0.05
1926,"COMUNICADO: La Junta Directiva General del Club Olimpia Deportivo tiene a bien hacer del conocimiento de la afición deportiva en general y en particular a la seguidora de nuestra institución, lo siguiente: https://t.co/LUtMXcvnd1",197,58,2018,196452,255,0.13
1927,"📷 | Juticalpa 2-2 Olimpia [Apertura 2018]

Vea la galería completa en  👉 https://t.co/eA79QceC1Z https://t.co/lA5JlYlnmy",37,7,2018,196452,44,0.02
1928,Elevamos nuestras oraciones a Dios por el eterno descanso del alma del Licenciado Miguel Angel Mejía Espinoza (QDDG) y que dé el bálsamo del consuelo a la familia doliente. https://t.co/CgPsg30HDB,47,16,2018,196452,63,0.03
1929,"Los leones rescatan el partido en los últimos minutos y se quedan con el empate jugando de visita.

⚽️ | Juticalpa 2-2 Olimpia
🦁 | #RugeLeón https://t.co/lHUbLHxczw",146,38,2018,196452,184,0.09
1930,Todo listo en Juticalpa 💪¡Vamos con todo! #RugeLeón https://t.co/OP9NaompLy,43,9,2018,196452,52,0.03
1931,"Esta tarde ¡vamos con todo! 💪

⚽ - Juticalpa vs Olimpia
🕔 - 3:00 pm
🏟️ - Estadio Juan Ramón Brevé - Juticalpa
🦁 - #RugeLeón https://t.co/cuGlxFjNmG",74,29,2018,196452,103,0.05
1932,"Este domingo los leones visitan Juticalpa por la sexta jornada del Apertura 2018 💪 

⚽ - Juticalpa vs Olimpia
🗓️ - Domingo 26 de agosto
🕔 - 2:00 pm
🏟️ - Estadio Juan Ramón Brevé - Juticalpa
🦁 - #RugeLeón https://t.co/hQEjD6Z5go",64,25,2018,196452,89,0.05
1933,Olimpia derrotó 2-0 al Altamira FC de El Paraíso y avanza a la siguiente ronda de la Copa Presidente. | #RugeLeón https://t.co/JEGDs565RM,96,19,2018,196452,115,0.06
1934,"Jugadores y Cuerpo Técnico de Olimpia realizaron el día de hoy una visita a la Casa de descanso Don Dante Casorelli de El Paraiso, previo al encuentro ante el Altamira FC por la Copa Presidente.

🦁 | #RugeLeón https://t.co/aiSoNaV5A9",110,27,2018,196452,137,0.07
1935,"El Club Olimpia Deportivo felicita a nuestro Presidente, José Rafael Ferrari, por el homenaje que la Asociación Hondureña al Rescate de los Valores y la Moral (Valmoral) le otorgó por su sensibilidad humana en favor de los demás, destacándolo como Personaje del año Valmoral 2018. https://t.co/zMPRSUVe5V",214,53,2018,196452,267,0.14
1936,"Olimpia enfrentará esta tarde al equipo Altamira FC en El Paraíso, por la Copa Presidente a partir de las 2:00pm | 💪 ¡Vamos con todo! #RugeLeón #CopaPresidente #Honduras https://t.co/NJ1ByMfQBZ",42,13,2018,196452,55,0.03
1937,"📷 | Motagua 0-1 Olimpia [Apertura 2018]

Vea la galería completa en  👉 https://t.co/eA79QceC1Z https://t.co/TnrivAkKXr",71,8,2018,196452,79,0.04
1938,"Los leones se quedan con el clásico y con los tres puntos en el Nacional 💪

⚽️ | Motagua 0-1 Olimpia
🦁 | #RugeLeón https://t.co/N2u5iVHqQD",285,117,2018,196452,402,0.2
1939,"Esta tarde ¡vamos con todo! 💪 

⚽ - Motagua vs Olimpia
🕔 - 4:00 pm
🏟️ - Estadio Nacional - Tegucigalpa
🦁 - #RugeLeón https://t.co/Ao5BjTHZR6",88,33,2018,196452,121,0.06
1940,"Este domingo los leones se juegan el derbi capitalino 💪 por la quinta fecha del Apertura.

⚽ - Motagua vs Olimpia
🗓️ - Domingo 19 de agosto
🕔 - 4:00 pm
🏟️ - Estadio Nacional - Tegucigalpa
🦁 - #RugeLeón https://t.co/NGFtiOjaw2",81,31,2018,196452,112,0.06
1941,"Olimpia U-13 cayó derrotado 2-1 ante el San Juan Jabloteh de Trinidad &amp; Tobago en el cierre de la Fase de Grupos de la Liga de Campeones de Concacaf.

Gracias chicos por su esfuerzo. Todas las experiencias son oportunidades de aprendizaje. #RugeLeón

#OlimpiaU13 #SCCLU13 https://t.co/51khgKNNKb",18,0,2018,196452,18,0.01
1942,"En su último partido de la Fase de Grupos, Olimpia U-13 enfrentará dentro de unos minutos al San Juan Jabloteh de Trinidad &amp; Tobago.

🖥️ - Transmisión en vivo por: https://t.co/iLPYYwdOlI

💪 #RugeLeón #OlimpiaU13 #SCCLU13 https://t.co/601WktsVbi",22,6,2018,196452,28,0.01
1943,"📷 | Olimpia 1-0 UPNFM [Apertura 2018]

Vea la galería completa en  👉 https://t.co/3SS0AnmQjQ https://t.co/1j4M4IIZaU",64,15,2018,196452,79,0.04
1944,"Esta es la Tabla de Posiciones después de la cuarta jornada del Torneo Apertura 2018.

⚽ | #RugeLeón https://t.co/UlwcbWG8O0",58,16,2018,196452,74,0.04
1945,"Olimpia U-13 cayó derrotado 3-0 ante el Águilas de Uagro de México por la Liga de Campeones de Concacaf.

 #OlimpiaU13 #SCCLU13 https://t.co/KTnCz0Gg3W",9,6,2018,196452,15,0.01
1946,"Olimpia U-13 enfrentará dentro de unos minutos al Aguilas de Uagro (MEX) por la Liga de Campeones de Concacaf.

🖥️ - Transmisión en vivo por: https://t.co/xeUeGbhm68
 
💪 #RugeLeón #OlimpiaU13 #SCCLU13 https://t.co/usbIHFIyVb",24,12,2018,196452,36,0.02
1947,"Triunfo para los leones en el Nacional 💪

⚽️ | Olimpia 1-0 UPNFM
🦁 | #RugeLeón https://t.co/1lU344QNoi",187,59,2018,196452,246,0.13
1948,"Olimpia U-13 cayó derrotado 3-0 ante el Toronto FC de Canadá en el arranque de la Liga de Campeones de Concacaf. 

💪 #RugeLeón #OlimpiaU13 #SCCLU13 https://t.co/BktJnWOHzM",16,8,2018,196452,24,0.01
1949,"En unos minutos nuestra representación U-13 enfrentará al Toronto FC de Canadá en el arranque de la Liga de Campeones de Concacaf. 

🖥️ - Transmisión en vivo por: https://t.co/1Bh7LbiVYz

💪 #RugeLeón #OlimpiaU13 #SCCLU13 https://t.co/qciT9COx18",35,10,2018,196452,45,0.02
1950,Te esperamos esta noche en el Nacional. 💪🦁 #RugeLeón https://t.co/3JR0dXkA7u,93,21,2018,196452,114,0.06
1951,"Ayer lunes viajó nuestra representación a Toluca, México. Ya se encuentran listos para enfrentar mañana al Toronto FC (Canadá) por la Liga de Campeones Sub-13 Concacaf Scotiabank. #RugeLeón https://t.co/vNf1OMU7x2",72,12,2018,196457,84,0.04
1952,"Mañana los leones vuelven al Nacional 💪⚽
 
🕔 - 7:00 pm
🏟️ - Estadio Nacional - Tegucigalpa
🎟️ - Sol: L.60 | Sombra: L.100 | Silla: L.200
🦁 - #RugeLeón https://t.co/fZhM9ARwA0",82,31,2018,196457,113,0.06
1953,"Mañana arriba al país el defensor central, Esteban Espíndola, para unirse al club y practicarse los exámenes físicos correspondientes.

#RugeLeón",138,43,2018,196457,181,0.09
1954,"📷 | Marathón 1-1 Olimpia [Apertura 2018]

Vea la galería completa en  👉 https://t.co/hv3OlaGkM2 https://t.co/8mf2pKdJwK",65,13,2018,196457,78,0.04
1955,"Les compartimos la Tabla de Posiciones después de la tercera jornada del Torneo Apertura 2018.

⚽ | #RugeLeón https://t.co/pNnVs9XIjp",91,30,2018,196457,121,0.06
1956,"Finaliza con empate el encuentro en San Pedro Sula.

⚽️ | Marathón 1-1 Olimpia
🦁 | #RugeLeón https://t.co/sEnJezdoSl",98,28,2018,196457,126,0.06
1957,"Esta tarde ¡vamos con todo! 💪 

⚽ - Marathón vs Olimpia
🕔 - 3:00 pm
🏟️ - Estadio Yankel Rosenthal - San Pedo Sula
🦁 - #RugeLeón https://t.co/artFVApTHr",71,30,2018,196457,101,0.05
1958,¡Mañana juegan los leones! 💪 Visitan San Pedro Sula por la tercera fecha del Apertura. https://t.co/gXCFZPAslF,107,28,2018,196457,135,0.07
1959,"Con el respaldo de Banco Atlántida (@bancatlan), las FBO sub 13 viajan el próximo lunes hacia Toluca, México, para representar a Honduras en la Liga de Campeones Sub-13 Concacaf Scotiabank.

💪 #RugeLeón [ https://t.co/StGxNF6dk7 ] https://t.co/pCTxi88WqX",73,17,2018,196457,90,0.05
1960,"Las Fuerzas Básicas Olimpistas (Sub-13) representarán a #Honduras en la Liga de Campeones Sub-13 Concacaf Scotiabank, que se realizará del 15 al 22 de agosto en Toluca, México.

💪 #RugeLeón [ https://t.co/gdZiFdqEic ]",73,18,2018,196457,91,0.05
1961,"Acuerdo de duelo: Club Olimpia lamenta la muerte trágica del profesional del derecho y activo dirigente deportivo Abogado Rubén Dario Mateo Galán (QDDG).

[ https://t.co/rHUhpNZZO0 ] https://t.co/dUHUDtVIZ9",40,14,2018,196457,54,0.03
1962,"Les compartimos la Tabla de Posiciones después de la segunda jornada del Torneo Apertura 2018.
 
⚽ | #RugeLeón https://t.co/RUx2VihZ7e",101,34,2018,196457,135,0.07
1963,"Los leones consiguieron la victoria en el Nacional 💪🏼 y se quedan con los tres puntos en la segunda fecha del Apertura 2018.

⚽️ | Olimpia 2-1 Platense
🦁 | #RugeLeón https://t.co/9zvbRt9JhX",227,68,2018,196457,295,0.15
1964,"Mañana los leones vuelven al Nacional 💪⚽
 
🎟️ - Sol: L.60 | Sombra: L.100 | Silla: L.200
🦁 - #RugeLeón https://t.co/RnP16ZLPl0",110,37,2018,196457,147,0.07
1965,"¡Los leones vuelven al Nacional! 💪⚽
Este domingo Olimpia recibe en casa al Platense por la segunda fecha del Apertura.

🕔 - 4:00 pm
🗓️ - Domingo 05 de agosto
🏟️ - Estadio Nacional - Tegucigalpa
🦁 - #RugeLeón https://t.co/VYzX8EpRVw",134,48,2018,196457,182,0.09
1966,"📷 | Real de Minas 1-3 Olimpia [Apertura 2018]

Vea la galería completa en  👉 https://t.co/NWSY4jeg5h https://t.co/h8oZhikftj",75,16,2018,196457,91,0.05
1967,"Al cumplirse la primera jornada, Olimpia arranca el Torneo Apertura 2018 en la primera posición. 

⚽ | #RugeLeón https://t.co/stCuNaDIZo",62,29,2018,196457,91,0.05
1968,"Arranque con triunfo para los leones 💪🏼. Tres puntos en Siguatepeque en el inicio del Apertura 2018.

⚽️ | Real de Minas 1-3 Olimpia
🦁 | #RugeLeón https://t.co/zZkakJBZMY",243,87,2018,196457,330,0.17
1969,Desayuno en Comayagua 🍊🍉🍞 ...estamos listos para nuestro primer compromiso esta tarde ante Real de Minas en Siguatepeque 💪🏼 #RugeLeón https://t.co/O29Gv536Wy,97,19,2018,196457,116,0.06
1970,"Hoy arrancamos, ¡este será nuestro torneo!  💪

⚽ - Real de Minas vs Olimpia
🕔 - 5:00 pm
🏟️ - Estadio Roberto Martínez Ávila - Siguatepeque
🦁 - #RugeLeón https://t.co/PGNXTnvSTW",131,49,2018,196457,180,0.09
1971,"Anunciamos la contratación de Pier Miqueas Barrios, defensa central argentino, que se estaría incorporando al equipo una vez pase las pruebas médicas respectivas que se le practicarán una vez arribe al país. https://t.co/hTGWGP4itj",163,70,2018,196457,233,0.12
1972,"¡Los leones vuelven a la acción! 💪⚽

Este sábado arrancamos el Torneo Apertura 2018 ante el recién ascendido Real de Minas.
🗓️ | Sábado 28 de julio
🕔 | 5:00 pm
🏟️ | Estadio Roberto Martínez Ávila - Siguatepeque
🦁 | #RugeLeón https://t.co/RT8IHRPjNe",112,48,2018,196457,160,0.08
1973,📷 | El Carmen 0-8 Olimpia [Copa Presidente] https://t.co/vlnn1DvE8w,146,26,2018,196457,172,0.09
1974,Olimpia derrotó 8-0 a El Carmen de Jesús de Otoro y avanza a la siguiente ronda de la Copa Presidente. | #RugeLeón https://t.co/Bs2w8gmIq6,167,85,2018,196457,252,0.13
1975,Duelo por la Copa Presidente ante El Carmen de Jesús de Otoro. Nos acompaña la afición en un bonito ambiente. #RugeLeón https://t.co/9NA2s0Rmma,65,9,2018,196457,74,0.04
1976,"Visita de solidaridad al Centro de Maternidad en Jesús de Otoro, Intibuca, previo al partido ante El Carmen por la Copa Presidente. #RugeLeón https://t.co/H3PrTOuNIU",165,43,2018,196457,208,0.11
1977,"Olimpia enfrentará mañana domingo al equipo El Carmen en Jesús de Otoro - Intibucá, por la Copa Presidente a partir de las 2:00pm | 💪 ¡Vamos con todo! #RugeLeón https://t.co/K2Zg4OqmDW",70,26,2018,196457,96,0.05
1978,"Olimpia cayó 3-2 esta tarde ante el Villanueva FC en partido amistoso jugado en el Estadio José Adrián Cruz de Villanueva.

Los goles blancos fueron de Rony Martínez y Carlos Will Mejía. | #RugeLeón https://t.co/mjhP5KAW6V",52,18,2018,196457,70,0.04
1979,Al finalizar el primer tiempo Olimpia empata sin goles en el amistoso ante Villanueva FC. #RugeLeón https://t.co/PBPX73EnPJ,34,7,2018,196457,41,0.02
1980,"Esta tarde enfrentamos al Villanueva FC a partir de las 3:00 pm en partido amistoso.

⚽ Entrada general: L.100
👉 Venta de boletos y entrada del público a partir de las 12:00m en el Estadio José Adrián Cruz de Villanueva.
🦁 #RugeLeón https://t.co/CqQvEikjLO",65,17,2018,196457,82,0.04
1981,"Olimpia derrotó 2-0 a la Liga Deportiva Alajuelense en partido amistoso jugando esta noche en el Estadio Morazán de San Pedro Sula.

⚽ | Goles: Jerry Bengtson y Kevin Álvarez
🦁 | #RugeLeón https://t.co/Us1emQXJT4",262,88,2018,196457,350,0.18
1982,"En el medio tiempo del amistoso contra Liga Deportiva Alajuelense, ganamos 1-0 con gol de Jerry Bengtson. #RugeLeón",79,12,2018,196457,91,0.05
1983,"Continuamos con nuestra preparación de cara al nuevo torneo. Mañana sábado enfrentamos al Villanueva FC a las 3:00 pm.

⚽ Entrada general: L.100
👉 Venta de boletos y entrada del público a partir de las 12:00m en el Estadio José Adrián Cruz de Villanueva. https://t.co/umG0rxYLk4",26,8,2018,196457,34,0.02
1984,"Olimpia derrotó 3-0 esta tarde al Honduras Progreso en partido amistoso jugado en el Estadio Roberto Martínez de  la ciudad de Siguatepeque.

Los goles fueron de Germán Mejía, Diego Reyes y Rony Martínez. | #RugeLeón https://t.co/c1LFHopFqZ",107,26,2018,196457,133,0.07
1985,"Damos la bienvenida a Leandro Motta dos Santos, mediocampista brasileño, quien hoy ha firmado contrato con el club | #OlimpiaHonduras #RugeLeón https://t.co/84JP5rDaNB",153,60,2018,196457,213,0.11
1986,"Presentaremos a nuestro equipo que disputará el nuevo torneo enfrentando al Alajuela de Costa Rica 💪
🗓️ | Viernes 13 de julio
🕖 | 7:00 pm
🏟️ | Estadio Morazán - San Pedro Sula
🎟️ | Silla L.200 ** Preferencia L.120 ** Sol L.60 https://t.co/yuccwUZ97A",67,29,2018,196457,96,0.05
1987,"Leandro Motta dos Santos, mediocampista brasileño, llega a Tegucigalpa para la revisión médica para unirse al club. #OlimpiaHonduras https://t.co/7zyh91YzRQ",106,52,2018,196457,158,0.08
1988,"¡El clásico centroamericano para presentar nuestro equipo que disputará el nuevo torneo! 💪

⚽ | Olimpia vs Liga Deportiva Alajuelense
🗓️ | Viernes 13 de julio
🕖 | 7:00 pm
🏟️ | Estadio Morazán - San Pedro Sula
🎟️ | Silla L.200 ** Preferencia L.150 ** Sol L.60 https://t.co/up95sVCv8D",206,84,2018,196457,290,0.15
1989,"Olimpia derrotó 3-0 esta tarde al Comayagua FC en partido amistoso.

Los goles fueron de Kevin Álvarez (42’), Bryan Moya (65’) y 
Marcelo Canales (82’) | #RugeLeón https://t.co/I8b9ISjqnW",115,24,2018,196457,139,0.07
1990,Finalizó el encuentro amistoso ante la UPNFM con un marcador final de 3-2 a favor de los Lobos. | #RugeLeón,25,7,2018,196457,32,0.02
1991,En estos momentos se juega el partido amistoso de preparación entre Olimpia y los Lobos de la UPNFM. | #RugeLeón https://t.co/RmqfdonV9M,53,14,2018,196457,67,0.03
1992,"Llegamos con mucha ilusión a ganar experiencia. Nos vamos contentos por llegar a ubicarnos dentro de los mejores 16 del Torneo. ¡Seguiremos preparándonos! 💪👍 #DonostiCup
 
¡Gracias a los niños de la FBO U-12 y sus padres por representarnos con garra! | #RugeLeón 🇭🇳️ https://t.co/jO4eZDrQk0",129,30,2018,196457,159,0.08
1993,"Las FBO (U-12) cayeron en octavos de final en el Donosti Cup en España ante el Sant Gabriel CE de Barcelona. ¡Lo hicieron bien muchachos!, ¡bravo! 💪🏼 #RugeLeón https://t.co/coXuVocVLt",56,21,2018,196457,77,0.04
1994,Las FBO (U-12) avanzan a octavos de final en el Donosti Cup en España. Recién derrotaron 4-3 al Lengokoak SD A del País Vasco. Mañana enfrentarán al Sant Gabriel CE de Barcelona.  💪🏼 #RugeLeón https://t.co/ShKTaGeyyU,84,33,2018,196457,117,0.06
1995,Las FBO (U-12) siguen avanzando en el Donosti Cup en España. Está mañana derrotaron 3-2 al San Diego FC de Estados Unidos. Dentro de unas horas se enfrentarán al Lengokoak SD A (reservas de la Real Sociedad). 💪🏼 #RugeLeón https://t.co/3mq82M1yqN,71,26,2018,196457,97,0.05
1996,"Las FBO (U-12) lograron superar la fase de grupos en el Donosti Cup en España de manera invicta. El día de hoy derrotaron al Danena KE A (2-1) y Urola KE (5-1), ambos equipos del País Vasco. | #RugeLeón https://t.co/7B5j6h07ar",67,24,2018,196457,91,0.05
1997,"Hoy nos enfocamos en trabajos de fuerza, potencia y velocidad 💪. | #RugeLeón #LeonesEnPretemporada https://t.co/GuOvmrkZv9",127,31,2018,196457,158,0.08
1998,Las FBO siguen con buen paso en el Donosti Cup en España. El día de hoy derrotaron 6-2 al JP Academy A de Japón. | #RugeLeón https://t.co/IlnuB3Wqjo,84,34,2018,196457,118,0.06
1999,Buen inicio para FBO en el Donosti Cup en España. En su primer partido derrotaron dos goles a uno al Atletic Sant Just FC B de Barcelona. | #RugeLeón https://t.co/HqwRzjL9xC,77,23,2018,196457,100,0.05
2000,Iniciamos temprano encomendándonos al Señor. Primer día de pretemporada en Siguatepeque aprovechando su clima y altura. | #RugeLeón https://t.co/cuEWT0t7cK,108,31,2018,196457,139,0.07
2001,"Como parte de la Asamblea de la Liga Nacional que acaba de iniciar, se otorgó reconocimiento a Salomón Galindo por su trayectoria como directivo de Liga Nacional y del Club  Olimpia Deportivo. En hora buena por Salomón, ¡Felicidades! https://t.co/PH1RizGuXD",62,15,2018,196457,77,0.04
2002,"Las Fuerzas Básicas Olimpistas Sub-12 representarán a Honduras en el Torneo Internacional Donosti Cup 2018 que se realizará en España en el mes de julio.

Hoy recibieron el patrocinio de la equipación y uniforme que portarán por parte de Banco Atlántida. 💪 #RugeLeón https://t.co/5oezIi2UF8",98,35,2018,196457,133,0.07
2003,"Continúan los trabajos del plantel, ahora con la incorporación de John Paul Suazo a la pretemporada del club. | #RugeLeón #LeonesEnPretemporada https://t.co/EUjDKDlOK3",93,37,2018,196457,130,0.07
2004,"Olimpia ganó 2-1 y es Bicampeón 🏆. Con éste, logra su 6to título en la Liga Femenina. 💪🏼🎉 https://t.co/YrJrQAHEvJ",133,50,2018,196457,183,0.09
2005,"Esta tarde Olimpia realizó dos partidos de práctica ante el equipo Alcón Junior de la Liga Mayor. 

En ambos encuentros los leones ganaron por dos goles a cero. En el primero los goles fueron de Costly y Lacayo; y en el segundo, de Canales y Róchez. 

#RugeLeón https://t.co/ffIPypqTID",65,22,2018,196457,87,0.04
2006,"Este domingo 24 de Junio a las 11:00am en el Estadio Nacional, Olimpia disputará la gran final del club femenino vs Motagua. 

Entrada a la localidad de silla L20 https://t.co/MgdioFuTWA",97,32,2018,196457,129,0.07
2007,El día inicia con charla del profesor Espinoza. 💪 ¡vamos con todo! | #RugeLeón #LeonesEnPretemporada https://t.co/0Nigv7ElrC,87,19,2018,196457,106,0.05
2008,"Seguimos trabajando duro, pero con entusiasmo. 💪 ¡Este torneo será nuestro! | #RugeLeón #LeonesEnPretemporada https://t.co/4Ct22B7OD8",143,35,2018,196457,178,0.09
2009,"En pretemporada, preparando con determinación el nuevo torneo. 💪 ¡vamos con todo! | #RugeLeón 🦁 https://t.co/652kTLI5lt",147,37,2018,196457,184,0.09
2010,"Hablar de Olimpia es hablar de grandeza, historia, títulos... entre muchas cosas más. 

👉 https://t.co/pqbQrOT3kN 

¡Felices 106 años de historia! 💪🎉 | #RugeLeón",178,56,2018,196457,234,0.12
2011,"El más grande, el más popular, el más querido, ...el más exitoso en la historia del fútbol de Honduras. 

¡106 años de historia! 🎉💪 | #RugeLeón https://t.co/0qfWT9J6Gk",595,300,2018,196457,895,0.46
2012,"En partido amistoso internacional, Olimpia cayó derrotado 3-1 ante el Alianza de El Salvador en Washington, Estados Unidos. https://t.co/iSQL4QVIyG",91,52,2018,196457,143,0.07
2013,Ya listos en Washington para enfrentar nuevamente al Alianza de El Salvador. #RugeLeon 💪🏼 https://t.co/YcRDHGfAuv,79,23,2018,196457,102,0.05
2014,"En partido amistoso internacional, Olimpia se impuso 4-2 ante el Alianza de El Salvador en New York, Estados Unidos. Los goles fueron de Carlo Costly, Rony Martínez y Elmer Guity. #RugeLeón https://t.co/dY9QSeb8DS",140,60,2018,196457,200,0.1
2015,"Este ranking se realiza en base al PORCENTAJE DE CAMPEONIZACIÓN (PC), el cual establece la relación entre el número de títulos de liga obtenidos sobre el número de torneos de liga disputados. El Dr. Elmer López Lutz nos lo explica aquí 👉 https://t.co/do1j9DlyMu",83,31,2018,196457,114,0.06
2016,"Damos la bienvenida a Jerry Bengtson Bodden, quien ha firmado contrato con nuestra institución | 💪 #RugeLeón https://t.co/O7dbnw9GFl",507,192,2018,196457,699,0.36
2017,El jugador Hendry Thomas solicitó un permiso especial al Presidente del club y a nuestro entrenador para hacer la pretemporada con el equipo. Dicho permiso fue autorizado.,154,41,2018,196457,195,0.1
2018,Felicidades a nuestra FBO SUB-13 🎉 Ahora son el Campeón Nacional 🏆 y representarán al país 🇭🇳 en la Liga de Campeones de la Concacaf en agosto próximo 💪🏼 | #RugeLeón https://t.co/tgTeb6uLep,159,37,2018,196457,196,0.1
2019,"📢 Atención olimpistas en Estados Unidos:

¡Partido amistoso internacional ante el Alianza de El Salvador! 

🗓️ | Domingo 10 de junio de 2018
🕤 | 4:00 pm
🏟️ | RFK Stadium
📍 | Washington DC
⚽ | #RugeLeón https://t.co/qXUGg7mN0T",104,50,2018,196457,154,0.08
2020,"📢 Atención olimpistas en Estados Unidos:

¡Partido amistoso internacional ante el Alianza de El Salvador! 

🗓️ | Viernes 8 de junio de 2018
🕤 | 9:30 pm
🏟️ | Mitchel Field Athletic Complex
📍 | Long Island - Nueva York
⚽ | #RugeLeón https://t.co/b6I0lmYY2t",71,40,2018,196457,111,0.06
2021,En los próximos días el Profesor Espinoza y su cuerpo técnico estarán planificando como quedará constituido el plantel y los trabajos de la pretemporada. | #RugeLeon ⚽️,134,43,2018,196457,177,0.09
2022,Comunicamos a la afición y al público en general que hemos llegado a un acuerdo con el Profesor Nahun Espinoza para que continúe al frente del equipo en este próximo Torneo de Apertura 2018-2019. | #RugeLeon ⚽️,356,135,2018,196457,491,0.25
2023,"Damos la bienvenida a Junior Alberto Lacayo Rochez, quien ha firmado contrato por 3 años con nuestra institución | 💪 #RugeLeón https://t.co/6SWLQKss5b",452,182,2018,196457,634,0.32
2024,"Damos la bienvenida a John Paul Suazo Caballero, quien ha firmado contrato por 3 años con nuestra institución | 💪 #RugeLeón https://t.co/GXrR9nch6f",286,113,2018,196457,399,0.2
2025,Olimpia se queda con el Subcampeonato en el Torneo Reservas de la Liga Nacional al caer en los lanzamientos de penal ante el Vida. ⚽ Buen trabajo muchachos 💪 #RugeLeón,72,15,2018,196457,87,0.04
2026,"Esta noche se juega la Gran Final del Torneo Reservas, ¡vamos con todo! 💪 
🕖 - 6:00 pm
🏟️ - Estadio Los Ángeles - Tegucigalpa.
⚽ - #RugeLeón https://t.co/wGk7oMt20s",63,23,2018,196457,86,0.04
2027,¡Felicidades a todas las madrecitas hondureñas! ❤️❤️ https://t.co/iUGkCRPouT,177,59,2018,196457,236,0.12
2028,Este es el gol de Carlo Costly de esta tarde | #RugeLeón 🦁 | https://t.co/TT8TDH7n7X,49,7,2018,196457,56,0.03
2029,"Final del partido. Empate en el Nacional de Tegucigalpa. Nos quedamos sin final.
⚽ | Motagua 1-1 Olimpia 
🦁 | #RugeLeón https://t.co/YGcvEe7x3S",84,28,2018,196457,112,0.06
2030,"Finaliza la primera mitad del encuentro. Nos vamos al descanso arriba en el marcador.

⚽ - #RugeLeón
✌🏼 - #FairPlay https://t.co/jqVCfiDSMw",74,20,2018,196457,94,0.05
2031,"Arranca el partido en el Nacional, ¡vamos con todo! 💪 

⚽ - #RugeLeón
✌🏼 - #FairPlay https://t.co/WrynGBr0Va",31,21,2018,196457,52,0.03
2032,"Esta tarde vamos con todo a dar el paso a la final 💪 
🕖 - 4:00 pm
🏟️ - Estadio Nacional - Tegucigalpa.
⚽ - #RugeLeón
✌🏼 - #FairPlay https://t.co/MIbgkeKXp4",87,34,2018,196457,121,0.06
2033,"¿Cuál de estas estrenarás mañana?

👉 A la venta en @diunsahn y https://t.co/T0RicdE63f | #RugeLeón #SomosOlimpia https://t.co/BK8s6yFYyO",79,17,2018,196457,96,0.05
2034,📷 | Olimpia 0-0 Motagua https://t.co/TLUofgHBOZ,62,18,2018,196457,80,0.04
2035,"Final del partido. Los leones empatan en el Nacional y definirán todo en el partido del próximo domingo.
⚽ | Olimpia 0-0 Motagua
🦁 | #RugeLeón https://t.co/GaN3KsCYY7",44,17,2018,196457,61,0.03
2036,"Finaliza la primera mitad del encuentro. Seguimos con el marcado empatado.

⚽ - #RugeLeón
✌🏼 - #FairPlay https://t.co/acCOk1dL1j",21,8,2018,196457,29,0.01
2037,"Arranca el partido en el Nacional, ¡vamos con todo! 💪 

⚽ - #RugeLeón
✌🏼 - #FairPlay https://t.co/tEmEkLB1IN",50,15,2018,196457,65,0.03
2038,"Ya estamos en el Nacional, ¡vamos  con todo hacia la final! 💪 

⚽ - #RugeLeón
✌🏼 - #FairPlay https://t.co/J6PjLOReqp",139,19,2018,196457,158,0.08
2039,"Esta tarde vamos con todo a dar el primer golpe 💪 
🕖 - 4:00 pm
🏟️ - Estadio Nacional - Tegucigalpa.
⚽ - #RugeLeón https://t.co/sjfEG6bq4i",107,45,2018,196457,152,0.08
2040,"La grandeza, la gloria y la historia de un gran equipo en nuestra nueva camiseta.
#SomosOlimpia #RugeLeon https://t.co/R6fNRFvjJ3",163,71,2018,196457,234,0.12
2041,"Adquiere la camiseta de tu preferencia en todas las tiendas Diunsa a nivel nacional y en https://t.co/T0RicdE63f 

#SomosOlimpia #RugeLeon #NuevaPiel https://t.co/DTqZQQxdHi",132,40,2018,196457,172,0.09
2042,"A la venta en Diunsa y https://t.co/ygu3mpQiIj 

#SomosOlimpia #RugeLeon #NuevaPiel https://t.co/yplgpSiRAY",184,55,2018,196457,239,0.12
2043,"Adquiere tu camiseta oficial en todas las tiendas Diunsa a nivel nacional.

#SomosOlimpia #RugeLeon https://t.co/4VRh7rD677",59,16,2018,196457,75,0.04
2044,"La grandeza, la gloria y la historia de un gran equipo en nuestra nueva camiseta.

#SomosOlimpia #RugeLeon #NuevaPiel https://t.co/wlggy9XgJT",213,97,2018,196457,310,0.16
2045,"En unos minutos...

#SomosOlimpia #RugeLeon #NuevaPiel https://t.co/kMco4jgcLP",128,34,2018,196457,162,0.08
2046,"Olimpia vestirá nueva piel de la marca Umbro. Muy pronto a la venta en Diunsa y https://t.co/T0RicdE63f 

🦁 | #somosolimpia #rugeleon https://t.co/clqS2Y5MWD",150,41,2018,196457,191,0.1
2047,Nos complace anunciar que el @CDOlimpia estará vistiendo la marca Umbro. #somosolimpia #rugeleon https://t.co/7IneTKFMXM,416,168,2018,196457,584,0.3
2048,"Estos son los precios para el partido de ida de la semifinal ante Motagua del próximo domingo:
🎟️ - Sol: L.80 | Sombra: L.150 | Silla: L.350
🦁 - #RugeLeón",129,65,2018,196457,194,0.1
2049,Repasemos en imágenes el triunfo que pone a los leones en la semifinal. 💪 #RugeLeon | https://t.co/Z5c0FgjgFA https://t.co/kDZMOOPB0g,99,26,2018,196457,125,0.06
2050,"Olimpia consigue la victoria en el Nacional de Tegucigalpa. ¡Estamos en semifinales! 💪🏼
⚽ | Olimpia 2-1 Platense
🦁 | #RugeLeón https://t.co/k7pdBZKD9X",198,70,2018,196457,268,0.14
2051,"Esta tarde vamos con todo ¡por el pase a semifinales! 💪 
🕖 - 4:00 pm
🏟️ - Estadio Nacional - Tegucigalpa.
⚽ - #RugeLeón https://t.co/Ad85X1z8Yn",123,43,2018,196457,166,0.08
2052,"Importante resultado en el partido de ida del repechaje rumbo a semifinales. 
⚽ | Platense 0-0 Olimpia 
🦁 | #RugeLeón https://t.co/HxDGFwSD5w",62,29,2018,196457,91,0.05
2053,"Esta noche vamos ¡con todo! a dar el primer paso. 💪 
🕖 - 7:15 pm
🏟️ - Estadio Excélsior - Puerto Cortés.
⚽ - #RugeLeón https://t.co/19qq7cZsf5",141,54,2018,196457,195,0.1
2054,📷 | Fotos del entrenamiento del día hoy. ¡Estamos listos para enfrentar a Platense en repechaje! 💪 #RugeLeon | https://t.co/EQETnKYxg6 https://t.co/dbOt4a2h8Q,102,28,2018,196457,130,0.07
2055,"Estos son los precios para el partido de vuelta del repechaje ante Platense del próximo domingo:
🎟️ - Sol: L.60 | Sombra: L.120 | Silla: L.250
🦁 - #RugeLeón",94,32,2018,196457,126,0.06
2056,Los juegos del repechaje serán ante Platense. El partido de vuelta será el domingo 22 en el Nacional de Tegucigalpa | #RugeLeon,115,42,2018,196457,157,0.08
2057,"Importante triunfo de los leones en el Nacional. 
⚽ | Olimpia 4-0 UPNFM 
🦁 | #RugeLeón https://t.co/t1MtfrQRYo",118,40,2018,196457,158,0.08
2058,"Este domingo vamos por la clasificación a semifinales. Acompañanos en esta importante lucha. 💪 
🕖 - 3:00 pm
🏟️ - Estadio Nacional - Tegucigalpa.
⚽ - #RugeLeón https://t.co/iOOGOxhBH2",86,21,2018,196457,107,0.05
2059,"Importante triunfo de los leones en Puerto Cortés. 
⚽ | Plantese 1-2 Olimpia 
🦁 | #RugeLeón https://t.co/P1CeeHdqSI",117,36,2018,196457,153,0.08
2060,"Mañana la cita es ante Platense por la fecha 17 del Clausura 2018 💪 
🕖 - 7:15 pm
🏟️ - Estadio Excélsior - Puerto Cortés.
⚽ - #RugeLeón https://t.co/QzyknkvF1h",68,16,2018,196457,84,0.04
2061,"Empatan los leones en el Nacional de Tegucigalpa. 
⚽ | Olimpia 2-2 Real España 
🦁 | #RugeLeón https://t.co/FVdCwRwsPI",74,24,2018,196457,98,0.05
2062,"💪 ...vamos leones, ¡con todo!
🕖 - 4:00 pm
🏟️ - Estadio Nacional - Tegucigalpa.
⚽ - #RugeLeón https://t.co/byvpBuGplp",84,34,2018,196457,118,0.06
2063,"Este domingo nuestro compromiso es ante el Real España. Acompañanos en la lucha por estos tres puntos. 💪 
🕖 - 4:00 pm
🏟️ - Estadio Nacional - Tegucigalpa.
⚽ - #RugeLeón https://t.co/ByAK8Hjlud",93,31,2018,196457,124,0.06
2064,"Caída de los leones en El Progreso. 
⚽ | Honduras Progreso 3-2 Olimpia
🦁 | #RugeLeón https://t.co/BYZYxjpR6Q",41,23,2018,196457,64,0.03
2065,"Mañana la cita es ante Honduras Progreso por la fecha 15 del Clausura 2018 💪 
🕖 - 7:00 pm
🏟️ - Estadio Humberto Michelleti - El Progreso.
⚽ - #RugeLeón https://t.co/YX1DD5adm3",61,23,2018,196457,84,0.04
2066,"Nos unimos a las muestras de pesar por el fallecimiento de Santiago Vergara, ex jugar del club Motagua. 🙏 https://t.co/OCEXK3tSvD",273,103,2018,196457,376,0.19
2067,"Excelente triunfo de los leones en el Nacional. 
⚽ | Motagua 0-1 Olimpia
🦁 | #RugeLeón https://t.co/dTQZCEeonN",249,95,2018,196457,344,0.18
2068,"Esta tarde nuestro compromiso es ante Motagua. Acompañanos en la lucha por estos tres puntos importantes. 💪 
🕖 - 4:00 pm
🏟️ - Estadio Nacional - Tegucigalpa.
⚽ - #RugeLeón https://t.co/Cd1qkxJQkW",132,39,2018,196457,171,0.09
2069,"Olimpia realiza sus trabajos respectivos de cara al importante compromiso de este domingo, ahora bajo el mando del Profesor Espinoza. 💪 #RugeLeón https://t.co/212NhRNCg8",148,42,2018,196457,190,0.1
2070,"Queremos agradecer al profesor Restrepo por su trabajo realizado en el Club Olimpia. Un gran profesional y todavía más, una gran persona. ¡Muchas gracias!  #RugeLeón https://t.co/zZ0jcdljRS",193,42,2018,196457,235,0.12
2071,"Después de aceptar la renuncia al Profesor Restrepo, la Directiva del Club Olimpia notifica la llegada de Nahún Espinoza como nuevo Director Técnico, quien será asistido por su hermano Juan Carlos. 

¡Bienvenido a casa! - #RugeLeón https://t.co/OTFdZMNDUD",339,155,2018,196457,494,0.25
2072,El Director Técnico Carlos Restrepo presentó su renuncia esta mañana al Vice Presidente Deportivo y en esta tarde se reunirá con el Presidente del club para evaluar su situación y tomar determinaciones para el resto del campeonato. #RugeLeón https://t.co/S0Lt7WCIn9,130,77,2018,196457,207,0.11
2073,"Empate de los leones en el Nacional. 
⚽ | Olimpia 1-1 Vida 
🦁 | #RugeLeón https://t.co/5SqMqtar9P",54,14,2018,196457,68,0.03
2074,"Hoy participamos, junto a los demás equipos de la @lnphonduras, en la “Conferencia Internacional sobre Mercadeo Deportivo” con participación de representantes de la Liga Española. https://t.co/OgcfZ8AFmj",103,23,2018,196457,126,0.06
2075,"Este domingo nuestro compromiso es ante el Vida. Acompañanos en la lucha por estos tres puntos. 💪 
🕖 - 4:00 pm
🏟️ - Estadio Nacional - Tegucigalpa.
⚽ - #RugeLeón https://t.co/ossBntk5v4",61,22,2018,196457,83,0.04
2076,"El equipo FBO Sub 12 se coronó 🏆Campeón del Torneo Federado Navideño. También se obtuvo el trofeo de máximo goleador compartido por Héctor Ávila y Led Mena. 💪🏼 Un gran trabajo de equipo, padres de familia y entrenadores #RugeLeon https://t.co/4EengRWzdm",71,17,2018,196457,88,0.04
2077,"La sub 14 de la FBO se coronó Campeón de liga. 🏆 Felicidades a nuestros jóvenes y a sus padres por su esfuerzo, determinación y amor al equipo 💪🏼#RugeLeon https://t.co/zoXEzCmyMH",73,23,2018,196457,96,0.05
2078,"Caída de los leones en el Yankel Rosenthal. 
⚽ | Marathón 3-1 Olimpia
🦁 | #RugeLeón https://t.co/dMgR1ZwGRm",65,13,2018,196457,78,0.04
2079,"Este domingo nos jugamos otros tres puntos importantísimos ante Marathón. 💪 
🕖 - 3:00 pm
🏟️ - Estadio Yankel Rosenthal - San Pedro Sula.
⚽ - #RugeLeón https://t.co/HFujeYPkLn",89,34,2018,196457,123,0.06
2080,"Excelente triunfo para los leones de visita en Tocoa. 💪
⚽ | Real Sociedad 0-2 Olimpia
🦁 | #RugeLeón https://t.co/f9Hjg2WCRa",172,41,2018,196457,213,0.11
2081,"Esta tarde nos jugamos tres puntos ante Real Sociedad en partido reprogramado de la jornada 10. 
🕖 - 2:00 pm
🏟️ - Estadio Francisco Martínez - Tocoa.
⚽ - #RugeLeón https://t.co/33vB4DV3e8",45,21,2018,196457,66,0.03
2082,"Acuerdo de duelo por el fallecimiento de la señora María Magdalena Molina, madre de nuestro deportista Carlo Jair Costly. 🙏 https://t.co/aOiKEHAjZE",118,39,2018,196457,157,0.08
2083,La Junta Directiva General del Club Olimpia Deportivo por este medio hace la siguiente Aclaración Pública: https://t.co/qZUSu8JFFm,67,25,2018,196457,92,0.05
2084,"Derrota para los leones en el Nacional de Tegucigalpa. 💪
⚽ | Olimpia 1-2 Juticalpa
🦁 | #RugeLeón https://t.co/FkJELQj4dn",46,15,2018,196457,61,0.03
2085,"Mañana volvemos a nuestro torneo doméstico. Enfrentamos a Juticalpa en nuestra casa 💪 
🕖 - 4:00 pm
🏟️ - Estadio Nacional - Tegucigalpa.
⚽ - #RugeLeón https://t.co/nRpb4gTzJy",96,35,2018,196457,131,0.07
2086,La Liga Nacional también se solidariza con el Profesor Oscar Salgado por el fallecimiento de su madre. https://t.co/iaWyvUU4O7,42,4,2018,196457,46,0.02
2087,"Acuerdo de duelo por el fallecimiento de la señora Dora Argentina Nelson, madre del Profesor Oscar Salgado, integrante del Cuerpo Técnico del Club Olimpia. https://t.co/Es3wXSFUBL",64,18,2018,196457,82,0.04
2088,"Los leones no pudieron en Nueva York y quedan fuera de la Liga de Campeones de Concacaf.  
⚽ - NY Red Bulls 2-0 Olimpia
🦁 - #RugeLeón https://t.co/lWMSCbmoCB",78,31,2018,196457,109,0.06
2089,Rumbo al Estadio 💪🏼 ¡Vamos leones! https://t.co/WME0j5Rw0z,63,24,2018,196457,87,0.04
2090,Ronny y el Cappy encargados de la utileria del club ya están preparados para tener todo listo en el estadio 💪🏼 #RugeLeon https://t.co/utwMhhuT8l,70,22,2018,196457,92,0.05
2091,"Lo técnico, lo táctico y lo anímico está listo 💪🏼 ...¡esta noche ruge el león! https://t.co/ENY3ywWIL8",193,70,2018,196457,263,0.13
2092,En las afueras del estadio los aficionados muestran su amor al león. ¡Gracias por su apoyo!  #RugeLeón https://t.co/ZXSTBH9MIx,213,51,2018,196457,264,0.13
2093,"Con el ánimo a tope 💪 ¡estamos listos! 

🦁 #RugeLeón https://t.co/aGSXNaVsEo",342,108,2018,196457,450,0.23
2094,"Fernando Osorio, Gerente de Licenciamiento de Clubes de CONCACAF y Jose Ernesto Mejia, secretario de Fenafuth entregan de material deportivo a Olimpia por su avance en el licenciamiento. Reciben el directivo Alfonso Guzmán, el entrenador Haroldo Guzman y jóvenes de la FBO de SPS. https://t.co/52BpfQa3pV",56,13,2018,196457,69,0.04
2095,Ya en la gran manzana 💪🏼 ...vamos leones. https://t.co/4HWtC8RumW,223,55,2018,196457,278,0.14
2096,En ruta a Nueva York 💪🏼 #RugeLeón https://t.co/TT4XlTDhC1,202,48,2018,196457,250,0.13
2097,"Los jugadores Brayan Moya, Jonathan Paz y Dabirson Castillo no viajan a Nueva York por situaciones personales en sus trámites de VISA para el ingreso a EEUU. 👉🏼 https://t.co/Qhq8Gi5cGJ",50,27,2018,196457,77,0.04
2098,"Los leones consiguieron un empate en el partido de ida por la Liga de Campeones de Concacaf.  
⚽ - Olimpia 1-1 NY Red Bulls 
🦁 - #RugeLeón https://t.co/cVybKSn9pk",176,52,2018,196457,228,0.12
2099,"Esta noche ¡vamos con todo! 
⚽ - Olimpia - NY Red Bulls 
🏆 -  Liga de Campeones de Concacaf.
🕖 - 9:00 pm
🏟️ - Estadio Nacional de Costa Rica.
🦁 - #RugeLeón https://t.co/TeDpiEmTtJ",197,95,2018,196457,292,0.15
2100,"Volvemos al ruedo internacional 💪 Este jueves enfrentamos al Red Bulls por la Concacaf Champions League. 
🕖 - 9:00 pm
🏟️ - Estadio Nacional de Costa Rica.
⚽ - #RugeLeón https://t.co/5JrFTp4cgN",144,59,2018,196457,203,0.1
2101,"Triunfo de los leones en el cierre de la primera vuelta del Clausura 2018. 💪
⚽ | UPNFM 0-2 Olimpia
🦁 | #RugeLeón https://t.co/6aNnAUV5yN",171,56,2018,196457,227,0.12
2102,"Mañana sábado el compromiso es ante los Lobos de la UPNFM 💪 
🕖 - 6:00 pm
🏟️ - Estadio Emilio Williams - Choluteca.
⚽ - #RugeLeón https://t.co/wok81tnahF",96,31,2018,196457,127,0.06
2103,"Los leones empatan en casa por la octava jornada del Clausura 2018. 💪
⚽ | Olimpia 0-0 Platense
🦁 | #RugeLeón https://t.co/n2qNQ6UrKI",33,11,2018,196457,44,0.02
2104,"Este miércoles enfrentamos a Platense en nuestra casa 💪 
🕖 - 7:00 pm
🏟️ - Estadio Nacional - Tegucigalpa.
👩‍❤️‍👨 - Mujeres entran gratis acompañadas de su pareja.
⚽ - #RugeLeón https://t.co/zhO9YOcw2Y",112,42,2018,196457,154,0.08
2105,"Gran triunfo de los leones en San Pedro Sula. 💪
⚽ | Real España 0-1 Olimpia 
🦁 | #RugeLeón https://t.co/BO2dTRdPnW",194,71,2018,196457,265,0.13
2106,"Esta noche vamos con todo para enfrentar de visita a Real España 💪 
🕖 - 7:00 pm
🏟️ - Estadio Morazán - San Pedro Sula.
⚽ - #RugeLeón https://t.co/tuTap4dmGa",134,42,2018,196457,176,0.09
2107,"Gran triunfo de los leones jugando en casa. 💪
⚽ | Olimpia 6-1 Honduras Progreso 
🦁 | #RugeLeón https://t.co/1hMbIh33hm",250,110,2018,196457,360,0.18
2108,"Te esperamos en el Nacional. 💪🦁 ¡A rugir leones!

🕖 - 7:00 pm
🏟️ - Estadio Nacional - Tegucigalpa.
🎟️ - Sol: L.60 | Sombra: L.100 | Silla: L.200 https://t.co/pZRhRnxU09",90,27,2018,196457,117,0.06
2109,"Te esperamos mañana para apoyar a nuestro amado león 💪 ante Honduras Progreso. 
🕖 - 7:00 pm
🏟️ - Estadio Nacional - Tegucigalpa.
⚽ - #RugeLeón https://t.co/raX5gkyAXx",106,30,2018,196457,136,0.07
2110,Admiramos el coraje y el espíritu alegre que mantienen los guerreros para afrontar esta lucha. Por eso nuestro aporte en este mes de febrero a @salvamivida  💪🦁💛 #RugeLeón #CáncerInfantilHN https://t.co/NX4TycoTNZ,136,46,2018,196457,182,0.09
2111,"Un nuevo empate para los leones en la quinta jornada del Clausura 2018. 💪
⚽ | Olimpia 1-1 Motagua 
🦁 | #RugeLeón https://t.co/1PsYMcEdTb",45,20,2018,196457,65,0.03
2112,¡Ruge león! 💪 https://t.co/BdlJmW4qz5,124,48,2018,196457,172,0.09
2113,"Este domingo te esperamos para apoyar a nuestro amado león 💪 ante Motagua. 
🕖 - 4:00 pm
🏟️ - Estadio Nacional - Tegucigalpa.
⚽ - #RugeLeón https://t.co/dxFDr5FXwx",127,51,2018,196457,178,0.09
2114,"Empatan los leones en La Ceiba por la cuarta jornada del Clausura 2018. 💪
⚽ | Vida 1-1 Olimpia 
🦁 | #RugeLeón https://t.co/mOV7VSvVFr",83,21,2018,196457,104,0.05
2115,"Esta noche ¡vamos con todo! 
🕖 - 7:15 pm
🏟️ - Estadio Municipal - La Ceiba.
⚽ - #RugeLeón https://t.co/ettoKKEpGZ",127,36,2018,196457,163,0.08
2116,"""Bi, tri y tetracampeonatos en la historia de la Liga Nacional"". Les compartimos el artículo del Dr. Elmer López Lutz: https://t.co/3H4QWnjMJ5",118,54,2018,196457,172,0.09
2117,"Empatan los leones en la tercera jornada del Clausura 2018. 💪
⚽ | Olimpia 1-1 Marathón 
🦁 | #RugeLeón https://t.co/kYjtzlw3o7",71,20,2018,196457,91,0.05
2118,Bienvenido a casa Wilson Palacios. 💪🏼 #RugeLeón https://t.co/OJQeQZXLtg,423,152,2018,196457,575,0.29
2119,"Nuestro siguiente compromiso es el domingo 💪 ante Marathón. 
🕖 - 4:00 pm
🏟️ - Estadio Carlos Miranda - Comayagua.
⚽ - #RugeLeón https://t.co/Yh1fi10ilD",109,35,2018,196457,144,0.07
2120,"Rugen los leones en la segunda jornada del Clausura 2018. 💪
⚽ | Juticalpa 3-5 Olimpia
🦁 | #RugeLeón https://t.co/IXCT9sT5Vi",177,63,2018,196457,240,0.12
2121,Felicidades en su día mujeres hondureñas. Sigan siempre con fortaleza luchando por sus sueños. 💃🦁 #RugeLeón https://t.co/hjz3CQQgUG,167,56,2018,196457,223,0.11
2122,Suspendido el partido ante Juticalpa por problemas eléctricos.  #RugeLeón,42,18,2018,196457,60,0.03
2123,"Todo listo para enfrentar a Juticalpa. 
🕖 - 7:00 pm
🏟️ - Estadio Juan Ramón Brevé - Juticalpa.
⚽ - #RugeLeón https://t.co/A8wpmvFcIf",51,12,2018,196457,63,0.03
2124,"Damos la bienvenida al mediocampista colombiano Jaime Miguel Córdoba Taborda, nuevo refuerzo del club. 💪🏼 #RugeLeón https://t.co/knWy7G9qf8",305,119,2018,196457,424,0.22
2125,"Mañana continuamos nuestro camino hacia el título del Clausura 2018 💪 enfrentando a Juticalpa. 
🕖 - 7:00 pm
🏟️ - Estadio Juan Ramón Brevé - Juticalpa.
⚽ - #RugeLeón https://t.co/nXACz0Q4Hq",108,45,2018,196457,153,0.08
2126,"Damos la bienvenida al defensor argentino Nicolás Del Grecco, nuevo refuerzo del club. 💪🏼 #RugeLeón https://t.co/44JiZ56whZ",276,132,2018,196457,408,0.21
2127,"Los leones inician con buen pie en el Clausura 2018. 💪
⚽ | Olimpia 1-0 Real Sociedad
🦁 | #RugeLeón https://t.co/PmhbQx6q3H",171,50,2018,196457,221,0.11
2128,"Esta tarde iniciamos el Clausura 2018 💪 ante Real Sociedad. 
🕖 - 5:00 pm
🏟️ - Estadio Carlos Miranda - Comayagua.
⚽ - #RugeLeón https://t.co/8vWfd6918U",108,31,2018,196457,139,0.07
2129,"Damos la bienvenida al defensor panameño Luis Ovalle, nuevo refuerzo del club. 💪🏼 #RugeLeón https://t.co/G2zURGCEce",449,215,2018,196457,664,0.34
2130,"Iniciamos el Clausura 2018 💪 ante Real Sociedad. 
🗓️ - Sábado 20 de enero
🕖 - 5:00 pm
🏟️ - Estadio Carlos Miranda - Comayagua. https://t.co/z89g0z0ZSV",136,53,2018,196457,189,0.1
2131,"Tres temporadas sin título para Olimpia, ¿es realmente una sequía? - https://t.co/STNS6ux8Jn",80,20,2018,196457,100,0.05
2132,Lamentamos el fallecimiento de nuestro ex jugador y ex seleccionado nacional Juan Carlos García. Dios lo reciba en su seno y le de fortaleza y resignación a su familia 🙏 https://t.co/zoteoMuxlh,758,314,2018,196457,1072,0.55
2133,Olimpia segundo mejor equipo de Centroamérica: https://t.co/jTKws31b3h,205,87,2018,196457,292,0.15
2134,Antes de finalizar este año nos preparamos para un 2018 de éxitos. Hemos firmado contrato para el próximo año a Rony Martínez y Diego Reyes #RugeLeon https://t.co/oGAVRJfkpl,501,200,2017,196457,701,0.36
2135,"Banco Atlántida te invita esta noche al ""juego de las estrellas por nuestras estrellas"":
🏆 - Copa Amistad (Olimpia vs Motagua)
👉 - A beneficio de Fundación Hondureña para el Niño con Cáncer 
🕖 - 7:00 pm
🏟️ - Estadio Los Ángeles
 🎫 - Donación: L.100 https://t.co/xLqWcHLVDT",77,7,2017,196457,84,0.04
2136,Les deseamos a todos que pasen una ¡feliz navidad! 🎄⚽🎉 https://t.co/QgcbdmU2K2,276,56,2017,196457,332,0.17
2137,"Los leones no pudieron en el partido de vuelta de la semifinal y se quedan sin final. 
⚽ | Motagua 3-1 Olimpia
🦁 | #RugeLeon https://t.co/ndH6lG7crn",86,18,2017,196452,104,0.05
2138,"Mañana sábado nos jugamos el pase a la final en partido a puerta cerrada. 
🕖 - 3:00 pm
📍- Estadio Nacional - Tegucigalpa
🦁 - #RugeLeon https://t.co/uYn1GObYkK",93,31,2017,196452,124,0.06
2139,"Los leones se impusieron esta tarde y ganan la semifinal de ida en partido a puerta cerrada jugado en el Nacional de Tegucigalpa. 
⚽ | Olimpia 2-0 Motagua
🦁 | #RugeLeon https://t.co/avbAqgNSjs",291,134,2017,196452,425,0.22
2140,Olimpia enfrentará al Red Bulls de New York en los octavos de final de la Concacaf Champions League en partidos de ida y vuelta el próximo mes de febrero. | 🦁 #RugeLeón https://t.co/FaM8j2Re4h,231,136,2017,196452,367,0.19
2141,En unos minutos dará inicio el sorteo de la Concacaf Champions League en donde Olimpia conocerá a su rival para los octavos de final que se juegan en febrero del próximo año. #RugeLeon https://t.co/E5SSD3CmGU,33,16,2017,196452,49,0.02
2142,Los partidos de la semifinal del Torneo Apertura 2017 ante Motagua se realizarán este miércoles y sábado A PUERTAS CERRADAS. #RugeLeón https://t.co/9iZtVuJlMI,92,78,2017,196452,170,0.09
2143,"Atención aficionados olimpistas 📢

Mañana martes (2pm - 5pm) se reembolsará el valor del boleto del partido suspendido ante Motagua contra entrega del boleto original completo en la taquilla No.7 del Estadio Nacional de Tegucigalpa. https://t.co/9y3v4tHcax",41,39,2017,196452,80,0.04
2144,Confirmado: el partido de esta noche ante Motagua queda suspendido debido a razones de seguridad. #RugeLeon https://t.co/dZMV0rp7E8,74,75,2017,196452,149,0.08
2145,Estamos a la espera del Comunicado Oficial de parte de la Liga Nacional al respecto del partido de esta noche ante Motagua por la semifinal del Apertura 2017. #RugeLeon,97,40,2017,196452,137,0.07
2146,"Este jueves es el partido de ida de la semifinal ante Motagua. Te esperamos para apoyar a nuestro amado león. 
🕖 - 7:00 pm
📍- Estadio Nacional - Tegucigalpa
🦁 - #RugeLeon https://t.co/OIwYJ0iwaY",159,72,2017,196452,231,0.12
2147,Confirmamos que el partido de este sábado ante UPNFM será a las 4:00pm. 🦁 - #RugeLeon https://t.co/n19N2EclyW,58,26,2017,196452,84,0.04
2148,"Este sábado nos jugamos el pase a la semifinal ante UPNFM. Te esperamos para apoyar a nuestro amado león. 
🕖 - 2:30 pm
📍- Estadio Nacional - Tegucigalpa
 🦁 - #RugeLeon https://t.co/hz11SYcFSF",57,19,2017,196452,76,0.04
2149,"Los leones empatan en la ida del repechaje ante los lobos en partido jugado esta tarde a puerta cerrada en el Nacional. 
⚽ | UPNFM 2-2 Olimpia
🦁 | #RugeLeon https://t.co/4vgLL4H5Jt",50,20,2017,196452,70,0.04
2150,El partido programado para esta noche en Tegucigalpa entre UPNFM y Olimpia por el repechaje de la Liga Nacional queda suspendido hasta nuevo aviso. #RugeLeon https://t.co/GGP9yWhSDF,77,53,2017,196452,130,0.07
2151,"Gran triunfo de esta noche en el Nacional. Los leones finalizan las dos vueltas en la tercera posición, clasificando al repechaje frente a UPNFM.
⚽ | Olimpia 4-1 juticalpa
🦁 | #RugeLeon https://t.co/Hpe89SwiTe",91,33,2017,196452,124,0.06
2152,"Esta noche cerramos las dos vueltas ante Juticalpa. Te esperamos en el Nacional para apoyar a nuestro amado león en este decisivo partido. #RugeLeon
🕖 - 7:00 pm
🎟️ - Entrada gratis con la contraseña de ingreso del partido del domingo ante Marathón. https://t.co/NlzyRfVFk6",48,21,2017,196452,69,0.04
2153,"Mañana cerramos las dos vueltas ante Juticalpa. Te esperamos en el Nacional para apoyar a nuestro amado león en este decisivo partido. #RugeLeon
🕖 - 3:00 pm
📍- Estadio Nacional - Tegucigalpa https://t.co/6Y1j0q2pDT",38,17,2017,196452,55,0.03
2154,"Fuerzas Básicas Olimpistas Sub-12, Campeón de la Copa FESA de El Salvador. 💪 #RugeLeon | https://t.co/AxNPZqca56 https://t.co/w5HviYHr1y",104,32,2017,196452,136,0.07
2155,"Lamentable derrota de los leones en el Nacional.

⚽ | Olimpia 0-1 Marathón 
🦁 | #RugeLeon https://t.co/hVZwCCrmmM",60,16,2017,196452,76,0.04
2156,Mañana contamos con tu apoyo en este trascendental encuentro. Con este boleto te damos la entrada gratis para el partido del jueves ante Juticalpa. #RugeLeon https://t.co/pCcuBJTieA,114,40,2017,196452,154,0.08
2157,En partido reprogramado este domingo los leones recibirán al Marathón y cuentan con tu apoyo en este trascendental encuentro. #RugeLeon https://t.co/sQMgAsuGH8,67,18,2017,196452,85,0.04
2158,"El león no pudo en Tocoa y pierde la oportunidad de ganar tres puntos importantes.
⚽ | Real Sociedad 2-1 Olimpia
🦁 | #RugeLeon https://t.co/JMOl9TYWLL",37,9,2017,196452,46,0.02
2159,"Mañana el león continúa la actividad del Torneo Apertura 2017-2018 con un importante encuentro. #RugeLeon
🕖 - 1:00 pm
📍- Estadio Francisco Martínez- Tocoa https://t.co/PVXwEgEhJN",55,18,2017,196452,73,0.04
2160,"Conozcan a los 28 campeones Sub-12 🏆 💪 Un campeonato para el recuerdo de estos jóvenes promesas. ¡Felicidades a ellos, sus padres de familia y al cuerpo técnico! #RugeLeón https://t.co/rykCLZvS6D",74,25,2017,196452,99,0.05
2161,Realiza todas tus compras con tus Tarjetas de Crédito Olimpia y participa 👇 - https://t.co/xAiE8hJ9qK https://t.co/5Tl2bEIEEO,23,6,2017,196452,29,0.01
2162,Confirmamos que el partido Olimpia vs Marathón progamado para el día de mañana miércoles ha sido suspendido. https://t.co/no1lNVa4nQ,61,28,2017,196452,89,0.05
2163,Partido clave para consolidar el liderato. Olimpia vs Marathón este miércoles en el Nacional. #RugeLeon https://t.co/IwT37CGqqn,94,30,2017,196452,124,0.06
2164,"Felicidades Fuerzas Básicas Olimpistas (Sub 12), por coronarse 🏆 Campeón de la Liga federada Jorge Humberto Andrade, al vencer 1x0 a Motagua https://t.co/KcphWkovSj",131,40,2017,196452,171,0.09
2165,"Triunfo de los leones en el Nacional y suben a la primera posición.
⚽ | Olimpia 3-0 Platense
🦁 | #RugeLeon https://t.co/bilbu8fnrg",136,57,2017,196452,193,0.1
2166,Por si aún no lo han visto. Excelente nota de @relymp que narra la historia de Tato y su gran amor por Olimpia. https://t.co/ugCde6rvIh https://t.co/XgFkWNNV15,201,61,2017,196452,262,0.13
2167,Mañana domingo los leones enfrentan a Platense en nuestra casa. ¡Contamos con tu apoyo!  #RugeLeon https://t.co/K3Bly7283Q,88,27,2017,196452,115,0.06
2168,"Importante triunfo para los leones en el Nacional Tegucigalpa.
⚽ | UPNFM 0-2 Olimpia 
🦁 | #RugeLeon https://t.co/YKMOx3GSfS",152,44,2017,196452,196,0.1
2169,Esta noche en partido reprogramado los leones enfrentan a los lobos. 💪¡Vamos con todo! - #RugeLeon https://t.co/AHHQ1QgB8w,79,32,2017,196452,111,0.06
2170,"Finaliza el partido con empate en el Nacional Tegucigalpa.
⚽ | Olimpia 0-0 Motagua 
🦁 | #RugeLeon https://t.co/yTKGpdprXX",68,18,2017,196452,86,0.04
2171,Este domingo ante Motagua en el derby capitalino. 🏆 - Presentaremos la Copa y Trofeos ganados en la Concacaf League. #RugeLeon https://t.co/6SlCw1TIJ7,140,52,2017,196452,192,0.1
2172,Con una cena celebraron anoche los campeones 💪🏼🏆 ¡Felicidades leones! https://t.co/ityzaX9k7o,175,47,2017,196452,222,0.11
2173,"🏅-Michael Chirinos, Balón de Oro (MVP) del Torneo
🥇-Roger Rojas, Botín de Oro (5 goles) del Torneo
🎖️-Kevin Álvarez, Jugador Joven de Torneo https://t.co/2EYWgFxmfA",328,174,2017,196452,502,0.26
2174,"Olimpia, primer Campeón 🏆 de la Concacaf League 💪 #RugeLeón https://t.co/jRiimBVFj9",264,142,2017,196452,406,0.21
2175,"¡Ganamos!, somos CAMPEONES de la SCOTIABANK LEAGUE 2017 de la CONCACAF. #RugeLeón",708,466,2017,196452,1174,0.6
2176,Finalizan los 90 minutos. Olimpia 1-1 Santos (marcador global). Vamos a penales. #RugeLeón,67,19,2017,196452,86,0.04
2177,Estamos en el medio tiempo en Costa Rica. Olimpia derrota a Santos y el marcador global se mantiene empatado 1-1. #VamosLeones,58,21,2017,196452,79,0.04
2178,¡Gol de Olimpia!!! ...los leones se ponen igual en el marcador global (Olimpia 1-1 Santos),164,74,2017,196452,238,0.12
2179,"A pocos minutos, ...vamos por la remontada, vamos por ¡la gloria! - #RugeLeón https://t.co/EmQfpm2RGg",95,42,2017,196452,137,0.07
2180,"Hoy vamos por la remontada, por la copa 🏆,...vamos ¡por la gloria! #RugeLeón 🦁 https://t.co/500CLq9QX3",281,150,2017,196452,431,0.22
2181,"Importante triunfo en el Nacional.
⚽ | Olimpia 3-0
🦁 | #RugeLeon https://t.co/S1uSUtJdiN",171,64,2017,196452,235,0.12
2182,Mañana los leones reciben al Real España y contamos con tu apoyo. 💪¡Vamos con todo! - #RugeLeon https://t.co/6Hg6JzKgLy,57,22,2017,196452,79,0.04
2183,Olimpia cayó derrotado en el Olímpico de San Pedro Sula en primer partido de la Final de Liga Scotiabank de Concacaf. #SinpúblicoNoEsIgual https://t.co/OWnpDXHhxk,46,19,2017,196452,65,0.03
2184,¡Desde el corazón de un león! ... https://t.co/PzLbF887t6 ... #RugeLeon,38,21,2017,196452,59,0.03
2185,A unas cuantas horas del primer partido de la final de la Scotiabank League de la Concacaf 💪...¡vamos leones! https://t.co/1Lm61MF5sv,58,31,2017,196452,89,0.05
2186,Mañana Olimpia buscará (a puerta cerrada) dar el primer golpe en la final de la Liga Scotiabank de Concacaf vs Santos Guápiles 💪 - #RugeLeon https://t.co/t4czZ7dEDW,93,53,2017,196452,146,0.07
2187,"Caída en La Ceiba en el arranque de la fecha once del Torneo Apertura 2017.
⚽ | Vida 1-0 Olimpia
🦁 | #RugeLeon https://t.co/jVRQg5zTB2",27,18,2017,196452,45,0.02
2188,Olimpia solicita a @CONCACAF que la final se juegue con público: https://t.co/98G2BWllB0 | #juegolimpio #solidaridad #EstadoDeGol,119,65,2017,196452,184,0.09
2189,Olimpia consiguió tres puntos importantes esta noche en partido reprogramado de la sexta fecha 🦁 #RugeLeon https://t.co/GSDRUifOdK,157,50,2017,196452,207,0.11
2190,"En Olimpia estamos en contra de la violencia en los estadios. Apoyamos el #RespetoAlAdversario ☺️👍

#NoMasViolencia #EstadoDeGol https://t.co/NC0rlfKE0b",146,59,2017,196452,205,0.1
2191,"Olimpia se impuso esta tarde en casa ante los progreseños.
⚽ | Olimpia 3-0 Honduras Progreso
🦁 | #RugeLeon https://t.co/9B9pMqhocb",133,59,2017,196452,192,0.1
2192,Esta tarde los leones reciben al Honduras Progreso y contamos con tu apoyo. 💪¡Vamos con todo! - #RugeLeon https://t.co/FYkWGfu3dA,64,21,2017,196452,85,0.04
2193,"Olimpia empató esta noche en tierras olanchanas.
⚽ | Juticalpa 2-2 Olimpia
🦁 | #RugeLeon https://t.co/ITq5BEHAcq",52,17,2017,196452,69,0.04
2194,"En Olimpia estamos en contra de la violencia en los estadios. Apoyamos el #RespetoAlAdversario y el #JuegoLimpio ☺️👍

#NoMasViolencia https://t.co/zyTZIhGjzT",107,47,2017,196452,154,0.08
2195,Olimpia ganó esta tarde en el Nacional de Tegucigalpa y suma tres puntos en el Apertura 2017-2018. 🦁 | #RugeLeon https://t.co/hHg3cPeV3h,121,46,2017,196452,167,0.09
2196,Mañana continúa el Apertura 2017-2018. Los leones reciben al Real Sociedad. 💪¡Vamos con todo! - #RugeLeon https://t.co/fvgsFC8aQE,57,27,2017,196452,84,0.04
2197,Olimpia enfrentará al Santos de Guápiles (Costa Rica) en la final de la Liga Scotiabank de Concacaf (19 y 26 de octubre). 🦁💪 #RugeLeon https://t.co/KOmmbmvbaw,117,56,2017,196452,173,0.09
2198,¡Estamos en la final! Olimpia solo está a la espera de conocer su rival para la gran final de la Liga Scotiabank de la Concacaf. #RugeLeon https://t.co/3SQeyM4WED,105,54,2017,196452,159,0.08
2199,Gol de Olimpia. Roger Rojas pone el empate en el Olímpico de San Pedro Sula.,66,12,2017,196452,78,0.04
2200,Mañana Olimpia buscará (a puerta cerrada) su pase a la final de la Liga Scotiabank de Concacaf ante el Plaza Amador. 💪 - #RugeLeon https://t.co/cnFdZQRO8M,96,39,2017,196452,135,0.07
2201,"Lamentable derrota en San Pedro Sula.
⚽ | Marathon 3-2 Olimpia
🦁 | #RugeLeon https://t.co/38jV0Jpv6K",58,31,2017,196452,89,0.05
2202,Mañana de vuelta al torneo local. Los leones visitan al Marathón. 💪¡Vamos con todo! - #RugeLeon https://t.co/sTNxgCbSRA,76,24,2017,196452,100,0.05
2203,"Recordemos los 7 goles de Olimpia de la noche de ayer en Panamá. ⚽

🎬: CONCACAF https://t.co/gjZoT3UBHj",115,59,2017,196452,174,0.09
2204,"¡Tremendo triunfo del león! 
Olimpia da el primer golpe en la semifinal de ida.
⚽ | Plaza Amador 1-7 Olimpia
🦁 | #RugeLeon https://t.co/Av8sfFkrP3",290,160,2017,196452,450,0.23
2205,Mañana vamos con todo a dar el primer golpe en semifinal de Liga Scotiabank de Concacaf ante el Plaza Amador de Panamá. 💪 - #RugeLeon https://t.co/sf58lYUukk,166,66,2017,196452,232,0.12
2206,"Finalizó empatado el derbi capitalino en Choluteca.
⚽ | Motagua 1-1 Olimpia 
🦁 | #RugeLeon https://t.co/VzCl4jhrh6",64,15,2017,196452,79,0.04
2207,Esta tarde continúa la actividad en el Apertura 2017-2018. Los leones visitan al Real España. 💪¡Vamos con todo! - #RugeLeon https://t.co/DE0sjyu48u,23,5,2017,196452,28,0.01
2208,"Caída del león en el Morazán de San Pedro Sula.
⚽ | Real España 2-0 Olimpia https://t.co/G9mrc3jOvK",23,6,2017,196452,29,0.01
2209,"Comunicado oficial – Partido 24 de agosto ante Alianza 👉
https://t.co/L1qjpHssjx https://t.co/SRDrDcroY6",63,38,2017,196452,101,0.05
2210,"¡ESTAMOS EN SEMIFINALES! 
Tremendo triunfo del león en el Nacional de Tegucigalpa.
⚽ | Olimpia 3-1 Alianza
🦁 | #RugeLeon https://t.co/E6fwXSwhQU",509,259,2017,196452,768,0.39
2211,Este jueves vamos con todo a dar la remontada en los cuartos de final la Liga Scotiabank de la Concacaf ante el Alianza. 💪 - #RugeLeon https://t.co/ayQFkbzcmq,110,52,2017,196452,162,0.08
2212,"¡A reponernos en casa! 
⚽ |  Alianza 1-0 Olimpia
🦁 | #RugeLeon https://t.co/WTzY4nCQIc",101,31,2017,196452,132,0.07
2213,"¡Esta noche volveremos a rugir!
⚽ - Alianza vs Olimpia
🕖 - 8:00 pm
📍- Estadio Cuscatlán - San Salvador, El Salvador. https://t.co/LKVIDmUzLX",105,53,2017,196452,158,0.08
2214,"Finalizó el partido. Empate en el Nacional de Tegucigalpa.
⚽ | Olimpia 0-0 Vida 
🦁 | #RugeLeon",39,17,2017,196452,56,0.03
2215,Continúa la actividad en el Apertura 2017-2018. Los leones reciben al Vida. 💪¡Vamos con todo! - #RugeLeon https://t.co/obzDfah4oE,77,33,2017,196452,110,0.06
2216,"Olimpia clasificó anoche a cuartos de final de la Liga Scotiabank. Ahora enfrentará al Alianza (ES) por el pase a semifinales.
📹: CONCACAF https://t.co/qbFP238tHq",96,35,2017,196452,131,0.07
2217,"Con gol de Roger Rojas, los leones se impusieron esta noche ante los ticos por la Liga Scotiabank de la Concacaf 👊 #RugeLeon https://t.co/Myho8lpP4e",180,97,2017,196452,277,0.14
2218,Los Leones del Olimpia también festejamos hoy el #WorldLionDay ¡Ruge León! https://t.co/yaiOcMUNel,175,103,2017,196452,278,0.14
2219,Está todo listo. Esta noche sellaremos nuestra clasificación a cuartos de final de la Liga Scotiabank de la Concacaf 💪 - #RugeLeon https://t.co/saTPqiHVjw,116,55,2017,196452,171,0.09
2220,Mañana vamos con todo a cerrar la clasificación en la Liga Scotiabank de la Concacaf ante la Liga Deportiva Alajuelense. 💪 - #RugeLeon https://t.co/8QMjxMAkjQ,144,59,2017,196452,203,0.1
2221,"Seguimos con paso firme en el Apertura 2017-2018 👊.
⚽ | Honduras Progreso 0-1 Olimpia
🦁 | #RugeLeon https://t.co/d3X1rTAdsj",138,64,2017,196452,202,0.1
2222,Continúa la actividad en el Apertura 2017-2018. Los leones enfrentarán mañana de visita al Honduras Progreso. 💪 - #RugeLeon https://t.co/s9PBB1N6Sz,58,23,2017,196452,81,0.04
2223,Excelente resultado para los leones que derrotaron a su rival costarricense por la Liga Scotiabank de la Concacaf 👊🦁 #RugeLeon https://t.co/hQEaex85Nx,225,107,2017,196452,332,0.17
2224,Olimpia debuta en el nuevo formato de Concacaf. Se trata de la Liga Scotiabank y lo hace ante la Liga Deportiva Alajuelense. 💪 #RugeLeon https://t.co/rcOxxtPUTX,130,67,2017,196452,197,0.1
2225,"Con gol de Óscar Salas, los leones consiguen sus primeros tres puntos del Apertura 2017-2018.
⚽ | Olimpia 1-0 UPNFM
🦁 | #RugeLeon https://t.co/Q29mnfTmio",88,36,2017,196452,124,0.06
2226,💪🏼 Fotos del entrenamiento previo a comenzar el Torneo Apertura de la Liga Nacional y la Liga CONCACAF 👉🏼 https://t.co/c8WZBKfeOJ #RugeLeon https://t.co/MJOWCM7XNC,61,22,2017,196452,83,0.04
2227,"Héctor Ávila Fonseca, joven promesa del fútbol hondureño https://t.co/dgleRAVhLt",26,7,2017,196452,33,0.02
2228,Olimpia arranca el Apertura 2017-2018 en partido adelantado (de la jornada 4) frente al recién ascendido UPNFM. 💪¡Vamos con todo! #RugeLeon https://t.co/5Qyx2vdEe5,75,46,2017,196452,121,0.06
2229,"Excelente resultado en partido amistoso internacional 👊 esta noche en el Nacional.
⚽ | Olimpia 2-0 Águila (El Salvador)
🦁 | #RugeLeon https://t.co/XdoG4J0Acu",113,52,2017,196452,165,0.08
2230,Mañana martes amistoso internacional frente al Águila de El Salvador. #RugeLeon https://t.co/RNbY52iZ8V,70,39,2017,196452,109,0.06
2231,"Es oficial: ""Choco"" Lozano al Barcelona -  https://t.co/c7IqbhCZh5 https://t.co/s3gQ48A3qM",135,82,2017,196452,217,0.11
2232,"Contundente resultado en partido amistoso 👊 esta noche en el Nacional de Tegucigalpa.
⚽ | Olimpia 5-0 Honduras Progreso
🦁 | #RugeLeon https://t.co/52NeUC7U5I",84,39,2017,196452,123,0.06
2233,Este sábado Olimpia enfrentará al Honduras Progreso en partido amistoso. #RugeLeon https://t.co/ZOHyLgHihc,68,33,2017,196452,101,0.05
2234,"Contratación, previa evaluación médica: Andrés Quejada Murillo, defensa central colombiano proveniente del Fútbol Club Fortaleza. https://t.co/u0g1zEBzLb",72,66,2017,196452,138,0.07
2235,"Contratación, previa evaluación médica: Jonathan Paz proveniente del Real Sociedad de Tocoa. https://t.co/mbrmTgqM4K",79,62,2017,196452,141,0.07
2236,"¡Vístete de gloria! 💪
→ Adquiere la nueva camiseta del león en 📲 https://t.co/T0RicdE63f https://t.co/JdrE2cOeTM",78,29,2017,196452,107,0.05
2237,Comunicado oficial ante declaraciones de deportiva salvadoreño: https://t.co/Uu5PSesbaW,55,61,2017,196452,116,0.06
2238,Olimpia recibe reconocimiento de FUNHOCAM - https://t.co/TjZ4NfAbW2,28,17,2017,196452,45,0.02
2239,La Junta Directiva y el DT Restrepo tuvieron el chance de celebrar los 105 años de Olimpia 🎉 💪🏼 https://t.co/iT7D6tmRue,117,49,2017,196452,166,0.08
2240,El técnico Carlos Retrepo fue presentado oficialmente esta tarde. Reiteramos nuestra bienvenida y buenos deseos en su gestión 💪👊 #RugeLeon 🦁 https://t.co/YSFXGzu3dK,84,52,2017,196452,136,0.07
2241,"Carlos Restrepo, nuevo Director Técnico de Olimpia, ya se encuentra en el país. ¡Le damos la bienvenida y le deseamos éxito! 💪🦁 #RugeLeon https://t.co/KaNZH9JJR9",78,35,2017,196452,113,0.06
2242,"¡Felicidades olimpistas! 💪
Son 105 años llenos de gloria e historia ⚽🏆⚽🏆🎉 https://t.co/6HZfCaoabe",328,263,2017,196452,591,0.3
2243,Olimpia enfrentará a Liga Deportiva Alajuelense en temporada inaugural de la Liga CONCACAF Scotiabank: https://t.co/Vjb1pL2ciz,45,22,2017,196452,67,0.03
2244,Olimpia enfrentará a la Liga Deportiva Alajuelense en octavos de final de la Liga de Campeones de CONCACAF. #RugeLeon 💪🏼,105,60,2017,196452,165,0.08
2245,¡Bienvenido a casa profesor Restrepo! https://t.co/KcmnhXvUG8,231,166,2017,196452,397,0.2
2246,El Lic. Ferrari acaba de informar a través de su cuenta de twitter la contratación de Carlos Restrepo como nuevo Director Técnico. #RugeLeon https://t.co/q59wmgLcLV,101,86,2017,196452,187,0.1
2247,Agradecemos al Profesor Vargas por todo el trabajo y esfuerzo brindado para hacer más grande al Club Olimpia. ¡Le deseamos suerte y éxito! https://t.co/8ZWwuj6Caw,237,142,2017,196452,379,0.19
2248,Contrato con Prof Vargas venció el torneo pasado. En reunión de directiva de próxima semana se analizará desempeño y se tomará una decisión.,59,53,2017,196452,112,0.06
2249,"No se pudo. Quedamos fuera.
⚽ Olimpia 2-2 Honduras Progreso 🦁 #RugeLeon https://t.co/tw7Boo5I6o",57,26,2017,196452,83,0.04
2250,"Banco Atlántida, máximo patrocinador de ese sentimiento que llevás en el pecho. #RugeLeon #RemontadaBlanca #JuegoLimpio https://t.co/kdFSYztLU4",38,18,2017,196452,56,0.03
2251,¡Vamos por la REMONTADA blanca! 💪👊 y necesitamos de tu apoyo. ¡SOL GRATIS! 🦁 | #RugeLeón #RemontadaBlanca #JuegoLimpio https://t.co/Wnw49ZRD0w,49,34,2017,196452,83,0.04
2252,¡Vamos por la REMONTADA blanca! 💪👊 y necesitamos de tu apoyo. ¡GRATIS EN SOL! 🦁 | #RugeLeón #RemontadaBlanca #JuegoLimpio https://t.co/dWDrdtjGt7,111,67,2017,196452,178,0.09
2253,"Caímos en el partido de ida  👊...¡a recuperarnos en la vuelta!
⚽ Honduras Progreso 4-2 Olimpia 🦁 #RugeLeon https://t.co/fuDTOjhSKq",52,32,2017,196452,84,0.04
2254,¡Olimpia se queda con las dos vueltas! 👊💪 Olimpia 3-0 Platense 🦁 #RugeLeon https://t.co/Ft5zb7bL0Y,91,44,2017,196452,135,0.07
2255,⚽ | Olimpia vs Platense | ¡Mujeres gratis en Sol y Sombra! (Acompañadas de un hombre) #RugeLeón https://t.co/LUzBM2scPe,50,27,2017,196452,77,0.04
2256,"¡Victoria en Juticalpa! 👊 ...permanecemos en la punta.
⚽ Juticalpa 3-5 Olimpia 🦁 #RugeLeon https://t.co/LGAVpwsUAa",95,42,2017,196452,137,0.07
2257,Firma de autógrafos en Tiendas Mendels de esta tarde. 🖊 | #RugeLeon https://t.co/4PZB5fVlXY,61,21,2017,196452,82,0.04
2258,"🗓 Este jueves:
🖊 Firma de autógrafos
📍 @tiendasmendels - Metromall
#RugeLeon https://t.co/qs7hA7ApUA",50,20,2017,196452,70,0.04
2259,"Olimpia toma la punta del torneo después de la victoria de esta tarde.
⚽️ | Olimpia 3-1 Real España | #RugeLeon https://t.co/JAcEcRyMYk",107,47,2017,196452,154,0.08
2260,"Los albos empataron esta tarde en Tela y permanecen en la segunda posición de la tabla.
⚽ | Vida 2-2 Olimpia #RugeLeon https://t.co/GEhygNZBsX",30,12,2017,196452,42,0.02
2261,"¡No puedes quedarte sin la gloria! 
→ Adquiérelas ya en https://t.co/ygu3mpQiIj y Tiendas Mendels. https://t.co/O38pgdcqMg",65,26,2017,196452,91,0.05
2262,"¡No puedes quedarte sin la gloria! 
 → Adquiérelas ya en https://t.co/ygu3mpQiIj y Tiendas Mendels https://t.co/73YZ1LBNHx",70,36,2017,196452,106,0.05
2263,¡Gracias por identificarte con la nueva piel! 🦁⚽️ Pueden adquirir la nueva indumentaria oficial en Mendels y en https://t.co/ygu3mpQiIj🛍 https://t.co/nHUA0jMTAf,50,16,2017,196452,66,0.03
2264,"Los albos empataron esta tarde en el derbi capitalino y permanecen en la segunda posición de la tabla.
⚽ | Motagua 1-1 Olimpia #RugeLeon https://t.co/0FTpDFKrJd",35,21,2017,196452,56,0.03
2265,Olimpia y Banco Atlántida presentan la nueva piel del león: https://t.co/zH69WN1N7w https://t.co/QWuWARCNrS,62,42,2017,196452,104,0.05
2266,Nueva indumentaria oficial presentada esta noche ante medios de comunicación en las instalaciones de @bancatlan https://t.co/T7Mpw3cBAu,113,67,2017,196452,180,0.09
2267,Olimpia visitó el hospital Gabriela Alvarado de Danli previo al partido de esta tarde ante el Estrella Roja por la Copa Presidente. https://t.co/YCgn71kcbf,30,5,2017,196452,35,0.02
2268,"Olimpia perdió esta tarde en tanda de penales ante el Estrella Roja de Danlí, quedando eliminado de la Copa Presidente. https://t.co/thM2Wdb2ff",21,10,2017,196452,31,0.02
2269,A minutos de iniciar el duelo amistoso ante la Selección de El Salvador en el BBVA Compass Stadium de Houston. #RugeLeon https://t.co/mWVaTF3j9T,40,19,2017,196452,59,0.03
2270,"Firma de autógrafos en Oficinas de Banco Atlántida en Houston, Estados Unidos. https://t.co/AYdEWSACKH",70,34,2017,196452,104,0.05
2271,¡Toda Honduras con la 'H'! 🇭🇳💪🏼 https://t.co/1qkZGH8LIe,40,17,2017,196452,57,0.03
2272,"Olimpia ya se encuentra en Houston, donde el domingo enfrentará en partido amistoso a la Selección de El Salvador. #RugeLeon https://t.co/ItMXMsQqVH",40,24,2017,196452,64,0.03
2273,Olimpia clasificó a cuartos de final de la Copa Presidente al derrotar en penales al Atlético Municipal de Santa Cruz de Yojoa. https://t.co/mSM198hYDv,60,35,2017,196452,95,0.05
2274,Visita al Centro Integral para la Inclusión Escolar (CIPIE) en Santa Cruz de Yojoa. Se compartió y entregó material didáctico a los niños. https://t.co/8sE5Qql9cg,83,53,2017,196452,136,0.07
2275,"Olimpia derrotó esta tarde en casa al Social Sol.
⚽ | Olimpia 3-1 Social Sol #RugeLeon https://t.co/dEgcppl4th",67,23,2017,196452,90,0.05
2276,Un saludo a los campeones de Fuerzas Básicas Olimpistas FBO por su triunfo del pasado sábado 18 de marzo 2017 frente a Pumas de la UNAM. https://t.co/7n50sNTlc0,61,24,2017,196452,85,0.04
2277,"Nos solidarizamos con el jugador Santiago Vergara y su familia, esperamos que recupere pronto su estado de salud. #FuerzaVergara 🙏🏼💪🏼 https://t.co/6MEuA3wgEw",367,240,2017,196452,607,0.31
2278,"Olimpia cayó esta tarde de visita en San Pedro Sula.
⚽ | Marathón 2-0 Olimpia #RugeLeon https://t.co/2Monlw1v9P",15,13,2017,196452,28,0.01
2279,"Olimpia ganó esta tarde y continúa en la segunda posición de la tabla.
⚽ | Olimpia 3-0 Real Sociedad #RugeLeon https://t.co/d1DQ1s9vEm",69,40,2017,196452,109,0.06
2280,"Olimpia cayó derrotado en el Humberto Michelleti y baja a la segunda posición de la tabla.
⚽ | #RugeLeon https://t.co/WcXBZkYOEt",23,10,2017,196452,33,0.02
2281,El león empató esta tarde en Puerto Cortés y finaliza la primera vuelta del Torneo en la punta de la tabla. #RugeLeon https://t.co/4T7B6VoSIL,67,28,2017,196452,95,0.05
2282,"Está tarde en Puerto Cortés ¡A cerrar la primera vuelta!
⚽ | #RugeLeón https://t.co/61VWpyIJTF",48,22,2017,196452,70,0.04
2283,"Olimpia ganó ante el Juventus en partido jugado por la #CopaPresidente en Choluteca.
⚽ | Juventus 1-5 Olimpia| #RugeLeon https://t.co/XdR1Rs5E7P",63,45,2017,196452,108,0.05
2284,"Previo al partido de esta tarde por la Copa Presidente, Olimpia realizó una visita de solidaridad al Hospital del Sur, Choluteca. #RugeLeon https://t.co/uX6ym0nG24",59,33,2017,196452,92,0.05
2285,Ya pueden disfrutar de todas las fotos 📷 del Olimpia 3-2 Juticalpa en nuestra página de Facebook: https://t.co/7ZHRI9mWg6 https://t.co/62bxyHRcW6,49,16,2017,196452,65,0.03
2286,"Olimpia ganó esta tarde y recuperó la primera posición de la tabla.
⚽ | Olimpia 3-2 Juticalpa  #RugeLeon https://t.co/NVWWp3VyRW",81,32,2017,196452,113,0.06
2287,Este domingo los albos juegan en casa y ¡CUENTAN CON TU APOYO! #RugeLeón https://t.co/4xR9IpzLmV,61,35,2017,196452,96,0.05
2288,"Olimpia salió con gran victoria del Morazán.
⚽ | Real España 1-3 Olimpia #RugeLeon https://t.co/isguQPKFGL",125,60,2017,196452,185,0.09
2289,El león cuenta con tu aliento. Real España ha designado SOL SUR del Morazán para nuestra hinchada. En la cancha y en las gradas #JuegoLimpio https://t.co/0GAyMYQsy2,65,32,2017,196452,97,0.05
2290,Donis Escober fue operado con éxito de una fractura múltiple del pómulo derecho. Esperamos tenerlo de regreso en 3 semanas. #ÁnimoDonis https://t.co/zyClTInEzo,81,48,2017,196452,129,0.07
2291,"¡Gran goleada en el Nacional!
⚽ | Olimpia 7-1 Vida #RugeLeon https://t.co/yas5nwjqMa",132,70,2017,196452,202,0.1
2292,"Empate en el Nacional.
 ⚽ | Olimpia 2-2 Motagua #RugeLeon https://t.co/N4D1TSV7Xj",75,28,2017,196452,103,0.05
2293,"Tres puntos más. Los leones consiguieron otro triunfo en Olanchito.
⚽ | Social Sol 0-1 Olimpia #RugeLeon https://t.co/4IOIPz3HaV",70,31,2017,196452,101,0.05
2294,Esta noche el león luchará en Olanchito por continuar en la punta de la tabla de posiciones | #RugeLeón https://t.co/Z1fm3DYkQ0,47,25,2017,196452,72,0.04
2295,¡Ya tenemos precios para el duelo ante Motagua del próximo domingo! ⚽️ #RugeLeon https://t.co/WhbzBU2GUT,43,30,2017,196452,73,0.04
2296,"Gran triunfo en el Nacional.
 ⚽ | Olimpia 3-2 Marathón #RugeLeon https://t.co/LwjAjuLFD7",95,49,2017,196452,144,0.07
2297,"Cuando Motagua gana un título, ¿Cuántos lleva el Olimpia? | La columna del Dr Elmer López en ... https://t.co/KPxgwCvTsU https://t.co/GAt4XvfHcS",52,33,2017,196452,85,0.04
2298,El león vuelve a casa para enfrentar el clásico nacional ¡CONTAMOS CON TU APOYO!  #RugeLeón https://t.co/52GRpiPXUd,73,43,2017,196452,116,0.06
2299,"Los leones avanzan en la Copa Presidente.
 ⚽ | San Rafael 0-5 Olimpia https://t.co/SaeG45wqUk",73,43,2017,196452,116,0.06
2300,"Walter Ariel García, argentino de 32 años arribó hoy para reforzar la defensa central del club. ¡Le deseamos éxito! https://t.co/RMI2iKs3OI",135,92,2017,196452,227,0.12
2301,"Derrota en Tocoa.
 ⚽ | Real Sociedad 2-0 Olimpia https://t.co/G947Hka3Sa",20,25,2017,196452,45,0.02
2302,En esta segunda jornada nos toca de visita ¡VAMOS CON TODO! | #RugeLeón https://t.co/OCITNhoi0L,41,28,2017,196452,69,0.04
2303,"Les compartimos ""Una tarde con Jorge Bran"": https://t.co/n41GrTAhvB https://t.co/FWMq8EWzfm",52,24,2017,196452,76,0.04
2304,Nueva directiva para el período 2017-2019. Será liderada por el Lic. José Rafael Ferrari y nuestro Presidente Honorario Juan Ferrera. https://t.co/mo0eugohBP,83,62,2017,196452,145,0.07
2305,"¡Excelente arranque para los leones! 
⚽ | Olimpia 5-2 Honduras Progreso https://t.co/DfpfVpUq9s",146,76,2017,196452,222,0.11
2306,"¡Iniciamos el torneo en casa!
 ⚽ | Olimpia vs Honduras El Progreso 
📅 | Domingo 08 de enero | 4:00 pm
#RugeLeon https://t.co/PQWNn9DaT0",95,40,2017,196452,135,0.07
2307,"¡Mañana 28 de diciembre! #RugeLeón
Estadio Carlos Miranda de Comayagua (4:00 pm)
Clausura 2017 | Pre-Temporada | Olimpia vs Real España https://t.co/7MuC0bDFMD",52,25,2016,196452,77,0.04
2308,Brayan Josue V. Moya Bienvenido al Olimpia #RugeLeón https://t.co/qTZ0HfrWGO,122,59,2016,196452,181,0.09
2309,"Felicidades #RugeLeón Luis Garrido recibido premio Muhammed Ali por su Espíritu de lucha. 
Otorgado por UNIVISION. https://t.co/8KvkjbXXJw",187,106,2016,196452,293,0.15
2310,#RugeLeón Inicia la pretemporada https://t.co/7BDv5Ut8gB,67,30,2016,196452,97,0.05
2311,El Club Olimpia lamenta la triste noticia que carro cisterna acaba con la vida de futbolista del Olimpia reservas https://t.co/T8c9IXCBKW https://t.co/jjRiX61Kg0,68,50,2016,196452,118,0.06
2312,"Gracias por acompañarnos incondicionalmente, la mejor afición. #RugeLeón https://t.co/pZvaE9zvNT",75,27,2016,196452,102,0.05
2313,"¡Empatamos en Tegucigalpa! 
Semifinal | Olimpia (1-1) Motagua
Estadio Nacional, Tegucigalpa #RugeLeón https://t.co/NSwFntqSr1",32,12,2016,196452,44,0.02
2314,"¡La cita es HOY Domingo! #RugeLeón
Estadio Nacional de Tegucigalpa (4:00 pm)
Apertura 2016 | Semifinal | Olimpia vs Motagua
#JuegoLimpioHON https://t.co/rUvksut1Qk",37,30,2016,196452,67,0.03
2315,"¡Este domingo #PoneteLaBlanca! #RugeLeón
Estadio Nacional de Tegucigalpa (4:00 pm)
Semifinal | Olimpia vs Motagua https://t.co/ygu3mpQiIj https://t.co/PTOEogSdBl",42,27,2016,196452,69,0.04
2316,"¡LOS PRECIOS PARA EL PARTIDO! 
Estadio Nacional de Tegucigalpa (4:00 pm)
Semifinal | Olimpia vs Motagua #RugeLeón https://t.co/rfIIiyIElE",55,49,2016,196452,104,0.05
2317,"Olimpia vs Motagua (4 pm) 4/DIC
Apertura 2016 | Semifinal | #RugeLeón
Estadio Nacional de Tegucigalpa https://t.co/UpynHCo9tO",27,14,2016,196452,41,0.02
2318,"¡Perdimos en Tegucigalpa! 
Semifinal | Motagua (1-0) Olimpia
Estadio Nacional, Tegucigalpa #RugeLeón https://t.co/V4YsNFpqet",25,18,2016,196452,43,0.02
2319,"¡La cita es este jueves! #RugeLeón
Estadio Nacional de Tegucigalpa (7:30 pm)
Apertura 2016 | Semifinal | Motagua vs Olimpia https://t.co/8UbasxTjKC",61,27,2016,196452,88,0.04
2320,Comunicado Oficial | Nota de Duelo @ChapecoenseReal https://t.co/1saveHBttN,118,101,2016,196452,219,0.11
2321,En @CDOlimpia nos solidarizamos con el dolor que embarga a la familia del club brasileño @ChapecoenseReal https://t.co/u1zsfeW6oM,204,225,2016,196452,429,0.22
2322,"Motagua vs Olimpia (1/Dic) 7:30 pm
Apertura 2016 | Semifinal | #RugeLeón
Estadio Nacional de Tegucigalpa https://t.co/GlI7DFtHfr",56,26,2016,196452,82,0.04
2323,"¡Perdimos en El Progreso! 
Jornada 18 | Honduras Progreso (2-0) Olimpia
Estadio Humberto Micheletti, El Progreso #RugeLeón https://t.co/dXklEQREfP",23,15,2016,196452,38,0.02
2324,"¡La cita es este sábado! #RugeLeón
Estadio Micheletti de El Progreso (3 pm)
Jornada 18 | Honduras Progreso vs Olimpia https://t.co/x4wiNb1TM8",67,29,2016,196452,96,0.05
2325,"¡Ganamos en Tegucigalpa! 
Jornada 17 | Olimpia (3-0) Marathon
Estadio Nacional, Tegucigalpa #RugeLeón https://t.co/m1tbfYiMBq",112,46,2016,196452,158,0.08
2326,"¡LOS PRECIOS PARA EL PARTIDO! 
Estadio Nacional de Tegucigalpa (7 pm)
Jornada 17 | Olimpia vs Marathon #RugeLeón https://t.co/QrqRfVAwa8",37,18,2016,196452,55,0.03
2327,"¡La cita es MAÑANA sábado! 
Estadio Nacional de Tegucigalpa (7 pm)
Jornada 17 | Olimpia vs Marathon #RugeLeón https://t.co/N0vZFTtXxw",46,30,2016,196452,76,0.04
2328,"¡Ganamos en Juticalpa! 
Jornada 16 | Juticalpa (1-2) Olimpia
Estadio de Juan Ramón Breve #RugeLeón https://t.co/1dOtdkQvsb",80,47,2016,196452,127,0.06
2329,"¡La cita es HOY miércoles! (6:30 pm)
Estadio Juan Ramón Breve Vargas de Juticalpa
Jornada 16 | Juticalpa vs Olimpia #RugeLeón https://t.co/bdSBleBt1C",53,27,2016,196452,80,0.04
2330,"Se acabó Octubre y dejaremos de usar el rosa, pero nuestro compromiso con la campaña sigue intacto. ¡tu si la puedes seguir usando! https://t.co/JTqsqp7FXw",108,52,2016,196452,160,0.08
2331,"¡Ganamos en Tegucigalpa! 
Jornada 15 | Olimpia (1-0) Real Sociedad
Estadio Nacional de Tegucigalpa #RugeLeón https://t.co/IwDilUCIE2",60,18,2016,196452,78,0.04
2332,"¡La cita es HOY domingo! 
Estadio Nacional de Tegucigalpa (4 pm)
Jornada 15 | Olimpia vs Real Sociedad #RugeLeón https://t.co/aESAwmIwYf",53,23,2016,196452,76,0.04
2333,"¡LOS PRECIOS PARA EL DOMINGO! 
Estadio Nacional de Tegucigalpa (4:00 pm)
Jornada 15 | Olimpia vs Real Sociedad #RugeLeón https://t.co/wear5QnP39",50,28,2016,196452,78,0.04
2334,En este mes nos unimos a @FUNHOCAM_HON para luchar contra el cáncer Adquierela en @tiendasmendels o en https://t.co/ygu3mpyHjJ https://t.co/svIiI8wTzm,29,11,2016,196452,40,0.02
2335,"¡Empatamos en Tegucigalpa! 
Jornada 14 | Motagua (1-1) Olimpia
Estadio Nacional de Tegucigalpa #RugeLeón https://t.co/DerV9PEbyx",51,20,2016,196452,71,0.04
2336,"¡La cita es MAÑANA domingo! 
Estadio Nacional de Tegucigalpa (4 pm)
Jornada 14 | Motagua vs Olimpia #RugeLeón https://t.co/NrIAWZIbCq",89,39,2016,196452,128,0.07
2337,"¡Empatamos en Tegucigalpa! 
CONCACAF | Olimpia (4-4) Pachuca
Estadio Nacional de Tegucigalpa #RugeLeón https://t.co/WI1YsFPVCn",113,47,2016,196452,160,0.08
2338,"¡La cita es MAÑANA miércoles! 
Estadio Nacional de Tegucigalpa (8 pm)
CONCACAF | Olimpia vs Pachuca #RugeLeón https://t.co/qhy5AphecW",75,46,2016,196452,121,0.06
2339,"¡LOS PRECIOS PARA EL MIÉRCOLES! 
Estadio Nacional de Tegucigalpa (8:00 pm)
CONCACAF | Olimpia vs Pachuca #RugeLeón https://t.co/32OhnLQrWv",96,65,2016,196452,161,0.08
2340,"Olimpia vs Pachuca
CONCACAF | LIGA DE CAMPEONES
Estadio Nacional, TGU #RugeLeón https://t.co/5OsIg8xv53",29,14,2016,196452,43,0.02
2341,"¡Ganamos en Tegucigalpa! 
Jornada 13 | Olimpia (3-1) Vida
Estadio Nacional de Tegucigalpa #RugeLeón https://t.co/9O9sQ3QXQN",80,37,2016,196452,117,0.06
2342,"¡LOS PRECIOS PARA EL SÁBADO! 
Estadio Nacional de Tegucigalpa (7:00 pm)
Jornada 13 | Olimpia vs Vida #RugeLeón https://t.co/zZ58bumH8h",42,18,2016,196452,60,0.03
2343,"Olimpia vs Vida
Apertura 2016 | Jornada 13
Estadio Nacional, TGU #RugeLeón https://t.co/d9UYAyBZ54",24,7,2016,196452,31,0.02
2344,"¡Perdimos en San Pedro Sula! 
Jornada 12 | Real España (3-2) Olimpia
Estadio Morazán de San Pedro Sula #RugeLeón https://t.co/m9LcME6Vgw",36,21,2016,196452,57,0.03
2345,"¡La cita es este MIÉRCOLES! 
Estadio Morazan de San Pedro Sula (7 pm)
Jornada 12 | Real España vs Olimpia #RugeLeón https://t.co/QHLsbEByRU",70,27,2016,196452,97,0.05
2346,"NOS PODEMOS LA CAMISETA
Adquierela en tiendas Mendels o en www.LaNuevaBlanca.con y paga con Tarjeta o MoneyGram https://t.co/t7VTb5y5tI",45,19,2016,196452,64,0.03
2347,"Vídeo Resumen #RugeLeón
Jornada 11 | Olimpia (3-1) Platense
Estadio Nacional de Tegucigalpa https://t.co/gsb38mz9Hr",50,24,2016,196452,74,0.04
2348,"¡Ganamos en Tegucigalpa! 
Jornada 11 | Olimpia (3-1) Platense
Estadio Nacional de Tegucigalpa #RugeLeón https://t.co/AKjeFrPfsz",90,37,2016,196452,127,0.06
2349,"En este mes de Octubre, nos unimos a @funhocam para luchar contra el cáncer de mama. ¡Ganemos juntos esta batalla! https://t.co/rJxCd2TzlH https://t.co/OGBDvWveff",74,54,2016,196452,128,0.07
2350,"¡La cita es MAÑANA domingo! 
Estadio Nacional de Tegucigalpa (400 pm)
Jornada 11 | Olimpia vs Platense #RugeLeón https://t.co/Aeui7U1BIN",51,25,2016,196452,76,0.04
2351,"Vídeo Resumen #RugeLeón
CONCACAF | Police United F.C. (1-5) Olimpia 
Estadio F.F.B. Football Field en Belmopán
https://t.co/U44AI8NCsV",28,11,2016,196452,39,0.02
2352,"¡Ganamos en Belice! #RugeLeón
CONCACAF | Police United F.C. (1-5) Olimpia 
Estadio F.F.B. Football Field en Belmopán (6:00 pm) https://t.co/SqWqnzUeEZ",70,42,2016,196452,112,0.06
2353,"¡La cita es MAÑANA en Belice! 
Estadio F.F.B. Football Field en Belmopán (6:00 pm)
CONCACAF | Police United F.C. vs Olimpia #RugeLeón https://t.co/pW61baBpoJ",42,28,2016,196452,70,0.04
2354,"¡La cita es este JUEVES en Belice! 
Estadio F.F.B. Football Field en Belmopán (6:00 pm)
CONCACAF | Police United F.C. vs Olimpia #RugeLeón https://t.co/cgZQEGVGnC",55,25,2016,196452,80,0.04
2355,"Video Resumen #RugeLeón
Jornada 10 | Social Sol (1-2) Olimpia 
Estadio San Jorge de Olanchito, Yoro
https://t.co/tBRakGVhtF",18,4,2016,196452,22,0.01
2356,"¡Ganamos en Olanchito! 
Jornada 10 | Social Sol (1-2) Olimpia
Estadio San Jorge de Olanchito #RugeLeón https://t.co/6hurlTCUSd",73,45,2016,196452,118,0.06
2357,"¡La cita es HOY sábado! 
Estadio San Jorge de Olanchito (7:00 pm)
Jornada 10 | Social Sol vs Olimpia #RugeLeón https://t.co/13FARj93PK",29,15,2016,196452,44,0.02
2358,"¡La cita es mañana sábado! 
Estadio San Jorge de Olanchito (7:00 pm)
Jornada 10 | Social Sol vs Olimpia #RugeLeón https://t.co/Mr67QVVxM9",47,14,2016,196452,61,0.03
2359,"Video Resumen #RugeLeón
Jornada 9 | Olimpia (2-0) Honduras de El Progreso
Estadio Nacional de Tegucigalpa https://t.co/VvdMNrIxR7",16,5,2016,196452,21,0.01
2360,"¡Ganamos en Tegucigalpa! 
Jornada 9 | Olimpia (2-0) Honduras de El Progreso
Estadio Nacional de Tegucigalpa #RugeLeón https://t.co/aELURjiuE3",83,50,2016,196452,133,0.07
2361,"¡LOS PRECIOS PARA HOY! 
Estadio Nacional Tegucigalpa (7 pm) #RugeLeón
Jornada 9 | Olimpia vs Honduras de El Progreso https://t.co/Yf8ZPoandI",33,12,2016,196452,45,0.02
2362,"¡La cita es mañana miércoles! (7 pm)
Estadio Nacional de Tegucigalpa #RugeLeón
Jornada 9 | Olimpia vs Honduras de El Progreso https://t.co/ptbgyb6N2E",58,30,2016,196452,88,0.04
2363,"¡Viste con orgullo!, adquiéralas en nuestra tienda online https://t.co/rJxCd2BYu9 indumentaria oficial 2016 #RugeLeón https://t.co/4tCLvNBuV7",36,17,2016,196452,53,0.03
2364,"Olimpia vs Honduras de El Progreso
Apertura 2016 | Jornada 9 #RugeLeón
Estadio Nacional de Tegucigalpa https://t.co/YYTRJy3S6u",42,17,2016,196452,59,0.03
2365,"¡Perdimos en San Pedro Sula! 
Jornada 8 | Marathon (2-0) Olimpia
Estadio Yankel Rosenthal #RugeLeón https://t.co/1cTfI5z2uB",26,18,2016,196452,44,0.02
2366,"¡La cita es HOY sábado! 3:30 pm
Estadio Yankel Rosenthal, SPS #RugeLeón
Jornada 8 | Marathol vs Olimpia https://t.co/ApyS46Q3jT",49,19,2016,196452,68,0.03
2367,"¡La cita es este sábado! 3:30 pm
Estadio Yankel Rosenthal, SPS 
Jornada 8 | Marathol vs Olimpia #RugeLeón https://t.co/GiwKDsBdt2",52,33,2016,196452,85,0.04
2368,Pocos equipos pueden darse el lujo de haber tenido a tres o más hermanos. leer https://t.co/LkmAPtGXGD https://t.co/fxHCY37irO,38,15,2016,196452,53,0.03
2369,Gracias a los que nos acompañaron! #RugeLeón Ven y celebra los goles así cómo ellos en el próximo partido en casa! https://t.co/BT3Qu8wHyg,63,15,2016,196452,78,0.04
2370,"¡Ganamos en Tegucigalpa! 
Jornada 7 | Olimpia (2-0) Juticalpa
Estadio Nacional de Tegucigalpa #RugeLeón https://t.co/ZirneXF51e",114,48,2016,196452,162,0.08
2371,"¡La cita es HOY en TGU! 4 pm
Estadio Nacional, Tegucigalpa #RugeLeón Jornada 7 | Olimpia vs Juticalpa https://t.co/hBFW1QoiDJ",46,20,2016,196452,66,0.03
2372,"¡LOS PRECIOS PARA MAÑANA! 
Estadio Nacional Tegucigalpa (4 pm)
Jornada 7 | Olimpia vs Juticalpa #RugeLeón https://t.co/cWmVSeM8pR",27,25,2016,196452,52,0.03
2373,"Vídeo Resumen #RugeLeón
Jornada 5 | Olimpia (3-1) Motagua
Estadio Nacional de Tegucigalpa https://t.co/IJOrsBLpqs",86,54,2016,196452,140,0.07
2374,"¡Ganamos en Tegucigalpa! 
Jornada 5 | Olimpia (3-1) Motagua
Estadio Nacional de Tegucigalpa #RugeLeón https://t.co/KfVsdTP5OD",138,108,2016,196452,246,0.13
2375,"¡LOS PRECIOS PARA HOY! 
Estadio Nacional Tegucigalpa (7 pm)
Jornada 5 | Olimpia vs Motagua #RugeLeón https://t.co/ghx4h6opy9",30,17,2016,196452,47,0.02
2376,Adquiéralas en nuestra tienda online https://t.co/rJxCd2TzlH indumentaria oficial 2016 #RugeLeón https://t.co/WtiWKNL1ci,29,9,2016,196452,38,0.02
2377,"¡La cita es mañana ! (7 pm)
Estadio Nacional, Tegucigalpa #RugeLeón
Apertura 2016 | Jornada 5 | Olimpia vs Motagua https://t.co/vuqRBA0kiH",72,44,2016,196452,116,0.06
2378,"Video Resumen #RugeLeón
Jornada 6 | Real Sociedad (2-3) Olimpia
Estadio Francisco Martinez Duron, Tocoa

https://t.co/i0ijmjhv0I",21,8,2016,196452,29,0.01
2379,"¡Ganamos en Tocoa! #RugeLeón
Jornada 6 | Real Sociedad (2-3) Olimpia
Estadio Francisco Martinez Duron, Tocoa https://t.co/QuDAZ3NVS5",93,45,2016,196452,138,0.07
2380,Todos en el @CDOlimpia le deseamos mucha suerte a @Alberthelis17 en esta nueva etapa @rayados #RugeLeón https://t.co/JgweXGe3Nw,150,91,2016,196452,241,0.12
2381,"#RugeLeón
¡La cita es este domingo!
Estadio Francisco Martinez, Tocoa 
Jornada 4 | Real Sociedad vs Olimpia https://t.co/h8ffRqII8o",54,26,2016,196452,80,0.04
2382,"¡Hoy todos apoyado a la H! 
Juegos Olímpicos Río 2016 (10 am)
Semifinal | HONDURAS vs NIGERIA https://t.co/JK0030H3Y3",31,20,2016,196452,51,0.03
2383,"Video Resumen (4to Gol) #RugeLeón
CONCACAF | Olimpia (4-0) Police United FC https://t.co/Ghi2b3Xhhe",22,13,2016,196452,35,0.02
2384,"Video Resumen (3er Gol) #RugeLeón
CONCACAF | Olimpia (4-0) Police United FC https://t.co/9cIAqLaMyU",12,8,2016,196452,20,0.01
2385,"Video Resumen (2do Gol) #RugeLeón
CONCACAF | Olimpia (4-0) Police United FC https://t.co/w5RIPcJHQX",12,7,2016,196452,19,0.01
2386,"Video Resumen (1er Gol) #RugeLeón
CONCACAF | Olimpia (4-0) Police United FC https://t.co/hUfnrOPSqD",18,13,2016,196452,31,0.02
2387,"¡Hoy todos apoyado a la H! 
Semifinal | HONDURAS vs BRASIL
Juegos Olímpicos Río 2016 (10 am) https://t.co/rExRWH5MFR",24,25,2016,196452,49,0.02
2388,"#RugeLeón
¡Ganamos en Tegucigalpa! 
CONCACAF | Olimpia (4-0) Police United FC https://t.co/YwcBLV7S9t",61,49,2016,196452,110,0.06
2389,"¡LOS PRECIOS PARA HOY! 
Estadio Nacional Tegucigalpa (8:06 pm)
CONCACAF | Olimpia vs Police United FC https://t.co/d88IhIUUau",22,14,2016,196452,36,0.02
2390,"¡La cita es hoy (8 pm)!
Estadio Nacional de Tegucigalpa
@CONCACAF | Olimpia vs Police United FC #RugeLeón https://t.co/HLevWsHqwm",29,36,2016,196452,65,0.03
2391,"Esta noche necesitamos de tu apoyo sin el uso de pólvora, CONCACAF nos puede sancionar #RugeLeón https://t.co/Q9upCk0QGz",41,25,2016,196452,66,0.03
2392,"Vídeo (2do Gol)
Jornada 4 | Vida (2-2) Olimpia https://t.co/csbAt9tnbB",13,7,2016,196452,20,0.01
2393,"Vídeo (1er Gol)
Jornada 4 | Vida (2-2) Olimpia https://t.co/HCIO6zzg7A",16,6,2016,196452,22,0.01
2394,"#RugeLeón
¡Empatamos en La Ceiba! 
Jornada 4 | Vida (2-2) Olimpia https://t.co/sBgZXwhpiX",41,23,2016,196452,64,0.03
2395,"¡La cita es hoy en La Ceiba!
Estadio Municipal Ceibeño (7 pm)
Jornada 4 | Vida vs Olimpia #RugeLeón https://t.co/MwYB5kll0h",41,36,2016,196452,77,0.04
2396,Nuestro futbolista @alberthelis17 habló para @FenafuthOrg aquí las declaraciones:   https://t.co/kY7oh8wEAg,24,11,2016,196452,35,0.02
2397,"Mañana, Sábado #RugeLeón
Apertura 2016 | Jornada 4 | Vida vs Olimpia 
Estadio Municipal Ceibeño https://t.co/zMUUmWOenZ",29,18,2016,196452,47,0.02
2398,"Vídeo del Gol del gane
Jornada 3 | Olimpia (1-0) Real España 
¡Ganamos en Tegucigalpa! #RugeLeón https://t.co/zvKAuvbsLF",72,35,2016,196452,107,0.05
2399,"#RugeLeón
¡Ganamos en Tegucigalpa! 
Jornada 3 | Olimpia (1-0) Real España https://t.co/qYohJUbSRu",66,41,2016,196452,107,0.05
2400,¿Ya te vas para el estadio? Puedes pasar por @tiendasmendels y vestir la piel de los leones esta noche. #RugeLeón https://t.co/YvlmyceBwz,36,11,2016,196452,47,0.02
2401,"¡LOS PRECIOS PARA HOY! 
Estadio Nacional Tegucigalpa (7 pm)
Jornada 3 | Olimpia vs Real España #RugeLeón https://t.co/eGGwcmD0HP",34,24,2016,196452,58,0.03
2402,"Olimpia vs Real España
Apertura 2016 | Jornada 3
Estadio Nacional, Tegucigalpa https://t.co/nmkViqfzbd",36,28,2016,196452,64,0.03
2403,"#RugeLeón ¡Todo buen Olimpista viste con orgullo!, adquiéralas en nuestra tienda online https://t.co/rJxCd2TzlH https://t.co/Ka9DMRGsEG",63,32,2016,196452,95,0.05
2404,"#RugeLeón
¡Empatamos en Puerto Cortes! 
Jornada 2 | Platense (2-2) Olimpia https://t.co/LLPZYG5jHu",41,19,2016,196452,60,0.03
2405,"¡La cita es esté domingo!
Estadio Excelsior Puerto Cortes (3 pm)
Jornada 2 | Platense vs Olimpia #RugeLeón https://t.co/KfltM7bj2g",50,24,2016,196452,74,0.04
2406,"¡Perdimos en Hidalgo! #RugeLeón
Jornada 1 | Pachuca (1-0) Olimpia https://t.co/SSaw7N0f8b",29,26,2016,196452,55,0.03
2407,Ayer el Olimpia llegó al estadio de Hidalgo en Pachuca (México) https://t.co/2vnigWJDgu,77,41,2016,196452,118,0.06
2408,"El Olimpia llegó a México, ahora va rumbo a Pachuca Hidalgo https://t.co/EmK6tZEX8n",61,38,2016,196452,99,0.05
2409,"¡La cita es este martes en México! 
Estadio Hidalgo, Pachuca (8 pm)
CONCACAF | Pachuca MX vs Olimpia HN https://t.co/BVji2DWRdq",99,70,2016,196452,169,0.09
2410,"Resumen en Vídeo #RugeLeón
Jornada 1 | Olimpia (3-2) Social Sol

https://t.co/g90XvkTJB2",10,8,2016,196452,18,0.01
2411,"Jornada 1 | Olimpia (3-2) Social Sol
(3-2) Gol de Bayron Méndez 53'  #RugeLeón https://t.co/GdmcDPAHqf",38,24,2016,196452,62,0.03
2412,"Jornada 1 | Olimpia (3-2) Social Sol
(2-2) Gol de Michael Chirinos 49'  #RugeLeón https://t.co/9s23QFJMqh",23,16,2016,196452,39,0.02
2413,"Jornada 1 | Olimpia (3-2) Social Sol
(1-2) Gol de Michael Chirinos 42'  #RugeLeón https://t.co/zzW7WW0aTC",23,23,2016,196452,46,0.02
2414,"¡Ganamos en TGU! #RugeLeón
Jornada 1 | Olimpia (3-2) Social Sol https://t.co/CoCeTTi1kp",64,47,2016,196452,111,0.06
2415,Bienvenido Marcelo Canales #RugeLeón https://t.co/SXYr0qxApU,60,54,2016,196452,114,0.06
2416,"¡La cita es hoy en Tegucigalpa! 
Estadio Nacional Tiburcio Carías (7 pm)
Jornada 1 | Olimpia vs Social Sol https://t.co/UNGHRqOh3Y",42,37,2016,196452,79,0.04
2417,"Bienvenido Guillermo Sierra, Colombiano (defensor) 26 años https://t.co/sL96zBwPnc",37,31,2016,196452,68,0.03
2418,"¡Los precios! 29 Jul
Estadio Nacional (7 pm)
Jornada 1 | Olimpia vs Social Sol https://t.co/x4zkzbLGDs",25,14,2016,196452,39,0.02
2419,"Olimpia vs Social Sol
Clausura 2016 | Jornada 1
Estadio Nacional, Tegucigalpa https://t.co/VHYVFjyMbj",22,10,2016,196452,32,0.02
2420,"Bienvenido John Henry Sánchez! Colombiano de 21 años, volante del Atlético Nacional. https://t.co/NKB1UDi6fn",65,59,2016,196452,124,0.06
2421,"Llega al club John Henry Sánchez! Colombiano de 21 años, volante del Atlético Nacional. Viene de jugar en el Alianza Petrolera de Colombia",38,22,2016,196452,60,0.03
2422,"Vídeo Resumen 
Olimpia (3-1) Real Sociedad
¡2do GOL DEL OLIMPIA! @carlocostly31 https://t.co/I4XAywYHrx",39,18,2016,196452,57,0.03
2423,"Vídeo Resumen 
Olimpia (3-1) Real Sociedad
¡1er GOL DEL OLIMPIA! @carlocostly31 https://t.co/Ciway6t80e",37,22,2016,196452,59,0.03
2424,"Olimpia (3-1) Real Sociedad
¡Ganamos el 3er Lugar » Copa Presidente!
Estadio, José Adrián Cruz de Villanueva, Cortes.",36,19,2016,196452,55,0.03
2425,"Olimpia vs Real Sociedad
3er Lugar » Copa Presidente 22/07/16 (7 pm) 
Estadio José Adrián Cruz de Villanueva, Cortes https://t.co/uBopw9eMp8",50,18,2016,196452,68,0.03
2426,"Doble Amistoso » @lepaeraFc vs Olimpia 
6:30 pm Sábado 16/06 en Lepaera
3:00 pm Domingo 17/06 en Gracias https://t.co/VdIgHNa833",32,19,2016,196452,51,0.03
2427,"¡SOMOS SÚPERCAMPEONES DE HONDURAS! #RugeLeón
Honduras Progreso (3-3) Olimpia | Penales (4-5) #Súpercopa2016
Humberto Micheletti, El Progreso",78,66,2016,196452,144,0.07
2428,"Amistoso internacional
Olimpia (HN) vs ALIANZA (ES)
Sábado 23 de Julio / 2016 (7:30 pm)
Estado de New Jersey, EUA https://t.co/1xhWgqe09l",65,43,2016,196452,108,0.05
2429,"Amistoso » Honduras Progreso vs Olimpia 
Viernes 8 de Julio / 2016 (7:15 pm) 
Estadio, Humberto Micheletti, Yoro https://t.co/Qr807VifUF",29,22,2016,196452,51,0.03
2430,"Amistoso » Honduras Progreso vs Olimpia 
Viernes 8 de Julio / 2016 (7:15 pm) 
Estadio, Humberto Micheletti, Yoro https://t.co/sGaDG9xVYw",26,10,2016,196452,36,0.02
2431,"Amistoso » Honduras Progreso vs Olimpia 
Viernes 8 de Julio / 2016 (7:15 pm) 
Estadio, Humberto Micheletti, Yoro https://t.co/9dmFu0w0O2",11,4,2016,196452,15,0.01
2432,"Amistoso » Juticalpa vs Olimpia 
Domingo 3 de Julio / 2016 (2 pm) 
Estadio, Juan Ramón Breve, Juticalpa https://t.co/rLaQWg2Gdr",36,16,2016,196452,52,0.03
2433,"Amistoso » Juticalpa vs Olimpia 
Domingo 3 de Julio / 2016 (2 pm) 
Estadio, Juan Ramón Breve, Juticalpa https://t.co/qjdZTfFpik",29,18,2016,196452,47,0.02
2434,Todo Olimpista se identifica con la piel oficial #PoneteLaBlanca cómpralas en https://t.co/rJxCd2TzlH #RugeLeón https://t.co/S0nE9fcovm,52,41,2016,196452,93,0.05
2435,Primer entrenamiento de los Leones #RugeLeón https://t.co/83wC7EkYkf,38,19,2016,196452,57,0.03
2436,Primer entrenamiento de los Leones #RugeLeón https://t.co/0hzpCZRN9X,27,19,2016,196452,46,0.02
2437,"¡FELIZ ANIVERSARIO LEONES! 
Son 104 años de historia #RugeLeón https://t.co/ZBLLnl6C9R",115,123,2016,196452,238,0.12
2438,"El @CDOlimpia es 1 lugar en el Ranking al desplazar al @SaprissaOficial. 
Leer https://t.co/v3BmkjWshz #RugeLeón https://t.co/1f9NrlslTG",58,69,2016,196452,127,0.06
2439,Adquiere la camiseta de los campeones ingresando a https://t.co/ocM7CpNzIL no te quedes sin tu camiseta #RugeLeón https://t.co/IJdWpeFkET,35,21,2016,196452,56,0.03
2440,"Inicia el mes con piel de campeón, adquirí en https://t.co/rJxCd2TzlH la versión manga larga #RugeLeón https://t.co/YogBLPjyxA",43,21,2016,196452,64,0.03
2441,"¿Qué te parece? Así quedó el GRUPO E, Pachuca (Mex),  Police United (Bel) y Olimpia (HN) #RugeLeón https://t.co/v4XnyAnfWO",75,38,2016,196452,113,0.06
2442,Representantes del Club en el sorteo  comparten con los representantes de Tigres de México https://t.co/xbuSQsgnVZ,52,25,2016,196452,77,0.04
2443,Sorteo de la SCL 2016-2017 https://t.co/kjoO0ywr6X,29,24,2016,196452,53,0.03
2444,Banco Atlántida hombro a hombro con el Olimpia ¡La 30 es nuestra! ¡Felicidades #Camp30nes! #RugeLeón https://t.co/qYQHdWVCAJ,43,16,2016,196452,59,0.03
2445,Gracias https://t.co/11EyniImW9,34,22,2016,196452,56,0.03
2446,Gracias !! https://t.co/2FG3W8pdmX,55,39,2016,196452,94,0.05
2447,La 30 https://t.co/j0glxUYnMb,106,81,2016,196452,187,0.1
2448,Celebración de la Junta Directiva con los jugadores y el cuerpo técnico https://t.co/9xmX25K8ZH,99,44,2016,196452,143,0.07
2449,"Felicidades a todos los aficionados por el apoyo !!
Ayer rugió el Nacional  #RugeLeón #Camp30nes #PoneteLaBlanca https://t.co/FNWpbjCwvg",98,82,2016,196452,180,0.09
2450,"SOMOS CAMPEONES #RugeLeón #PoneteLaBlanca
Adquiere la camiseta https://t.co/rJxCd2BYu9 #Camp30nes #VamosPorLa30 https://t.co/KgQ6F5BzwH",81,67,2016,196452,148,0.08
2451,"¡SOMOS CAMPEONES DE HONDURAS! #RugeLeón
OLI (3-1) RSO | Global (5-1) #PoneteLaBlanca
 #VamosPorLa30 #Camp30nes https://t.co/3kmyY3YosZ",207,253,2016,196452,460,0.23
2452,"¡Llegó el día! #PoneteLaBlanca
Real Sociedad vs Olimpia #RugeLeón
Estadio Nacional, TGU #VamosPorLa30 https://t.co/phtHCwEcDm",67,46,2016,196452,113,0.06
2453,"Hoy se jugamos la Gran Final #RugeLeón
Real Sociedad vs Olimpia #PoneteLaBlanca
Estadio Nacional, TGU #VamosPorLa30 https://t.co/4414Yubqvy",56,34,2016,196452,90,0.05
2454,"Hoy a partir de (10 am)
Taquillas 7 y 8 venderán  SOL 
Taquilla 5 venderán SOMBRA y SILLA
#PonteLaBlanca #RugeLeon https://t.co/vvmHAXGgrW",45,20,2016,196452,65,0.03
2455,El domingo #PoneteLaBlanca juntos pintaremos el Nacional y a toda Honduras de blanco #RugeLeón Juntos #VamosPorLa30 https://t.co/25Wk4NmXU8,90,73,2016,196452,163,0.08
2456,Ellos se van a palco a ver al amado León Comunicarse 2280-1010 @bancatlan  #RugeLeón #VamosPorLa30 #PoneteLaBlanca https://t.co/NdUkYb2KKX,8,2,2016,196452,10,0.01
2457,"Entrenamiento para la Gran Final de Vuelta Est. Nacional, TGU
#PonteLaBlanca y juntos #VamosPorLa30 #RugeLeón https://t.co/7rCIYdQGbB",24,21,2016,196452,45,0.02
2458,"Entrenamiento para la Gran Final de Vuelta
Est. Nacional, TGU
#PonteLaBlanca y juntos #VamosPorLa30 #RugeLeón https://t.co/jd1e0xuUQc",16,8,2016,196452,24,0.01
2459,"Entrenamiento para la Gran Final de Vuelta
Est. Nacional, TGU
#PonteLaBlanca y juntos #VamosPorLa30 #RugeLeón https://t.co/s0Y763j5Ic",18,6,2016,196452,24,0.01
2460,En taquillas 7 y 8 se venderá entradas para Sol y en la taquilla 5 las entradas para Sombra y Silla mañana a las 10 Am Estadio Nacional.,17,12,2016,196452,29,0.01
2461,"Este domingo #PoneteLaBlanca
#RugeLeón Juntos #VamosPorLa30 

ver video https://t.co/RwUHEOhmBD https://t.co/KT4fWfWjC4",58,19,2016,196452,77,0.04
2462,#PoneteLaBlanca Participa en la rifa de una camiseta del Club Olimpia Deportivo ingresa en: https://t.co/bJ2zsOmmLh https://t.co/gXKeUCpiDI,22,14,2016,196452,36,0.02
2463,"Este domingo #PoneteLaBlanca
#RugeLeón Juntos #VamosPorLa30 

ver video https://t.co/RwUHEOhmBD https://t.co/hCuO1C7wXM",23,22,2016,196452,45,0.02
2464,"Los precios para la Gran Final 4 pm
Olimpia vs @CDRealSociedad TGU
#PoneteLaBlanca y juntos #VamosPorLa30 #RugeLeón https://t.co/rEYNcZsOvg",13,9,2016,196452,22,0.01
2465,"Este domingo #PoneteLaBlanca
#RugeLeón Juntos #VamosPorLa30 
ver video ▶ https://t.co/RwUHEOyY0d https://t.co/zod6UF5Dhe",41,46,2016,196452,87,0.04
2466,Postales | @CDRealSociedad  (1-2) Olimpia https://t.co/jh6Ic43LQ7,14,11,2016,196452,25,0.01
2467,Postales | @CDRealSociedad  (1-2) Olimpia https://t.co/celmus0eCG,12,5,2016,196452,17,0.01
2468,Postales | @CDRealSociedad (1-2) Olimpia https://t.co/S6ambVKy2u,16,5,2016,196452,21,0.01
2469,"Envía OLIMPIA al 0024 para participar en la promoción más grande de todos los tiempos: ""UN BOLETO PARA SIEMPRE""",17,1,2016,196452,18,0.01
2470,"Recuerden acreditarse en las oficinas del club, asi tendran acceso al estadio info https://t.co/BbpbhZZjFI https://t.co/ygT1F9DFoZ",20,8,2016,196452,28,0.01
2471,"Los precios para la Gran Final 4 pm
Olimpia vs @CDRealSociedad  TGU
#PonteLaBlanca y juntos #VamosPorLa30 #RugeLeón https://t.co/J9EcMIygHY",19,25,2016,196452,44,0.02
2472,"Esté domingo #PonteLaBlanca juntos #VamosPorLa30
Cómprala en https://t.co/rJxCd2TzlH ó en @tiendasmendels #RugeLeón https://t.co/ltVg8QUAzi",28,18,2016,196452,46,0.02
2473,"¡Ganamos en Tocoa! #RugeLeón
@CDRealSociedad (1-2) Olimpia
#VamosPorLa30",65,66,2016,196452,131,0.07
2474,"Gol del Real Sociedad #RugeLeón
Real Sociedad (1-2) Olimpia
#VamosPorLa30 https://t.co/EOItSW9Y4H",22,12,2016,196452,34,0.02
2475,"¡GOOOOOL DEL OLIMPIA! #VamosPorLa30 Real Sociedad (0-2) Olimpia #RugeLeón
@carlocostly31 https://t.co/ONyuRLQd2m",62,43,2016,196452,105,0.05
2476,Te invitamos a participar #VamosPorLa30 para información @bancatlan  #ViveLaGranFinalEnPalco https://t.co/A64GREXsKK,14,6,2016,196452,20,0.01
2477,"¡GOOOOOL DEL OLIMPIA! #RugeLeón
Real Sociedad (0-1) Olimpia 
Álex López al '34 
Estadio Francisco Martínez, Tocoa https://t.co/4e0BOiIg21",52,26,2016,196452,78,0.04
2478,Te invitamos a participar #VamosPorLa30 para más información ingresar en @bancatlan #ViveLaGranFinalEnPalco https://t.co/10X9QsiPsB,14,5,2016,196452,19,0.01
2479,Si aun no has visto el #ElToquedeRely ► Olimpia un sentimiento que se pasa de generación en generación ►https://t.co/mMJQ1Q6ABI,23,18,2016,196452,41,0.02
2480,"Postales de la semifinal #JuegoLimpio
Olimpia (2-0) Motagua, Global (2-0)
#RugeLeón Estadio Nacional, TGU https://t.co/1Qm4E1kZ3i",31,10,2016,196452,41,0.02
2481,"Postales de la semifinal #JuegoLimpio
Olimpia (2-0) Motagua, Global (2-0)
#RugeLeón Estadio Nacional, TGU https://t.co/MXvQRnG8v5",10,5,2016,196452,15,0.01
2482,"Postales de la semifinal #JuegoLimpio
Olimpia (2-0) Motagua, Global (2-0)
#RugeLeón Estadio Nacional, TGU https://t.co/CFcNamicmY",19,6,2016,196452,25,0.01
2483,"Postales de la semifinal #JuegoLimpio
Olimpia (2-0) Motagua, Global (2-0)
#RugeLeón Estadio Nacional, TGU https://t.co/45OEhgGpgX",18,8,2016,196452,26,0.01
2484,"Gran Final de Ida #RugeLeón 
@CDRealSociedad vs Olimpia (2 pm)
Estadio Francisco Martínez Durón, Tocoa 
#JuegoLimpio https://t.co/cS9divpdpW",45,31,2016,196452,76,0.04
2485,"2do gol de @romellq31 Olimpia (2-0) @MOTAGUAcom
#RugeLeón #JuegoLimpio Estadio Nacional, TGU https://t.co/EvQ4T5X4Pl",28,27,2016,196452,55,0.03
2486,"1er gol y baile de @carlocostly31 Olimpia (1-0) @MOTAGUAcom
#RugeLeón #JuegoLimpio Estadio Nacional, TGU https://t.co/9I7e9kcJJ0",60,43,2016,196452,103,0.05
2487,"¡Ganamos en el Nacional!
Olimpia (2-0) Motagua, Global (2-0)
#RugeLeón Estadio Nacional, TGU https://t.co/fYf4aVGZsd",111,106,2016,196452,217,0.11
2488,"Hoy se juega la semifinal de vuelta (4 pm)
Olimpia vs Motagua #RugeLeón
Estadio Nacional, Tegucigalpa https://t.co/5VcJTs7zh1",39,18,2016,196452,57,0.03
2489,"Olimpista no te quedes en casa, esta tarde tenemos que pintar #DeBlancoElNacional 🇳🇱 tu apoyo es fundamental para nuestro triunfo.",52,36,2016,196452,88,0.04
2490,¡La hora del juego se acerca! Olimpista este domingo tenemos que pintar #DeBlancoElNacional 🇳🇱 💪🏼 https://t.co/QITJGt0PRA,49,25,2016,196452,74,0.04
2491,"Los precios para la Semifinal de Vuelta #RugeLeón #DeBlancoElNacional
Olimpia vs Motagua (4 pm) #JuegoLimpio https://t.co/n32bRkFHsP",31,15,2016,196452,46,0.02
2492,Ya estamos más cerca de la 🏆30 necesitamos #DeBlancoElNacional 🇳🇱 para lograr la clasificación a la final. ¡Juntos por la 30! #JuegoLimpio,63,66,2016,196452,129,0.07
2493,"Resumen | @MOTAGUAcom vs @CDOlimpia 
#RugeLeón Video: https://t.co/6qbshmKW0U https://t.co/wp2JboVsMh",6,4,2016,196452,10,0.01
2494,"¡Empatamos en el Nacional!
Motagua (0-0) Olimpia 
#RugeLeón Semifinal de Ida https://t.co/ajB2gYGQKr",17,22,2016,196452,39,0.02
2495,"¿Cuál es tu pronóstico para hoy? Semifinal de ida, @MOTAGUAcom vs OLIMPIA #RugeLeón",15,8,2016,196452,23,0.01
2496,"Hoy se jugará la semifinal de ida, en el Estadio Nacional, Tegucigalpa a las (7 pm) #RugeLeón https://t.co/yvfnPW9OkI",70,38,2016,196452,108,0.05
2497,Todo Olimpista se identifica con la piel oficial #RugeLeón cómpralas en https://t.co/rJxCd2TzlH ó @tiendasmendels https://t.co/6apAjkGvpl,76,25,2016,196452,101,0.05
2498,El Club Olimpia lamenta el fallecimiento del deportista Don Ricardo Taylor QDDG este domingo 8 de mayo 2016 https://t.co/SUstkJMVmt,41,22,2016,196452,63,0.03
2499,"¡Empatamos en Tocoa! Jornada 18
Real Sociedad (0-0) Olimpia #RugeLeón
Terminamos en 1er Lugar con 37 puntos https://t.co/hEGBngyrJL",49,28,2016,196452,77,0.04
2500,Le solicitamos a la @lnphonduras y al @CDRealSociedad #fairplay el día domingo y así garantizar un espectáculo https://t.co/R2CXxtAtim,30,34,2016,196452,64,0.03
2501,"Video resumen https://t.co/npuNapZoMS
Jornada 17 | Olimpia (5-0) Victoria #RugeLeón",9,2,2016,196452,11,0.01
2502,"¡Ganamos en el Nacional! TGU
Jornada 17 | Olimpia (5-0) Victoria #RugeLeón https://t.co/xRur5V5cnZ",42,20,2016,196452,62,0.03
2503,"¡Los precios para hoy miércoles! en Tgu
Jornada 17 | Olimpia vs Victoria (7 pm) https://t.co/2FaZWbUMDY",19,11,2016,196452,30,0.02
2504,"¡Hoy la cita es en el Nacional! en Tgu
Jornada 17 | Olimpia vs Victoria (7 pm) https://t.co/ednEsQYcSN",20,23,2016,196452,43,0.02
2505,Postales del partido que ganamos en el Nacional Jornada 16 | Olimpia (3-0) Platense #RugeLeón https://t.co/Ym9vsqdRsk,30,19,2016,196452,49,0.02
2506,Postales del partido que ganamos en el Nacional Jornada 16 | Olimpia (3-0) Platense #RugeLeón https://t.co/q9iFBCbuqw,19,10,2016,196452,29,0.01
2507,"Nuestro próximo partido Jornada 17
Olimpia vs Victoria #RugeLeon
Estadio Nacional TGU https://t.co/Z9vPHAfqez",25,16,2016,196452,41,0.02
2508,"¡Ganamos en el Nacional! TGU
Jornada 16 | Olimpia (3-0) @PlatenseFC_OFI  #RugeLeón https://t.co/8opJa7F6zl",60,34,2016,196452,94,0.05
2509,"Olimpia vs @PlatenseFC_OFI 
Precios L.30 Sol* L.60 Sombra L.150  Silla
*Niños (-12) años GRATIS/SOL acompañados https://t.co/F9nDdmy1LP",32,19,2016,196452,51,0.03
2510,"Jornada 16 | Olimpia vs @PlatenseFC_OFI (4 pm) 
Estadio Nacional, Tegucigalpa https://t.co/IMYbWq02JY",24,19,2016,196452,43,0.02
2511,"¡Un buen Olimpista se identifica con la indumentaria oficial! 
Adquiere la en  https://t.co/rJxCd2TzlH #RugeLeón https://t.co/XJJKbuCq4K",24,11,2016,196452,35,0.02
2512,#RugeLeón Van 3 partidos que perdemos al hilo ¿De quien crees que sea la culpa?,8,4,2016,196452,12,0.01
2513,"¡No pudimos en el Municipal Ceibeño! 
Jornada 15 | Vida (2-1) Olimpia #RugeLeón",8,6,2016,196452,14,0.01
2514,"¡No pudimos en el Nacional! TGU
Semifinal de la @CopaPresidente 
Olimpia (0-3) @rcdespana 
(1-4) en el global #RugeLeón",15,9,2016,196452,24,0.01
2515,"¡Hoy la cita es en el Nacional 7 pm! TGU
@rcdespana vs Olimpia #RugeLeón
Semifinal | @CopaPresidente https://t.co/qp2MfYpEbY",19,19,2016,196452,38,0.02
2516,Envía OLIMPIA al 0024 Al suscribirte estarás participando en el sorteo de mucho dinero en efectivo y premios https://t.co/Rg3YTJ3X2F,21,10,2016,196452,31,0.02
2517,"¡No pudimos en el Nacional! TGU
Jornada 14 | Olimpia (0-1) @JuticalpaFC  #RugeLeón",22,14,2016,196452,36,0.02
2518,"¡Los precios de la Jornada 14! TGU
Olimpia vs @JuticalpaFC (4:00 pm) #RugeLeón https://t.co/648LRqyKJZ",22,12,2016,196452,34,0.02
2519,"Jornada 14
Olimpia vs @JuticalpaFC 
(4 pm) Estadio Nacional, TGU https://t.co/goSerb0Kt2",27,25,2016,196452,52,0.03
2520,"¡Ganamos en el Morazán! SPS
Jornada 13 | Marathon (0-1) Olimpia #RugeLeón",65,58,2016,196452,123,0.06
2521,"Un buen Olimpista se identifica con la piel oficial #RugeLeón 
Adquiere tu camiseta en https://t.co/rJxCd2TzlH https://t.co/8GIPvus6MK",21,10,2016,196452,31,0.02
2522,"Vídeo Resumen Jornada 12
Motagua (1-4) Olimpia #RugeLeón
https://t.co/2Qio7hMYjD",9,12,2016,196452,21,0.01
2523,"¡Ganamos en el Nacional! 
Motagua (1-4) Olimpia #RugeLeón",101,73,2016,196452,174,0.09
2524,"¿Cual es tu pronostico para el partido de hoy? (7:00 pm) 
Jornada 12 | @MOTAGUAcom vs @CDOlimpia #RugeLeón",16,7,2016,196452,23,0.01
2525,"¡Hoy sábado nos vemos en el Nacional! Tegucigalpa
Jornada 12 | @MOTAGUAcom vs @CDOlimpia (7:00 pm) #RugeLeón https://t.co/63VIEDY6Kd",45,28,2016,196452,73,0.04
2526,"¡Este sábado nos vemos en el Nacional! Tegucigalpa
Jornada 12 | Motagua vs Olimpia (7:00 pm) #RugeLeón https://t.co/kKlKX3rgvU",67,37,2016,196452,104,0.05
2527,"Un buen Olimpista se identifica con la piel oficial #RugeLeón 
Adquiere tu camiseta en https://t.co/rJxCd2TzlH https://t.co/mnvhRfMVWJ",20,12,2016,196452,32,0.02
2528,"La cita es en el Olímpico a las 7 pm
Hoy todos somos #Honduras apoyemos a nuestra selección #RugeLeón https://t.co/WLfw89dxGs",78,38,2016,196452,116,0.06
2529,"¿Cuál crees que sea el resultado de hoy?
#ElSalvador  vs #Honduras  #Rusia2018",8,1,2016,196452,9,0.0
2530,"#RugeLeón Gol de Kevin Álvarez (2-0) minuto 28’
Olimpia (2-2) @ClubHProgreso https://t.co/gKBDnqTy43",16,2,2016,196452,18,0.01
2531,"#RugeLeón Gol de @alberthelis9 (1-0) minuto 7’ 
Olimpia (2-2) @ClubHProgreso https://t.co/CIRqly2JtS",4,1,2016,196452,5,0.0
2532,Resumen | Olimpia (2-2) Honduras Progreso #RugeLeón https://t.co/R6PKBaSeAW,3,2,2016,196452,5,0.0
2533,"¡TERMINÓ! #RugeLeón
Olimpia (2-2) @ClubHProgreso 
Elis (1-0) 7’
Álvarez (2-0) 28’
Acevedo (2-1) 46’
Elvir (2-2) 63’ https://t.co/7UK7vF6TCG",16,9,2016,196452,25,0.01
2534,Niños menores de 12 años GRATIS en SOL acompañados de un adulto. https://t.co/D3HqttC5Ql,14,4,2016,196452,18,0.01
2535,"¡Los precios para hoy! #RugeLeón
Jornada 11 | Olimpia vs Honduras Progreso (4 pm) https://t.co/VY4qqEYfBE",15,9,2016,196452,24,0.01
2536,El regalo de papá está en https://t.co/ygu3mpQiIj https://t.co/fcUtASbFp2,7,5,2016,196452,12,0.01
2537,El mejor legado de un padre a sus hijos es un poco de su tiempo cada día ¡FELIZ DÍA DEL PADRE! #RugeLeón https://t.co/8oXIbtgdZp,45,34,2016,196452,79,0.04
2538,El mejor legado de un padre a sus hijos es un poco de su tiempo cada día ¡FELIZ DÍA DEL PADRE!… https://t.co/3IVlCD1rBi,12,7,2016,196452,19,0.01
2539,Gol de @alberthelis9 | Real España (2-3) Olimpia #RugeLeón https://t.co/8r6vp0jkXn,25,12,2016,196452,37,0.02
2540,Gol de @Lpz10alex | Real España (2-3) Olimpia #RugeLeón https://t.co/4NSd032cX9,29,15,2016,196452,44,0.02
2541,Gol de @CarloCostly31 | Real España (2-3) Olimpia #RugeLeón https://t.co/H7IhlV6wgm,19,14,2016,196452,33,0.02
2542,Video Resumen 10 Jornada | Real España (2-3) Olimpia #RugeLeón https://t.co/hfllbeZE7s,9,4,2016,196452,13,0.01
2543,¡Ganamos en San Pedro! Mira algunas de las imágenes que nos dejó el encuentro en el Olímpico Metropolitano #RugeLeón https://t.co/DqE21m3tAc,22,10,2016,196452,32,0.02
2544,¡Ganamos en San Pedro! Mira algunas de las imágenes que nos dejó el encuentro en el Olímpico Metropolitano #RugeLeón https://t.co/xFiGG7MR9d,30,8,2016,196452,38,0.02
2545,¡Ganamos en San Pedro! Mira algunas de las imágenes que nos dejó el encuentro en el Olímpico Metropolitano #RugeLeón https://t.co/aov7ebU44F,20,10,2016,196452,30,0.02
2546,¡Ganamos en San Pedro! Mira algunas de las imágenes que nos dejó el encuentro en el Olímpico Metropolitano #RugeLeón https://t.co/uwi068De9O,13,5,2016,196452,18,0.01
2547,"¡Ganamos en el Olímpico! #RugeLeón
10 Jornada | @rcdespana (2-3) Olimpia https://t.co/S3PUSqCyPC",55,44,2016,196452,99,0.05
2548,"Un buen Olimpista se identifica con la piel oficial #RugeLeón 
Adquiere tu camiseta en https://t.co/rJxCd2TzlH https://t.co/sw04k2xzPr",46,19,2016,196452,65,0.03
2549,"¡Empatamos en Tegucigalpa! #RugeLeón
9 Jornada | Olimpia (1-1) @CDRealSociedad 
Chirinos (1-0) y Martínez (1-1) https://t.co/qICnOWTosv",16,11,2016,196452,27,0.01
2550,"Esperamos de tu apoyo en el Nacional (4:00 pm), para terminar la primer vuelta con una victoria #RugeLeón https://t.co/EX1HYNv7jV",32,18,2016,196452,50,0.03
2551,"!Ganamos en @CopaPresidente! #RugeLeón
@CDOlimpia (2-1) @ClubHProgreso https://t.co/okdtxGzKBf",46,54,2016,196452,100,0.05
2552,"Los esperamos, con tu apoyo en las gradas el equipo logrará el pase a la semifinal de la @CopaPresidente #RugeLeón https://t.co/OoEkTle0iA",30,16,2016,196452,46,0.02
2553,Esperamos de tu apoyo en el Nacional tenemos que ganar para pasar a la siguiente fase @CopaPresidente #RugeLeón https://t.co/j8QrsQyc2S,29,29,2016,196452,58,0.03
2554,"#RugeLeón Resumen @ClubDepVICTORIA  (0-4) @CDOlimpia Jornada 8
https://t.co/0TBbT2muSk",16,10,2016,196452,26,0.01
2555,"!Ganamos en La Ceiba! #RugeLeón Victoria (0-1) Olimpia 
Bayron (0-1) Quioto (0-2) Will Mejia (0-3) Costly (0-4) https://t.co/WjXjpTTyHZ",40,44,2016,196452,84,0.04
2556,"!Inicio el partido en La Ceiba! 
 Vamos Olimpia #RugeLeón
 ¿CUÁL ES TU PRONÓSTICO? https://t.co/LrSA6lhwZL",15,4,2016,196452,19,0.01
2557,"Esperamos de tu apoyo en La Ceiba, ojalá que a la hora del partido tengamos un buen clima #RugeLeón https://t.co/XONrNYguHL",24,12,2016,196452,36,0.02
2558,Entrenamiento previo al juego contra el Victoria de este 27/02/16 #RugeLeón @ Estadio Nacional… https://t.co/x9qThz2D9b,9,6,2016,196452,15,0.01
2559,Entrenamiento previo al juego contra el Victoria de este 27/02/16 #RugeLeón @ Estadio Nacional… https://t.co/2CFO8h18DE,9,4,2016,196452,13,0.01
2560,Entrenamiento previo al juego contra el Victoria de este 27/02/16 #RugeLeón @ Estadio Nacional… https://t.co/xdOvn7UyYH,6,1,2016,196452,7,0.0
2561,Fotos del entrenamiento previo al juego contra el Victoria de este 27/02/16 #RugeLeón https://t.co/YKTl5LVHfl https://t.co/fc6IspIuyO,9,3,2016,196452,12,0.01
2562,La cita es esté sábado 27 de febrero a las 2:00 pm en el Estadio Municipal de La Ceiba @ Estadio… https://t.co/MeR9caG50Q,8,9,2016,196452,17,0.01
2563,Mañana habrá voluntarios con botellones en las ciudades principales del país para colaborar con esta campaña. https://t.co/fQLISAR5ID,33,22,2016,196452,55,0.03
2564,"Continúa nuestro camino #PorLa30 en el puerto. Olimpista, te esperamos este domingo a las 3:00 PM. #RugeLeón https://t.co/jsDyCVscZL",25,24,2016,196452,49,0.02
2565,¡Así finalizó el partido! Ribereños y leones igualaron a dos goles. Todo se definirá en Tegucigalpa. #Ruge León https://t.co/NqSdV6JcBY,17,13,2016,196452,30,0.02
2566,Minuto 93 | ¡Tarjeta roja para Mayron Flores! Nos quedamos con 9.,2,1,2016,196452,3,0.0
2567,Terminaremos el juego con uno menos. Luis Ordóñez recibe tarjeta roja.,4,3,2016,196452,7,0.0
2568,Minuto 86 | Agotamos los cambios. Entra: Luis Ordóñez; Sale: David Meza.,3,0,2016,196452,3,0.0
2569,Minuto 82 | ¡Gol del Honduras! Alvarado anota en una segunda acción luego de la atajada de Edrick Menjívar. Se empata el partido 2-2.,2,0,2016,196452,2,0.0
2570,Minuto 81 | ¡Penal para el Honduras! Cardona cae en el área y el árbitro sanciona la pena máxima.,4,3,2016,196452,7,0.0
2571,Minuto 73 | ¡GOOOL DEL OLIMPIA! Alberth Elis anota el segundo para los leones con un potente testazo. #RugeLeón https://t.co/YJ9gNRiprL,23,20,2016,196452,43,0.02
2572,Minuto 71 | Se realiza el cuarto cambio en Olimpia. Entra: Alberth Elis; Sale: Roger Rojas.,3,1,2016,196452,4,0.0
2573,Minuto 65 | ¡GOOOOL DEL OLIMPIA! Javier Estupiñán anota el empate. https://t.co/Aj5KVDOOT0,15,19,2016,196452,34,0.02
2574,Minuto 64 | ¡Cerca Olimpia del empate! Rojas nuevamente intentó sin embargo el balón se va desviado.,3,2,2016,196452,5,0.0
2575,Minuto 61 | Tercera modificación por parte de los merengues. Entra: Alejandro Reyes; Sale: Jorge Bengoché.,2,0,2016,196452,2,0.0
2576,"En el medio tiempo, se realizaron dos cambios. Ingresaron: Diego Rodríguez y Mayron Flores; salieron: Rembrandt Flores y Ever Alvarado.",3,0,2016,196452,3,0.0
2577,¡Arranca la segunda mitad! Ya se juega el complemento en la Perla del Úlua. #RugeLeón,2,0,2016,196452,2,0.0
2578,¡Así finalizó la primera mitad en el Humberto Micheletti! Los leones caen 1-0 ante los ribereños. https://t.co/ELfrX6ULUn,3,2,2016,196452,5,0.0
2579,Minuto 34 | ¡Gol del Honduras! Los locales se ponen arriba en el marcador.,1,0,2016,196452,1,0.0
2580,Minuto 25 | ¡Nos salvamos! Edrick Menjívar detiene el disparo que iba con dirección a gol. Se mantiene el empate 0-0.,3,0,2016,196452,3,0.0
2581,Minuto 20 | ¡Cerca Olimpia del primero! Remate de Rojas que pasa a un lado de la portería ribereña.,2,2,2016,196452,4,0.0
2582,¡Ya se juega en El Progreso! Así saltaron los leones a la cancha en la ida de 4tos de final de la Copa Presidente. https://t.co/gXeYYoy9yZ,9,7,2016,196452,16,0.01
2583,"Olimpista, mañana en El Progreso jugamos la Ida de los 4tos de Final con el objetivo de acercarnos al bicampeonato. https://t.co/zO6CRfTk8i",32,30,2016,196452,62,0.03
2584,Unámos a la @salvamivida para devolverle la sonrisa a nuestros niños. ¡Esta batalla la ganamos juntos! https://t.co/9dmRb76idr,13,12,2016,196452,25,0.01
2585,"Luego de vencer al Vida en la J6, los leones vuelven a ser líderes en solitario del Torneo Clausura. #RugeLeón https://t.co/7wkff2cjgV",18,21,2016,196452,39,0.02
2586,Esto son los detalles más destacados del club merengue en la goleada 4-0 ante Vida. #RugeLeón https://t.co/evA5It8Mbk,16,10,2016,196452,26,0.01
2587,Ya puedes ver en nuestro Facebook oficial la galería del Olimpia vs Vida por la J6 del Torneo Clausura. #RugeLeón https://t.co/MZqRmJsuya,17,9,2016,196452,26,0.01
2588,"Una tarde celebrando al amor, rodeados de amigos y con triunfo incluido. ¡A nosotros nos gusta eso! #GraciasOlimpia https://t.co/07hfDYb1QG",52,28,2016,196452,80,0.04
2589,Así finalizó el juego por la jornada 6 en una tarde en donde nos afianzamos en el liderato de la tabla. #RugeLeón https://t.co/PaTGqbGNgh,46,35,2016,196452,81,0.04
2590,Porque un día te enamoraste de estos colores y ahora los llevás en la piel.¡Celebramos un amor de toda la vida! https://t.co/B5ifW3XUHh,50,38,2016,196452,88,0.04
2591,"En el mes de la lucha contra el cáncer infantil, te compartimos los síntomas para detectar este mal. https://t.co/4H6E2lnJmU",21,22,2016,196452,43,0.02
2592,"Este domingo tienes una cita en el Nacional. ¡Olimpista, no te quedes en casa! https://t.co/RuezeCXu5S",25,26,2016,196452,51,0.03
2593,¿Tienes Instagram? Búscanos como @cdolimpia y sigue al más popular del país en todas las redes sociales. https://t.co/lPj3tsvMHN,18,9,2016,196452,27,0.01
2594,¿Pasarás el día del amor y la amistad con el amor de tu vida? https://t.co/8w2gPHI1jc,22,22,2016,196452,44,0.02
2595,¡Este domingo te esperamos para celebrar este amor! A partir de las 4 PM ante Vida para continuar el camino #PorLa30 https://t.co/3JdEHCVRAK,28,24,2016,196452,52,0.03
2596,¡Esta batalla la ganamos juntos! Puedes adquirir tu camiseta en Tiendas Mendel's y en https://t.co/fjGZH8XoOn. https://t.co/yC2LzLzjgU,22,20,2016,196452,42,0.02
2597,"Luego de 5 jornadas disputadas, así se encuentra la tabla de posiciones del Clausura 2016. #RugeLeón https://t.co/25KCbVonW9",14,15,2016,196452,29,0.01
2598,"Acciones de la jornada 5 ante Juticalpa, ingresa a nuestro sitio oficial en Facebook para observar el álbum completo https://t.co/Qa7YJIyfNu",25,4,2016,196452,29,0.01
2599,¡Fin del partido! Esta tarde caímos 2-1 ante Juticalpa en el Juan Ramón Brevé Vargas. https://t.co/SpesLbyGLS,7,18,2016,196452,25,0.01
2600,Min. 90 | ¡Tarjeta roja para Alberth Elis! Terminamos jugando con 9 hombres.,0,1,2016,196452,1,0.0
2601,Min. 85 | ¡Cerca los locales del tercero! Remate que se va por arriba de la portería de Donis Escober!,1,0,2016,196452,1,0.0
2602,Min. 78 | ¡Nos quedamos con 10! Tarjeta roja para Ever Alvarado.,1,2,2016,196452,3,0.0
2603,Min. 59 | Tarjeta amarilla para Ever Alvarado por parte del conjunto merengue.,0,1,2016,196452,1,0.0
2604,Min. 56 | ¡Agotamos los cambios! Entra: Michaell Chirinos; Sale: Romell Quioto.,2,4,2016,196452,6,0.0
2605,¡Arranca el complemento! Ya se juega la segunda mitad en Juticalpa. #RugeLeón,2,2,2016,196452,4,0.0
2606,En el medio tiempo se realiza el segundo cambio en Olimpia. Entra: Carlo Costly; Sale: Mayron Flores.,1,7,2016,196452,8,0.0
2607,¡Finalizó el primer tiempo! Los leones caen momentáneamente en el Juan Ramón Brevé ante los canecheros. #RugeLeón https://t.co/RVOVzpuRtZ,6,5,2016,196452,11,0.01
2608,Min. 45 | ¡Gol del Juticalpa! Esdras Padilla anota el 2-1 a favor de los canecheros.,1,5,2016,196452,6,0.0
2609,Min. 34 | ¡Se salvó Olimpia! Donis Escober desvía un disparo que tenía dirección a gol.,2,0,2016,196452,2,0.0
2610,Min. 20 | Segundo amonestado por parte del conjunto blanco. Oscar Salas recibe cartón amarillo.,0,5,2016,196452,5,0.0
2611,Min. 19 | Primer cambio merengue. Entra: Jhonny Palacios; Sale: Oliver Morazán.,3,8,2016,196452,11,0.01
2612,Min. 16 | ¡Gol de Juticalpa! Bernárdez anota el empate para los locales.,1,8,2016,196452,9,0.0
2613,Min. 2 | ¡GOOOL DEL OLIMPIA! Alberth Elis de derecha la manda a guardar para abrir el marcador. #RugeLeón,19,26,2016,196452,45,0.02
2614,Min. 1 | Primer amonestado del juego. Tarjeta amarilla para Oliver Morazán.,0,5,2016,196452,5,0.0
2615,¡Se movió el balón en el Juan Ramón Brevé! Leones y canecheros ya juegan en Juticalpa. #RugeLeón,9,5,2016,196452,14,0.01
2616,¡Así salimos esta tarde! Estos son los once leones que van en busca de los tres puntos en Juticalpa. #RugeLeón https://t.co/AAvlsydrZ0,17,22,2016,196452,39,0.02
2617,"En el mes de la lucha contra el cáncer infantil, te compartimos los #12Síntomas para detectar este mal. https://t.co/OJOiVZZtKc",28,28,2016,196452,56,0.03
2618,¡Este domingo nos vamos a Juticalpa! Continuamos nuestro camino #PorLa30 en tierras olanchanas. #RugeLeón https://t.co/xvyoi4Tqxu,65,22,2016,196452,87,0.04
2619,Así está la tabla de posiciones luego de la cuarta jornada. ¡Seguimos en la cima! https://t.co/hPZPy9p8NA,41,29,2016,196452,70,0.04
2620,Ya puedes ver el álbum del clásico Olimpia vs Marathón en nuestro Facebook oficial. https://t.co/Ei7TlVeAgk,26,17,2016,196452,43,0.02
2621,¡Finalizó el partido! Olimpia y Marathón empatan 0-0 y se reparten puntos en el Nacional. https://t.co/zoecpYdnW5,14,10,2016,196452,24,0.01
2622,Min. 90+1 | Alberth Elis dispara y el balón se va desviado. ¡Estuvo cerca el conjunto merengue!,4,5,2016,196452,9,0.0
2623,Min. 85 | ¡Muy cerca Marathón de anotar! Remate de Reyes que se va apenas desviado.,3,0,2016,196452,3,0.0
2624,Min. 75 | ¡Nos salvamos! Noel Valladares en dos tiempos y en la línea de gol evita el gol visitante.,5,2,2016,196452,7,0.0
2625,Min. 73 | Tarjeta amarilla para Javier Estupiñán.,3,0,2016,196452,3,0.0
2626,"¡Se viene ""El Cocherito"" a la cancha! Al minuto 63, Olimpia realiza su último cambio. Entra: Carlo Costly; Sale; Mayron Flores.",10,14,2016,196452,24,0.01
2627,Min. 61 | ¡Cerca Olimpia! Romell Quioto remata y el arquero verde evita el primero.,3,1,2016,196452,4,0.0
2628,Min. 57 | Cartulina amarilla para Romell Quioto. Segunda amonestación para los blancos.,1,0,2016,196452,1,0.0
2629,Min. 56 | Segundo cambio olimpista. Entra: Alex López; Sale: Bayron Méndez.,4,0,2016,196452,4,0.0
2630,Min. 50 | Primer cambio merengue. Entra: Javier Estupiñán; Sale: Carlos Will Mejía.,2,0,2016,196452,2,0.0
2631,Min. 47 | Primera amarilla para Olimpia. Amonestado Mayron Flores.,1,0,2016,196452,1,0.0
2632,Min. 46 | ¡Nos salvamos! Tiro libre de Mario Berríos que se estrella en el horizontal.,1,0,2016,196452,1,0.0
2633,¡Arranca el complemento! Ya se juega la segunda mitad de este clásico. #RugeLeón,3,3,2016,196452,6,0.0
2634,Medio Tiempo | Olimpia y Marathón empatan 0-0 en el Nacional. #RugeLeón https://t.co/lV1Fu2FYlj,2,1,2016,196452,3,0.0
2635,Min. 43 | ¡Muy cerca los leones! Israel Fonseca probó de cabeza pero el balón se fue por encima de la portería verde.,1,1,2016,196452,2,0.0
2636,Min. 42 | ¡Se salva la visita! Cerca Olimpia de anotar el primero del partido.,4,1,2016,196452,5,0.0
2637,Min. 29 | Se mantiene el 0-0 en el Nacional. #RugeLeón,4,0,2016,196452,4,0.0
2638,Min. 15 | ¡Nuevamente Quioto! El atacante merengue remató y el arquero desvia a tiro de esquina.,5,5,2016,196452,10,0.01
2639,Min. 9 | ¡Cerca Olimpia del primero! Potente remate de Romell Quioto que se va apenas desviado.,7,2,2016,196452,9,0.0
2640,¡Se movió la redonda! Comienza en clásico en el Nacional. #RugeLeón,7,7,2016,196452,14,0.01
2641,¡Así sale Olimpia en este clásico! Estos son los once leones que Héctor Vargas manda a la cancha. #RugeLeón https://t.co/TSlEt5xNAg,20,25,2016,196452,45,0.02
2642,"Olimpista, esta tarde te esperamos en el Nacional. ¡Llenemos la casa! https://t.co/O6x92UjTxr",55,42,2016,196452,97,0.05
2643,Ya puedes adquirir tu camiseta conmemorativa contra el cáncer infantil en Tiendas Mendel's y https://t.co/fjGZH8XoOn https://t.co/Yuqw6QSMnI,27,18,2016,196452,45,0.02
2644,"Este domingo nos enfrentamos a Marathón en busca de mantener el buen paso en el Clausura. ¡Olimpista, te esperamos! https://t.co/qKQnFMJdx9",36,27,2016,196452,63,0.03
2645,"¡Olimpista, esta es la camiseta que usaremos en el mes de Febrero! Nos unimos a la lucha contra el cáncer infantil. https://t.co/aVZFmmwLxP",100,81,2016,196452,181,0.09
2646,https://t.co/KTl2h3oRWv,15,11,2016,196452,26,0.01
2647,¡Nos volvemos a unir! Mañana a las 3 PM se presenta la camiseta conmemorativa a la lucha contra el cancer infantil. https://t.co/b5ZbWsOWLc,55,43,2016,196452,98,0.05
2648,¡Éste domingo te queremos allí una vez más! Olimpia Vs Marathón Precios: Sol: 40. L Sombra: 80. L y Silla: 150. L. https://t.co/XSZmDNGRQD,48,43,2016,196452,91,0.05
2649,"A ellas que alegran nuestros días, que sienten lo mismo por estos colores. ¡A las mujeres de Honduras, felicidades! https://t.co/KfKu8Ma6xR",52,23,2016,196452,75,0.04
2650,En nuestra galería en Facebook encuentras las mejores postales de nuestra victoria ante Motagua. ¡Revive el clásico! https://t.co/7qCavcsK8z,33,17,2016,196452,50,0.03
2651,Así se encuentra la tabla de posiciones luego de la victoria en el clásico. ¡Vamos Olimpia! https://t.co/iqrRJv6o19,44,31,2016,196452,75,0.04
2652,Min. 90+5 | ¡Finalizó el partido! Olimpia derrota 1-0 al Motagua y logra sumar 3 valiosos puntos #RugeLeón,35,44,2016,196452,79,0.04
2653,Min. 86 | ¡GOOOL DEL OLIMPIA! Ever Alvarado con el primero para los leones #RugeLeón,38,41,2016,196452,79,0.04
2654,Min. 84 | ¡PENAL PARA EL OLIMPIA! Esta es la oportunidad que hemos esperado #RugeLeón,20,9,2016,196452,29,0.01
2655,Min. 46 | ¡Se movió el balón! Ya se juega el complemento en el Estadio Nacional de Tegucigalpa. #RugeLeón,5,3,2016,196452,8,0.0
2656,¿Como crees que terminará este partido contra el Motagua?,5,6,2016,196452,11,0.01
2657,"Min. 45+3 | ¡Finalizó el primer tiempo! Olimpia empata 0-0 contra el Motagua, ambos con oportunidad, en un partido muy complicado #RugeLeón",10,7,2016,196452,17,0.01
2658,Min. 30 | Jugamos un complicado partido en el Estadio Nacional de Tegucigalpa. #RugeLeón,6,2,2016,196452,8,0.0
2659,Min. 15 | Seguimos empatando (0 - 0) en el Estadio Nacional de Tegucigalpa. #RugeLeón,7,2,2016,196452,9,0.0
2660,¡Se movió el balón! Ya se juega el primer tiempo en el Estadio Nacional de Tegucigalpa. #RugeLeón,7,9,2016,196452,16,0.01
2661,Estos son los 11 leones que el DT Vargas enviará a la cancha hoy contra el Motagua. #RugeLeón https://t.co/IarueBDzY4,16,10,2016,196452,26,0.01
2662,"Envía GOL al 5005 y gana con Interacel en este clásico. ¡3 camisetas originales y 10,000 lempiras en efectivo! https://t.co/j85Ugw8HgG",11,1,2016,196452,12,0.01
2663,"Olimpista, tu cita es mañana en el Nacional a partir de las 4:00 PM. #RugeLeón https://t.co/YDsCDxTrQf",35,37,2016,196452,72,0.04
2664,"Envía GOL al 5005 y gana con Interacel en este clásico. ¡3 camisetas originales y 10,000 lempiras en efectivo! https://t.co/fhArKHuwgC",24,5,2016,196452,29,0.01
2665,Vive el Clásico con las nuevas camisetas del Club Olimpia de venta en Tiendas Mendel's y en https://t.co/tBrEmP6s1S. https://t.co/FiSL3xrMsH,18,10,2016,196452,28,0.01
2666,"¡Este domingo es de clásico! Olimpista, no te quedés en casa y disfrutemos de esta fiesta. #RugeLeón https://t.co/kaRrHTQye2",31,24,2016,196452,55,0.03
2667,Que el fútbol sirva para unir y que el clásico sirva para disfrutar. ¡No más violencia en los estadios de Honduras! https://t.co/BEbRHP1NfH,54,60,2016,196452,114,0.06
2668,Hoy se cumplen quince años de aquellla mágica e histórica noche. ¡Que lindo es ser olimpista! https://t.co/fmGw384ib8,187,157,2016,196452,344,0.18
2669,¡Ya tenemos rival en Copa Presidente! Nos enfrentaremos a Honduras de El Progreso en Cuartos de Final. #RugeLeón https://t.co/0bAwIJrDMG,54,35,2016,196452,89,0.05
2670,Así están las posiciones del Clausura 2016. Llegamos al #ClásicoCapitalino con el objetivo de ser líderes. #RugeLeón https://t.co/rHc2VxQJZE,40,14,2016,196452,54,0.03
2671,El día de hoy llegamos a un acuerdo con Alexander López quien vuelve a vestirse de blanco. #BienvenidoAlexLópez https://t.co/3WbVcS8Vb7,104,89,2016,196452,193,0.1
2672,¡Finalizó el partido! Olimpia derrota 0-2 al Honduras de El Progreso y logra sumar 3 valiosos puntos #RugeLeón https://t.co/ALO2FFViMa,89,78,2016,196452,167,0.09
2673,Min. 85 | ¡GOOOL DEL OLIMPIA! Alberth Elis con el segundo para los leones. #RugeLeón,23,25,2016,196452,48,0.02
2674,Min. 72 | Tercer cambio en el Olimpia ingresa Kevin Alvarez y sale Carlos Will Mejia #RugeLeón,7,5,2016,196452,12,0.01
2675,Min. 71 | Segundo cambio en el Olimpia ingresa Oscar Salas y sale Bayron Méndez #RugeLeón,5,3,2016,196452,8,0.0
2676,"Min. 53 | Primer cambio del Olimpia, ingresara Romel Quioto, sale Roger Rojas",6,3,2016,196452,9,0.0
2677,¡Se movió el balón! Ya se juega el complemento en el Humberto Micheletti. #RugeLeón,12,3,2016,196452,15,0.01
2678,Finaliza el primer tiempo y el Olimpia gana (0-1) al Honduras del Progreso en el Estadio Humberto Micheletti https://t.co/40cDmupywt,33,21,2016,196452,54,0.03
2679,Min. 33 | ¡GOOOL DEL OLIMPIA! Everl Alvarado con el primero para los leones. https://t.co/aGp6A89Kut,32,24,2016,196452,56,0.03
2680,"Olimpia sale con: Valladares, de Souza, Alvarado, Fonseca, Mejía, Morazán, Méndez, Flores, Mejía, Rojas y Elis. #RugeLeón",12,14,2016,196452,26,0.01
2681,Este sábado visitamos al Honduras de El Progreso en nuestra primera salida del Clausura 2016. #RugeLeón https://t.co/crVjCcqHWk,40,30,2016,196452,70,0.04
2682,¡Finalizó el partido! Olimpia derrota 0-6 al Valle FC y logra la clasificación a cuartos de final. #RugeLeón https://t.co/anrmUQoenJ,39,42,2016,196452,81,0.04
2683,Min. 88 | ¡GOOOL DEL OLIMPIA! Javier Estupiñán desde el punto penal anota el sexto para los leones. https://t.co/N0w2E32bFQ,13,11,2016,196452,24,0.01
2684,Min. 87 | ¡Penal a favor de Olimpia! Mayron Flores es derribado en el área y provoca la pena máxima.,4,1,2016,196452,5,0.0
2685,Min. 79 | ¡GOOOL DEL OLIMPIA! Javier Estupiñán anota el quinto gol del juego. https://t.co/dQo9HcLFKp,7,13,2016,196452,20,0.01
2686,Min. 77 | Agotamos nuestros cambios. José Pinto ingresó en lugar de Michaell Chirinos.,5,0,2016,196452,5,0.0
2687,Min. 76 | ¡GOOOL DEL OLIMPIA! Kevin Álvarez la manda a guardar y pone el 0-4 a favor de los leones. https://t.co/m2Nd8762UY,9,8,2016,196452,17,0.01
2688,"Ya se encuentra en el terreno de juego Diego Rodríguez, quien ingresó en lugar de Romell Quioto.",5,0,2016,196452,5,0.0
2689,Min. 69 | ¡Cerca Valle FC del primero! Potente remate que desvía Edrick Menjívar.,1,0,2016,196452,1,0.0
2690,"Olimpia realizó su tercer cambio. Ingresó Oscar Salas, Rembrandt Flores abandonó el terreno de juego.",3,0,2016,196452,3,0.0
2691,Min. 62 | ¡GOOOL DEL OLIMPIA! Elmer Güity con un potente derechazo anota el tercero del juego. https://t.co/Vts2KUDzAm,5,8,2016,196452,13,0.01
2692,Min. 61 | ¡Volvió a llegar Olimpia! Jorge López remata de derecha pero el arquero local evita el tercero.,4,0,2016,196452,4,0.0
2693,Min. 51 | ¡Cerca Olimpia del tercero! Peligrosa llegada de los merengues que estuvo cerca de concretar Javier Estupiñán.,3,0,2016,196452,3,0.0
2694,¡Se movió el balón! Ya se juega el complemento en el José Elías Nazar. #RugeLeón,6,2,2016,196452,8,0.0
2695,Se realizan dos cambios antes de comenzar la segunda mitad: Mayron Flores por  Oliver Morazán y Alejandro Reyes por Jorge Bengoché.,5,4,2016,196452,9,0.0
2696,"Al finalizar el primer tiempo, Olimpia vence 0-2 al local Valle FC. https://t.co/GvsNPUuOFa",9,12,2016,196452,21,0.01
2697,Min 45. | Tiro libre de Romell Quioto que pasa elevado de la portería visitante.,1,2,2016,196452,3,0.0
2698,Min. 43 | Volvió a llegar Valle FC sin embargo Edrick Menjívar controla sin problemas.,2,0,2016,196452,2,0.0
2699,Min. 30| ¡Nos salvamos del primero! Edrick Menjívar evita el descuento para los locales.,7,0,2016,196452,7,0.0
2700,¡GOOOL DEL OLIMPIA! Jorge Bengoché marca el segundo para los leones y aumenta la ventaja. https://t.co/yBRg4lhAM0,17,25,2016,196452,42,0.02
2701,¡GOOOL DEL OLIMPIA! Al minuto 16 Romell Quioto hace el 0-1 a favor de los merengues. https://t.co/FVWAslIAhZ,14,13,2016,196452,27,0.01
2702,Min. 14| Tarjeta amarilla para Jorge Bengoché.,3,2,2016,196452,5,0.0
2703,¡Ya se juega en el José Elías Nazar! Estos son los 11 leones que Héctor Vargas envió a la cancha. #RugeLeón https://t.co/uKLfAVZB2q,15,12,2016,196452,27,0.01
2704,Este miércoles continua la actividad en la Copa Presidente. Visitamos al Valle FC a partir de las 4:00 PM. #RugeLeón https://t.co/ACxE9HVAyc,21,31,2016,196452,52,0.03
2705,Una de las postales que nos dejó el triunfo 3-1 sobre Real España. #RugeLeón https://t.co/7bUUUJtwB0,30,12,2016,196452,42,0.02
2706,Las postales que nos dejó el triunfo 3-1 sobre R.España y arranque con pie derecho en busca de la corona número 30. https://t.co/dXo7dC181i,25,25,2016,196452,50,0.03
2707,¡Finalizó el partido! Olimpia vence 3-1 al Real España y arranca con pie derecho el Clausura 2016. #RugeLeón https://t.co/jUk1EWyDcI,58,62,2016,196452,120,0.06
2708,Se adicionan 3 minutos de tiempo agregado. Olimpa sigue arriba en el marcador 3-1.,7,4,2016,196452,11,0.01
2709,"Minuto 84: Olimpia realiza su último cambio. Entra: Rembrandt Flores, Sale: Carlos Will Mejía.",5,1,2016,196452,6,0.0
2710,"Minuto 74: Michaell Chirinos anotaba el cuarto gol para los leones, sin embargo la jugada se invalidó por fuera de juego.",5,5,2016,196452,10,0.01
2711,"Minuto 72: Segundo cambio en Olimpia. Entra: Elmer Güity, Sale: Bayron Méndez.",3,3,2016,196452,6,0.0
2712,"Minuto 61: Se realizó el primer cambio en Olimpia. Salió: Roger Rojas, Entró: Michaell Chirinos.",5,5,2016,196452,10,0.01
2713,¡GOOOOL DEL OLIMPIA! Alberth Elis al 60 anota el 3-1 a favor de los leones. https://t.co/VRDOuAfEDa,19,30,2016,196452,49,0.02
2714,Minuto 47: Gol del Real España. Nicolás Cardozo desde el punto penal anota el 2-1.,1,1,2016,196452,2,0.0
2715,Minuto 47: El árbitro indica falta penal a favor del España.,0,3,2016,196452,3,0.0
2716,¡Comenzó la segunda mitad! Ya se juega el complemento en el Nacional. Olimpia vence 2-0 al Real España. #RugeLeón,4,5,2016,196452,9,0.0
2717,¡Fin de la primera parte! Los leones se van al descanso ganando 2-0 al Real España. #RugeLeón https://t.co/Frc8t0h4sd,10,9,2016,196452,19,0.01
2718,Minuto 32: ¡Se salva Olimpia del descuento! Delgado probó de distancia y el balón se estrelló en el horizontal.,0,2,2016,196452,2,0.0
2719,Minuto 30: ¡Cerca Olimpia del tercero! Potente remate de Bayron Méndez que despeja el arquero aurinegro.,2,2,2016,196452,4,0.0
2720,Minuto 26: Gran atajada de Donis Escober al disparo de Gerson Rodas. Luego la jugada fue invalidada por fuera de juego.,3,5,2016,196452,8,0.0
2721,Minuto 17: Gran remate de Jhow Benavídez que Donis Escober controla en dos tiempos. Seguimos arriba en el marcador por 2-0.,5,6,2016,196452,11,0.01
2722,¡GOOOL DEL OLIMPIA! Roger Rojas al minuto 12 dispara de derecha y anota el segundo para los leones. #RugeLeón https://t.co/mBTWi4OVct,20,28,2016,196452,48,0.02
2723,¡GOOOL DEL OLIMPIA! Ever Alvarado al minuto 2 abre el marcador. https://t.co/phz09wnyMK,23,18,2016,196452,41,0.02
2724,¡Penaaal! Carlos Will Mejía es derribado en el área y el árbitro decreta la pena máxima.,5,5,2016,196452,10,0.01
2725,¡Se movió el balón! Comienza nuestro #CaminoALa30 en el Nacional.,4,8,2016,196452,12,0.01
2726,"Así luce hoy nuestra banca. Arnold Peralta no se va, ¡siempre con nosotros! https://t.co/YunDDKRBPT",99,107,2016,196452,206,0.1
2727,"¡Olimpista, mañana domingo te esperamos en el Nacional! https://t.co/JHhKiAo8QX",37,41,2016,196452,78,0.04
2728,¡El Clausura 2016 está cada vez más cerca! Adquiere tu nueva camiseta en Tiendas Mendel's y https://t.co/fjGZH8XoOn. https://t.co/2BVdo5VcZh,20,15,2016,196452,35,0.02
2729,"Se acerca la hora de volvernos a ver. ¡Olimpista, este domingo te esperamos en el Nacional! https://t.co/scUlxc8E7g",50,35,2016,196452,85,0.04
2730,¿Ya estás listo para el Clausura 2016? Adquiere la nueva piel de tu amado león en Mendel's y https://t.co/fjGZH8XoOn https://t.co/9dS8S5cw2M,32,19,2016,196452,51,0.03
2731,"¡Olimpista, apunta las fechas! Este es el calendario de la primera vuelta del Clausura 2016 para los leones. https://t.co/MlMNEJvooL",60,86,2016,196452,146,0.07
2732,"Gracias por acompañarnos en este año. En el 2016, juntos vamos por mucho más. ¡Feliz año nuevo, olimpistas! https://t.co/TEVcSNh30H",98,68,2016,196452,166,0.08
2733,¿Nos sigues a todas partes? ¡Síguenos también en nuestra cuenta oficial de Instagram! https://t.co/FTnK06S9s3,43,16,2015,196452,59,0.03
2734,Por la alegría de ser olimpistas. ¡Felices fiestas son nuestros más sinceros deseos en esta hermosa época! https://t.co/fREELmbjC7,58,39,2015,196452,97,0.05
2735,"Olimpista, esta es nuestra nueva camiseta de visita. Puedes adquirirla en Tiendas Mendels y https://t.co/fjGZH8XoOn https://t.co/goOG9n9IW1",49,21,2015,196452,70,0.04
2736,¡Ya puedes adquirir la nueva camiseta de tu amado león! Búscala en Tiendas Mendels y https://t.co/fjGZH8XoOn. https://t.co/EjDRTHPTjF,43,21,2015,196452,64,0.03
2737,Hoy caímos 2-1 frente a Juticalpa FC. ¡Nos seguimos preparando para que este próximo torneo levantemos la 30! https://t.co/jQwzBHtJ14,8,10,2015,196452,18,0.01
2738,"Mañana comienza la preparación con el objetivo de sumar más éxitos. ¡Olimpistas de Olancho, nos vemos en Juticalpa! https://t.co/hFPfJB5t9j",21,15,2015,196452,36,0.02
2739,La nueva piel del león. Ya la puedes adquirir en Tiendas Mendel´s y en https://t.co/fjGZH9f0cX https://t.co/heDlcGn4Rx,49,41,2015,196452,90,0.05
2740,Esta tarde caímos 0-1 en la final de reservas. Gracias por los éxitos obtenidos en estos dos años. ¡Vamos por más! https://t.co/fiRw8PdMgA,18,9,2015,196452,27,0.01
2741,Nuestros jugadores presentes en HRN anunciando la venta de la nueva piel del Olimpia. ¡No te quedes sin la tuya! https://t.co/cm7cQ4aAth,15,10,2015,196452,25,0.01
2742,"¡Olimpista, esta es tu nueva piel! Ya puedes adquirirlas en Tiendas Mendel´s y https://t.co/fjGZH8XoOn. https://t.co/R6jD8FVTtS",69,72,2015,196452,141,0.07
2743,"¡Olimpista, esta es tu nueva piel! Ya puedes adquirirlas en Tiendas Mendel´s y https://t.co/fjGZH8XoOn. https://t.co/NKVIN0p95x",67,80,2015,196452,147,0.07
2744,Ya está todo preparado en Mendel´s Plaza Miraflores. ¡En unos minutos presentaremos la nueva piel del león. https://t.co/qMHqmcGEKk,17,13,2015,196452,30,0.02
2745,Ya está todo preparado en Mendel´s Plaza Miraflores. ¡En unos minutos presentaremos la nueva piel del león.,7,10,2015,196452,17,0.01
2746,"Llegó el día, te esperamos esta mañana en Plaza Miraflores en la presentación de la nueva indumentaria del León. https://t.co/b1xrOiHWIB",37,29,2015,196452,66,0.03
2747,¿Ya estás listo? Acompañanos mañana en Mendel´s Miraflores para conocer las nuevas camisetas de tu amado león. https://t.co/bk3l10JHkB,36,37,2015,196452,73,0.04
2748,Carlo Costly ya esta listo para presentarte la nueva camiseta de visita del Club Olimpia. ¡Espérala muy pronto! https://t.co/o5PXFM0i3g,37,38,2015,196452,75,0.04
2749,Fabio ya está listo para una nueva indumentaria. Espera muy pronto la nueva camiseta del club Olimpia. https://t.co/SVttG93FoL,52,52,2015,196452,104,0.05
2750,"A la memoria de Arnold Peralta. Hasta siempre campeón! 

 #NoMasViolencia #JuegoLimpio https://t.co/ignX9fuPmQ",160,137,2015,196452,297,0.15
2751,Comunicado y Acuerdo de Duelo. A la memoria de Arnold Peralta. https://t.co/hWvhDDbQuI,82,73,2015,196452,155,0.08
2752,Lamentamos profundamente el fallecimiento de nuestro jugador Arnold Peralta. La familia olimpista está de luto. https://t.co/FaIPtmHxov,531,793,2015,196452,1324,0.67
2753,VIDEO: Momento en que Motagua escondió balones en el Nacional : https://t.co/mjFFyLu1gJ #Juegolimpio,32,46,2015,196452,78,0.04
2754,Finalizó el partido. Olimpia empató 1-1 ante Motagua. Estamos fuera. https://t.co/iewpoF5lsR,16,21,2015,196452,37,0.02
2755,Pedimos #Juegolimpio... #VamosLeones,19,25,2015,196452,44,0.02
2756,Min. 85 Olimpia 1-1 Motagua #VamosLeones,8,7,2015,196452,15,0.01
2757,"Finaliza el primer tiempo. Olimpia se encuentra arriba en el marcador 1-0. #VamosLeones, estamos a 45 minutos. https://t.co/DUpvUZ0RcG",24,18,2015,196452,42,0.02
2758,Goool... Rommel Quioto a los 20 minutos. #VamosLeones https://t.co/fT440NfGIP,53,64,2015,196452,117,0.06
2759,Empezamos!... Arrancó la semifinal de vuelta del Apertura 2015 #VamosLeones,11,13,2015,196452,24,0.01
2760,Estamos listos. Vamos con todo... #VamosPorLa30 https://t.co/VpG80q8hnn,29,41,2015,196452,70,0.04
2761,"Festejar un gol es más lindo cuando lo hacemos juntos, este sábado asiste al Nacional #LocalesEnLaGrada #JuegoLimpio https://t.co/dNFemBRwpF",76,86,2015,196452,162,0.08
2762,Finalizó empatado 1-1 el primer partido de las semifinales. Todo se definirá en la vuelta.,14,31,2015,196452,45,0.02
2763,"Ya se juega la segunda parte. Vamos leones, ...#VamosPorLa30",9,7,2015,196452,16,0.01
2764,Nos vamos al descanso con un empate en el marcador.,3,3,2015,196452,6,0.0
2765,A los 34' Motagua empata el partido.,4,2,2015,196452,6,0.0
2766,Golazo de Bayron Mendez. Olimpia se pone arriba en el marcador 1-0. #VamosPorLa30,29,43,2015,196452,72,0.04
2767,El clásico de semifinales ha dado inicio. ruge león... #VamosPorLa30,11,25,2015,196452,36,0.02
2768,"Olimpista, te esperamos esta tarde en el Nacional. #VamosPorLa30 https://t.co/5D1LG8Jb6R",37,40,2015,196452,77,0.04
2769,Nuestro deseo de permitir el acceso a ambas barras no será posible. A solicitud de la Policia la barra rival no podrá ingresar mañana.,31,32,2015,196452,63,0.03
2770,Comunicado urgente | Resolución de la Junta Directiva del Club Olimpia en conjunto con la Secretaría de Seguridad. https://t.co/vmC6IKwZXn,21,27,2015,196452,48,0.02
2771,"""Le pedimos a los aficionados que se comporten y que no haya hechos que lamentar"". -Rafael Ferrari https://t.co/P0BkK7hsdw",36,48,2015,196452,84,0.04
2772,"""Nunca hemos prohibido que la barra visitante entre, vamos a garantizar la seguridad"". -Rafael Ferrari https://t.co/FysZfd5Pxk",33,37,2015,196452,70,0.04
2773,La Junta Directiva del Club Olimpia se pronuncia sobre la programación del juego de ida por la semifinal del Ap 2015 https://t.co/M0jP1ejAdP,25,54,2015,196452,79,0.04
2774,Imágenes de nuestro triunfo ante R. Sociedad 3-2 que nos permitió con un global de 5-4 avanzar a semifinales. https://t.co/pMKPXdLemw,20,8,2015,196452,28,0.01
2775,"Con un gol al minuto 91, German Mejía se estrenó como goleador y le dió la victoria a los leones. https://t.co/9EoK2haj1I",23,12,2015,196452,35,0.02
2776,Así llegó el empate anoche ante Real Sociedad. Alberth Elis al minuto 48 emparejaba los cartones. https://t.co/FxigazAU8z,21,13,2015,196452,34,0.02
2777,A petición de cuerpo técnico jugaremos el día lunes a las 7:00 PM en el Estadio Nacional nuestro compromiso por la semifinal ante Motagua.,19,28,2015,196452,47,0.02
2778,"¡Finalizó el partido! Olimpia gana 3-2 y estamos en semifinales. El camino a la 30 sigue, ¡Vamos Olimpia! https://t.co/kVneXmkClI",52,49,2015,196452,101,0.05
2779,Min. 91 | ¡GOOOOL DEL OLIMPIA! German Mejía anota el tercero del encuentro. Ganamos 3-2 y 5-4 en el marcador global. https://t.co/7pPasCqe0L,28,27,2015,196452,55,0.03
2780,Min. 85 | ¡Cerca Elis de anotar el tercero! El atacante merengue no pudo conectar el balón frente a la portería.,3,1,2015,196452,4,0.0
2781,Min. 85 | Olimpia agota sus cambios. Sale: Oscar Salas; Entra: Kevin Álvarez.,2,0,2015,196452,2,0.0
2782,Min. 77 | ¡Cerca Olimpia del tercero! Chirinos saca un remate sin ángulo que casi se cuela en el marco visitante. El marcador sigue 2-2.,5,2,2015,196452,7,0.0
2783,Min. 74 | ¡Se salva Olimpia! Noel Valladares evita el tercero del aceitero en un mano a mano frente a Abbot.,2,2,2015,196452,4,0.0
2784,Min. 71 | ¡Ceeerca Olimpia! Salas remata y el balón se estrella en el horizontal. ¡Vamos Olimpia!,3,2,2015,196452,5,0.0
2785,Min. 68 | Segundo cambio en Olimpia. Sale: Carlos Will Mejía; Entra: Michaell Chirinos.,1,2,2015,196452,3,0.0
2786,Min. 65 | Primer cambio merengue. Sale: Bayron Méndez; Entra: Germán Mejía.,2,2,2015,196452,4,0.0
2787,Min. 63 | Nuevamente Olimpia intenta. Carlos Will Mejía remata y el arquero visitante desvía.,1,0,2015,196452,1,0.0
2788,Min. 61 | ¡Cerca Olimpia de irse arriba! Ever Alvarado remata y Reyes evita el tercer gol merengue.,2,2,2015,196452,4,0.0
2789,Min. 48 | ¡GOOOL MERENGUE! Elis anota el empate en el Nacional. #RugeLeón https://t.co/X4yB3LKT8p,12,15,2015,196452,27,0.01
2790,¡Comienza el complemento! Ya se juega la segunda mitad del partido. ¡Vamos Olimpia!,3,2,2015,196452,5,0.0
2791,¡Finalizó la primera mitad! Los leones caen momentáneamente 1-2 en el Nacional. https://t.co/qnpUjsreGA,3,1,2015,196452,4,0.0
2792,Min. 44 | ¡Gol de Real Sociedad! Marco Tulio Vega hace el 1-2 y el global es de 3-4 a favor de los aceiteros.,0,2,2015,196452,2,0.0
2793,Min. 41 | Primera amonestación para los merengues. Tarjeta amarilla para Carlos Will Mejía.,0,0,2015,196452,0,0.0
2794,Min. 37 | ¡Cerca Real Sociedad! Potente remate de la visita que es desviado al tiro de esquina por Noel Valladares.,0,0,2015,196452,0,0.0
2795,Min. 36 | Olimpia 1 - Real Sociedad 1. El marcador global se encuentra 3-3 y con ese resultado los leones están accediendo a semifinales.,2,2,2015,196452,4,0.0
2796,Min. 27 | ¡Falló Méndez! Reyes detiene el penal de Bayron Méndez.,1,3,2015,196452,4,0.0
2797,Min. 26 | ¡Penal a favor de los leones! Derriban a Alberth Elis en el área y el árbitro sanciona la pena máxima.,1,0,2015,196452,1,0.0
2798,Min. 17 | ¡Se salva la visita! Primero Quioto y luego Elis rematan sin embargo la defensa desvía el balón.,1,0,2015,196452,1,0.0
2799,Min. 8 | ¡GOOOL DEL OLIMPIA! Quioto abre el marcador en el Nacional. El global es de 3-2 a favor de los leones. https://t.co/R4lniXKcVX,15,14,2015,196452,29,0.01
2800,"Min. 5 | Palacios cabecea desviado en el área pequeña, sin embargo la jugada no cuenta. Olimpia ya lleva peligro.",2,0,2015,196452,2,0.0
2801,¡Comenzó el partido! Ya se juega la vuelta del repechaje en el Nacional. ¡Vamos Olimpia!,1,4,2015,196452,5,0.0
2802,"Así sale Olimpia esta noche. ¡Vamos por las semis, vamos por la 30! https://t.co/lNDTe2UK7x",10,10,2015,196452,20,0.01
2803,"Ésta noche con tu aliento vamos a ganar, que no te queden excusas. ¡Asistí hoy al Nacional! Popular 20 L. Preferencia 60 L. Silla 150 L.",9,9,2015,196452,18,0.01
2804,Este miércoles buscaremos sellar juntos el pase a semifinales. Precios accesibles para que no te quedes en casa. https://t.co/GJx9Gb2ewT,16,18,2015,196452,34,0.02
2805,"No te pierdas la oportunidad de vestir la camiseta del León con un 50 % de descuento, identifícate éste miércoles. https://t.co/S7nt8vFjzy",13,13,2015,196452,26,0.01
2806,¡Finalizó el partido! Aceiteros y leones empatan 2-2 y definirán todo en el Nacional. https://t.co/kSGhhvs1TG,12,18,2015,196452,30,0.02
2807,Min. 92 | ¡Graaande Donis! El arquero merengue salva al león del tercer tanto aceitero.,8,1,2015,196452,9,0.0
2808,Min. 85 | Olimpia quema su último cambio. Entró: Roger Rojas; Salió: Romell Quioto.,4,0,2015,196452,4,0.0
2809,Se realiza el segundo cambio merengue. Ingresó: Bryan Johnson; Salió: Oscar Salas,4,0,2015,196452,4,0.0
2810,"¡EMPATA EL MERENGUE! Luego de una confusión de parte del juez central, el gol de Fonseca es válido. ¡Vamos Leones! https://t.co/qz0K6MObe0",11,14,2015,196452,25,0.01
2811,Min. 74 | ¡Gol de Real Sociedad! Tobías desde el punto penal anota el segundo.,0,0,2015,196452,0,0.0
2812,Min. 72 | Penal a favor de Real Sociedad. Supuesta mano en el área de un jugador blanco.,1,2,2015,196452,3,0.0
2813,Min. 67 | ¡GOOOL MERENGUE! Alvarado empata el marcador en Tocoa. https://t.co/JCRM2wMwjN,9,8,2015,196452,17,0.01
2814,Min. 64 | ¡Cerca Olimpia! Romell Quioto remata pero el balón se va arriba.,1,4,2015,196452,5,0.0
2815,Min. 60 | ¡Cerca Real Sociedad del segundo! Cabezazo peligroso que pasa muy cerca.,0,0,2015,196452,0,0.0
2816,Min. 49 | ¡Gol de Real Sociedad! Abbott marca el primero de la tarde.,2,2,2015,196452,4,0.0
2817,¡Ya se juega la segunda mitad! Comienza la parte complementaria del juego en el Francisco Martinez. #RugeLeón,4,4,2015,196452,8,0.0
2818,¡Finalizó la primera mitad! Real Sociedad y Olimpia empatan 0-0 en la ida del repechaje. https://t.co/wSWLasKngC,2,3,2015,196452,5,0.0
2819,Min. 27 | Aceiteros y leones empatan a cero en Tocoa.,1,2,2015,196452,3,0.0
2820,Comienza el juego en Tocoa y así salen los leones.Vamos Olimpia! https://t.co/P1lmIqAwNb,8,8,2015,196452,16,0.01
2821,En breve continuamos el camino a la 30 en Tocoa. Olimpia visita a Real Sociedad en la ida del repechaje. #RugeLeón https://t.co/a0Btc8dBBG,13,14,2015,196452,27,0.01
2822,"Arnold Peralta solicitó permiso para ausentarse en el juego de este domingo, será baja con Palacios quien llegó con sobrecarga muscular.",8,8,2015,196452,16,0.01
2823,"¡Final del encuentro! Caímos 4-2 en Puerto Cortés, juego que nos sirvió para hacer debutar a 4 jóvenes y jugar con jugadores canteranos.",13,22,2015,196452,35,0.02
2824,"Min. 81 | José Mario Pinto hace su debut con anotación, el goleador de las reservas hace lo que más sabe hacer. Platense 4-2 Olimpia.",3,4,2015,196452,7,0.0
2825,"Min. 77 | Gol de Platense, cuarto gol de los tiburones, caemos lamentablemente 4-1 en Puerto Cortés. #VamosLeón",0,2,2015,196452,2,0.0
2826,"Min. 65 | Gol de Platense, llegó el tercer tanto de los escualos. Caemos 3-1 en Puerto Cortés. #VamosLeón",0,1,2015,196452,1,0.0
2827,"Min. 51 | Gol de Platense, los locales anotan el segundo tanto, rebasando el marcador adverso. Caemos momentáneamente 2-1. #RugeLeón",0,2,2015,196452,2,0.0
2828,¡Arrancó la segunda parte! ¡Vamos por el triunfo! Platense 1-1 Olimpia. #RugeLeón,1,2,2015,196452,3,0.0
2829,"¡Final del primer tiempo! En los primeros 45 se anotaron dos goles, uno por bando y así nos vamos al descanso. #RugeLeón",2,4,2015,196452,6,0.0
2830,"Min. 43 | Gol de Platense, los locales empatan el encuentro casi al final del primer tiempo. Platense 1-1 Olimpia. #RugeLeón",1,3,2015,196452,4,0.0
2831,"Min. 36 | Roger Rojas la tuvo para concretar, jugada con peligrosidad. No se mueve el marcador. Platense 0-1 Olimpia. #RugeLeón",1,2,2015,196452,3,0.0
2832,"Min. 21 | Olimpia maneja mejor el partido, el marcador no se mueve en el encuentro. Platense 0-1 Olimpia. #RugeLeón",2,2,2015,196452,4,0.0
2833,"Min. 10 | Se acerca Olimpia por medio de Néstor Martínez, muy cerca del segundo el león. #RugeLeón",0,2,2015,196452,2,0.0
2834,Min. 2 | ¡GOLAZO! Mayron Ariel Flores anotó el primer tanto del encuentro. Platense 0-1 Olimpia. #RugeLeón,10,11,2015,196452,21,0.01
2835,¡Ya se juega en Puerto Cortés el último partido de las vueltas regulares! Platense vs Olimpia. #RugeLeón,4,5,2015,196452,9,0.0
2836,Este jueves los leones visitan Puerto Cortés en busca de cerrar las vueltas sumando 3 puntos. #RugeLeón https://t.co/HJ9p9Yb8gy,12,16,2015,196452,28,0.01
2837,"Nuestros deseos de una pronta recuperación para @luisgarrido_19, quien sufrió rotura de ligamentos. #FuerzaGarrido https://t.co/uNiYxGrWYZ",117,132,2015,196452,249,0.13
2838,Nuestras camisetas local y visita con el 50% de descuento. No te pierdas la oportunidad de vestir la piel del león. https://t.co/uElEQv8Lad,15,17,2015,196452,32,0.02
2839,Imágenes destacadas del clásico capitalino que caímos 1-0 en el Nacional. https://t.co/r80hM61Xyk,10,4,2015,196452,14,0.01
2840,El equipo de Reservas de Olimpia hoy desayunó temprano antes del partido ante Motagua a 10am. https://t.co/B3u2nbX1pj,10,4,2015,196452,14,0.01
2841,"¡Finalizó el partido! En un clásico disputado, los leones caen 1-0. https://t.co/5hD00SU3BE",7,14,2015,196452,21,0.01
2842,¡Se juega hasta el '95! El juez central añade 5 minutos más de clásico capitalino.,1,4,2015,196452,5,0.0
2843,Min. 83 | Muy fuerte entrada por detrás contra German Mejía que el árbitro sanciona con tarjeta amarilla para Eddie Hernández.,2,0,2015,196452,2,0.0
2844,Min. 78 | Una falta más de los azules y Reinieri Mayorquín se va expulsado por doble amonestación.,1,1,2015,196452,2,0.0
2845,Min. 75 | Olimpia agota sus cambios. Entra: Rembrandt Flores; Sale: Michaell Chirinos,0,0,2015,196452,0,0.0
2846,Min. 70 | ¡Se salva Motagua del empate! Elis desvía el balón que roza el vertical izquierdo de Licona.,0,1,2015,196452,1,0.0
2847,Min. 67 | ¡Cerca Olimpia! Roger Rojas estuvo a punto de anotar el empate.,1,1,2015,196452,2,0.0
2848,Se realiza el segundo cambio en Olimpia. Entra: Carlos Will Mejía; Sale: Oscar Salas.,1,1,2015,196452,2,0.0
2849,Min. 58 | ¡Se salva Motagua! Remate de Elis que pasa muy cerca de la meta motagüense.,0,0,2015,196452,0,0.0
2850,Min. 53 | ¡Vuelve a llegar Olimpia! Nuevamente Elis y Chirinos metiendo en problemas a la zaga azul. Seguimos 0-1 en el Nacional.,1,1,2015,196452,2,0.0
2851,Ya se juega el segundo tiempo y los leones van por los 3 puntos. #RugeLeón,3,0,2015,196452,3,0.0
2852,En el medio tiempo se realiza la primera modificación merengue. Entra: Roger Rojas; Sale: Kevin Álvarez.,0,1,2015,196452,1,0.0
2853,¡Finalizó el primer tiempo! Los leones caen momentaneamente 1-0 ante Motagua. ¡Vamos Olimpia! https://t.co/8wzPkF5qz8,2,4,2015,196452,6,0.0
2854,Min. 44 | ¡Ceeerca Olimpia! German Mejía remata sin embargo el balón es desviado por un defensor azul.,2,1,2015,196452,3,0.0
2855,Min. 38 | ¡Gol de Motagua! Se abre el marcador luego de una jugada a balón parado. ¡Vamos leones!,3,4,2015,196452,7,0.0
2856,Min. 34 | ¡Se salvó Motagua! Gran cabezazo por parte del ataque merengue que el arquero Licona apenas desvía.,3,3,2015,196452,6,0.0
2857,Se detuvo el juego al minuto 28. Lamentable suceso donde excluyen a ambos directores técnicos de sus respectivos banquillos.,4,9,2015,196452,13,0.01
2858,Min. 19 | Llegó Motagua con peligro sin embargo el remate sale apenas desviado.,1,1,2015,196452,2,0.0
2859,Min. 17 | Gran atajada de Menjívar al remate del delantero merengue Hernández. Seguimos empatados 0-0.,0,3,2015,196452,3,0.0
2860,Min. 16 | Gran gesto de Méndez que mete el centro y el arquero motagüense controla. Superior Olimpia en el juego.,1,2,2015,196452,3,0.0
2861,"Min. 8 | ¡Ceeerca Olimpia! Elis entra al área sin problemas y asiste, sin embargo el balón no pudo ser conectado por ningún jugador blanco.",3,2,2015,196452,5,0.0
2862,Min. 5 | Vuelve a llegar Olimpia por medio de Elis quien no logra controlar correctamente. El marcador sigue 0-0.,1,2,2015,196452,3,0.0
2863,Min. 2 | La primera llegada del juego es merengue. Elis remata de derecha pero el balón se desvía.,0,2,2015,196452,2,0.0
2864,¡Se movió la #5! Merengues y azules ya juegan el clásico. #RugeLeón,2,8,2015,196452,10,0.01
2865,Estamos a minutos de comenzar el clásico capitalino y así salen los leones a la cancha del Nacional. ¡Vamos Olimpia! https://t.co/p9jXQKbj82,13,17,2015,196452,30,0.02
2866,"Esta noche a partir de las 7, nuestros leones van a dejarlo todo en la cancha. ¡Hoy es día de clásico! Hoy #RugeLeón https://t.co/RfMo7stZyj",22,34,2015,196452,56,0.03
2867,Imágenes de nuestro triunfo de la noche del sábado 7 de noviembre ante Victoria; 6-0 y una propuesta de matrimonio. https://t.co/rzv4RFuYX6,20,15,2015,196452,35,0.02
2868,"Felicitamos a Alberth Elis, quien logró la marca de anotar su primer triplete con los tres goles ante Victoria. https://t.co/zYOkTdUZDW",43,30,2015,196452,73,0.04
2869,Olimpia se ubica en la segunda posición luego de concluir la Jornada 17 del Apertura 2015. Aún nos restan 2 juegos. https://t.co/Rb8jlSiDnX,30,23,2015,196452,53,0.03
2870,El partido pendiente con Motagua debe ser suspendido de acuerdo al Art. 37 de Liga Nacional por los jugadores que se aporta a la selección.,12,11,2015,196452,23,0.01
