,full_text,favorite_count,retweet_count,created_at,user.followers_count,engagement,performance,twtlength
0,https://t.co/r3Ze9AoS7w,18211,1797,2019,29435506,20008,0.07,23
1,https://t.co/CgPA4U0Wqo,38302,10274,2019,29435506,48576,0.17,23
2,https://t.co/fIHtyy3OMy,52229,5743,2019,29435506,57972,0.2,23
3,https://t.co/YuBbMweeeG,17739,1928,2019,29435506,19667,0.07,23
4,https://t.co/mkKFKNaCI0,10430,1084,2019,29435506,11514,0.04,23
5,https://t.co/JFvwOn7rKz,9431,922,2019,29435506,10353,0.04,23
6,https://t.co/rUoN7xv6L3,11659,1145,2019,29435506,12804,0.04,23
7,https://t.co/WEZSYGCkUr,8544,813,2019,29435506,9357,0.03,23
8,https://t.co/njow7ocGDu,11283,1117,2019,29435506,12400,0.04,23
9,https://t.co/kPNEdWFc6m,9064,834,2019,29435506,9898,0.03,23
10,https://t.co/ZS5lIHZwEJ,9524,976,2019,29435506,10500,0.04,23
11,https://t.co/f7De3vYAXY,12705,1414,2019,29435506,14119,0.05,23
12,https://t.co/gruZHfCJkM,9195,887,2019,29435506,10082,0.03,23
13,https://t.co/87tzdlkeUv,20661,2097,2019,29435506,22758,0.08,23
14,reading from the book of Daniel https://t.co/GHmLTWa7iS,50091,4861,2019,29435506,54952,0.19,55
15,Fam pulling up https://t.co/8BLUQubN4B,113195,6440,2019,29435506,119635,0.41,38
16,https://t.co/IBOwJjgKai,41144,4815,2019,29435506,45959,0.16,23
17,Vanessa Beecroft 11 24 19 https://t.co/y0lKkLVo60,28694,1724,2019,29435506,30418,0.1,49
18,Ye and Dre Jesus is King Part II coming soon. https://t.co/wTKFgXQQXQ,340002,67532,2019,29435506,407534,1.38,69
19,Invite artwork by Nick Knight https://t.co/U7IBqe1Gxk,47093,5672,2019,29435506,52765,0.18,53
20,"""FOLLOW GOD"" 

https://t.co/e3SRwWExir https://t.co/Pqy7qvc0aB",80112,13946,2019,29435506,94058,0.32,64
21,"‚ÄúJESUS IS KING‚Äù
Sunday Service Experience
The Forum Los Angeles Today

https://t.co/Xu4WGECVsT https://t.co/xci1nkfjVt",29939,3330,2019,29435506,33269,0.11,122
22,"‚ÄúJESUS IS KING‚Äù

https://t.co/OqvrhkLBIc https://t.co/E0JZJH3fwU",59960,7784,2019,29435506,67744,0.23,66
23,"JESUS IS KING
SUNDAY SERVICE EXPERIENCE
NOON PT LIVESTREAM
https://t.co/pJr7fEIN9S https://t.co/ykxoeG7qv8",54667,6742,2019,29435506,61409,0.21,109
24,"To my fans

Thank you for being loyal &amp; patient

We are specifically fixing mixes on ‚ÄúEverything We Need‚Äù ‚ÄúFollow God‚Äù &amp; ‚ÄúWater‚Äù ¬†
¬†
We not going to sleep until this album is out!",372387,53419,2019,29435506,425806,1.45,193
25,"‚ÄúJESUS IS KING‚Äù
      Midnight https://t.co/EMYldzBXCU",278793,74263,2019,29435506,353056,1.2,55
26,"‚ÄúJESUS IS KING‚Äù
    OCT 25th https://t.co/Ug4ghlQYk7",433544,123817,2019,29435506,557361,1.89,53
27,One of my favorite of many things about what the Trump hat represents to me is that people can‚Äôt tell me what to do because I‚Äôm black,149441,22442,2019,29435506,171883,0.58,133
28,Spoke with Joe Rogan    Podcast coming soonüî•üî•üî•,335567,64756,2019,29435506,400323,1.36,46
29,From now on I‚Äôm performing with my mutherfucking hat on üêâüêâüêâ,105026,12165,2019,29435506,117191,0.4,59
30,Love everyone      Start the year clean      Just be     All love,74556,19936,2019,29435506,94492,0.32,65
31,2024,74634,11198,2019,29435506,85832,0.29,4
32,Free thought,26536,5245,2019,29435506,31781,0.11,12
33,We will change the world.  God is on my side. I am a Christian. I am a tax payer. I am myself. God is with us.,76954,11257,2019,29435506,88211,0.3,110
34,Love everyone,28918,6720,2019,29435506,35638,0.12,13
35,Blacks are 90% Democrats     That sounds like control to me ü§î,80752,13464,2019,29435506,94216,0.32,61
36,They will not program me,61230,11566,2019,29435506,72796,0.25,24
37,Just so in 2019 you know where I stand,14672,1864,2019,29435506,16536,0.06,38
38,üêâüêâüêâ,16562,3018,2019,29435506,19580,0.07,3
39,Trump all day,137644,28426,2019,29435506,166070,0.56,13
40,Keep moving forward,126190,47226,2019,29435506,173416,0.59,19
41,Yeezy winter campaign üòÇüòÇüòÇ https://t.co/wR6401unNW,76713,5921,2019,29435506,82634,0.28,49
42,2019 we going in     Always remember we did five albums in a row       I love making music     We always feel the love,56636,6175,2019,29435506,62811,0.21,118
43,Love everyone,58922,14206,2018,29435506,73128,0.25,13
44,If something‚Äôs on my mind and spirit I let it out,26615,6045,2018,29435506,32660,0.11,49
45,Tweeting is legal and also therapeutic,116201,29469,2018,29435506,145670,0.49,38
46,See when you care about your family you don‚Äôt let no man push you to do nothing that could risk your freedom,14152,1954,2018,29435506,16106,0.05,108
47,If I got any cooler I would freeze to death,380473,158103,2018,29435506,538576,1.83,43
48,I ain‚Äôt never followed anyone else‚Äôs methods     I ain‚Äôt trying to be cool,20964,5065,2018,29435506,26029,0.09,74
49,Or it‚Äôs cool if it‚Äôs a diss record because it‚Äôs more entertaining? Ima break all codes. I ain‚Äôt taking advice from no one who ain‚Äôt do nothing to actually help,11776,1173,2018,29435506,12949,0.04,159
50,I only play by God‚Äôs rules. I don‚Äôt follow no man made codes,44849,10377,2018,29435506,55226,0.19,60
51,even the haters     haters are fans too,50761,11489,2018,29435506,62250,0.21,39
52,We appreciate all the real ones who made it through 2018 with us    Thank goodness for all of our fans and supporters,36637,4779,2018,29435506,41416,0.14,117
53,We feel the love,17970,3093,2018,29435506,21063,0.07,16
54,Everything happens for a reason,109923,50049,2018,29435506,159972,0.54,31
55,2019 we‚Äôre already so thankful for the blessings in order,30797,8674,2018,29435506,39471,0.13,57
56,Refresh,19897,5995,2018,29435506,25892,0.09,7
57,New designs new music new ideas renewed spirit we changing everything everyday the vision is crystal,21625,2948,2018,29435506,24573,0.08,100
58,I feel stronger than ever    We are stronger than ever,22083,4213,2018,29435506,26296,0.09,54
59,We feel soooo much love. So much good energy. So much good will,14580,2303,2018,29435506,16883,0.06,63
60,I‚Äôm drug free and my spirit is connected. No weapon formed against us shall prosper,62225,8332,2018,29435506,70557,0.24,83
61,I got to be myself and nobody had to ‚Äúlet me‚Äù,21669,4386,2018,29435506,26055,0.09,45
62,2018 was so beautiful,96972,28915,2018,29435506,125887,0.43,21
63,We‚Äôre super happy,55572,11357,2018,29435506,66929,0.23,17
64,My dad got me a drone for Christmas üî•üî•üî•,139304,10664,2018,29435506,149968,0.51,39
65,All positive vibes,109455,39129,2018,29435506,148584,0.5,18
66,Love everyone,161903,41448,2018,29435506,203351,0.69,13
67,Oxygen cost twenty dollars https://t.co/R86SfKWEpM,46366,5135,2018,29435506,51501,0.17,50
68,üòù https://t.co/CcyvpVYDyV,18421,1583,2018,29435506,20004,0.07,25
69,ü§™ https://t.co/DWSkmHGYaA,129757,15008,2018,29435506,144765,0.49,25
70,ü§î https://t.co/Zq9zsZSm3p,42074,2610,2018,29435506,44684,0.15,25
71,Wait for it... https://t.co/BcpWSARsw1,20754,1589,2018,29435506,22343,0.08,38
72,My dad said he sees a green aura around me so I looked this up and this described me perfectly https://t.co/gnUvpP01Nx,40331,3351,2018,29435506,43682,0.15,118
73,Bff https://t.co/wwGQihtBen,134749,13090,2018,29435506,147839,0.5,27
74,Legendary Christmas https://t.co/tSdUXB8HF3,40520,3135,2018,29435506,43655,0.15,43
75,Pulling up in the may bike üòÇ https://t.co/bNFc1RoSud,277239,52777,2018,29435506,330016,1.12,52
76,Cube and Short üêêüêê https://t.co/kGaduxWabJ,24823,1748,2018,29435506,26571,0.09,41
77,https://t.co/3sj7QELxcW,17023,2266,2018,29435506,19289,0.07,23
78,üêêüêê https://t.co/6goG0XAcgd,18010,1077,2018,29435506,19087,0.06,26
79,https://t.co/bkBiBfJWV0,7440,863,2018,29435506,8303,0.03,23
80,Yeezy colors https://t.co/dblBPmYWzO,45696,2942,2018,29435506,48638,0.17,36
81,Meanwhile https://t.co/VvGYMlTzw0,36177,2827,2018,29435506,39004,0.13,33
82,https://t.co/BfGRsXVg7T,27192,1658,2018,29435506,28850,0.1,23
83,2019 year of the established miracle  https://t.co/cl8iQwmj3L,9891,1351,2018,29435506,11242,0.04,61
84,Bob Dylan,53897,8773,2018,29435506,62670,0.21,9
85,"If I‚Äôd thought about it I never would‚Äôve done it, I would‚Äôve let it slide
If I‚Äôd lived my life by what others were thinkin‚Äô, the heart inside me would‚Äôve died
I was just too stubborn to ever be governed by enforced insanity
Someone had to reach for the risin‚Äô star, Its up to me",58804,9371,2018,29435506,68175,0.23,281
86,Met with Trav at my crib this morning   We expressed ourselves    It‚Äôs all love,148889,12419,2018,29435506,161308,0.55,79
87,https://t.co/f0QyccE0T6,27220,3472,2018,29435506,30692,0.1,23
88,I will put this in question form     Who has heard of the twelve lost tribes of Judah?  Have you heard that two of the tribes were actually black? ü§î,27918,3437,2018,29435506,31355,0.11,148
89,WE FREE,50080,9388,2018,29435506,59468,0.2,7
90,We free,21630,2846,2018,29435506,24476,0.08,7
91,I love that we are destigmitizing mental health     Gucciman and Quavo have a song Bipolar this is so good for culture,39078,3959,2018,29435506,43037,0.15,118
92,I‚Äôm loving the new music I‚Äôve been working on. 6 months off meds I can feel me again.   Remember when dark fantasy came out I used to tweet a storm also.,98698,12218,2018,29435506,110916,0.38,153
93,Keep squares out yo circle,164250,65479,2018,29435506,229729,0.78,26
94,There was a handler with me at TMZ a so called voice of reason that thank the lord no longer is in my circle,14829,1292,2018,29435506,16121,0.05,108
95,I have no more handlers     Only fear god,28331,4672,2018,29435506,33003,0.11,41
96,I give up drinking every week,109306,30598,2018,29435506,139904,0.48,29
97,You don‚Äôt make runaway on medication      Even alcohol is and addictive substance called spirits that actually block our earthly connection to our spirit when we drown ourselves in it,50081,7400,2018,29435506,57481,0.2,183
98,I cannot be on meds and make watch the throne level or dark fantasy level music,80003,11821,2018,29435506,91824,0.31,79
99,God has given me this voice for a reason,53212,8199,2018,29435506,61411,0.21,40
100,Perhaps we stop looking at my tweets as rants and start looking at them as therapy testimonials and some even ministry,47745,6937,2018,29435506,54682,0.19,118
101,Man makes plans and god laughs,46342,12659,2018,29435506,59001,0.2,30
102,I need to speak about how Chance demanding that we record in Chicago reconnected me with my roots and also my faith in Jesus Christ,55530,5839,2018,29435506,61369,0.21,131
103,You have to see and feel how happy I am and how strong my family is. We are even stronger because of this through the love and grace of god,19942,2131,2018,29435506,22073,0.07,139
104,People said my career was over after TMZ       I need to show the world that we so called crazy people will not be just written off,26185,3232,2018,29435506,29417,0.1,131
105,I‚Äôve been trying to do a serious interview speaking on mental health but it seems as though all members of press are afraid to speak to someone who has been diagnosed but is still everyone‚Äôs favorite super hero,62567,5689,2018,29435506,68256,0.23,210
106,People try to ‚Äòhandle you when they think you have a mental problem,20722,3793,2018,29435506,24515,0.08,67
107,We as a society are taking control of our consciousness and raising it together,17181,2729,2018,29435506,19910,0.07,79
108,The paradigm is shifting,16881,3485,2018,29435506,20366,0.07,24
109,We love,13699,2297,2018,29435506,15996,0.05,7
110,Drake and Trav both love Ye more than anyone and I love those guys back. We love everyone,34900,4323,2018,29435506,39223,0.13,89
111,We‚Äôre all growing together,15922,3147,2018,29435506,19069,0.06,26
112,It‚Äôs like when you see a tv show from the 60s and it‚Äôs super racist and sexist,11348,1075,2018,29435506,12423,0.04,78
113,It reminds me of when I said stop hip hop homophobia      It used to be ok for rappers to bash gay people just listen to certain rap records from the 90s and early 2000s,17569,2050,2018,29435506,19619,0.07,169
114,I don‚Äôt blame people for not knowing how to handle this that said we as a society will learn together,14100,1732,2018,29435506,15832,0.05,101
115,I am able to experience first hand how people who have mental health issues get written off by society.    Don‚Äôt listen to him cause he‚Äôs crazy. He‚Äôs washed cause he‚Äôs crazy etc...,25561,3998,2018,29435506,29559,0.1,180
116,No one would ever choose to end up in a mental hospital and diagnosed with a mental disorder but god chose me to publicly go through this journey and it is beautiful,40004,4560,2018,29435506,44564,0.15,165
117,Drake verbally attacked Cudi when he was in the hospital and went at me after TMZ because I decided to release albums in June   Is snowballed and he refused to meet with me but texted my mother in law and did sneak disses on peoples records that I consider family,34185,4583,2018,29435506,38768,0.13,263
118,People will no longer take mental health for a joke,25160,4533,2018,29435506,29693,0.1,51
119,I know Ariana said this to be cool and didn‚Äôt mean no harm but I don‚Äôt like even slightest level of slight commentary from someone I know loves and respects me https://t.co/T9VXaIj9MX,55181,8777,2018,29435506,63958,0.22,183
120,Erik Oken and I are @Cartier brothers https://t.co/tGMRbO9L6o,14062,871,2018,29435506,14933,0.05,61
121,Typo Lauren Michaels is the goat   The world needs that Ye SNL üëΩüëΩüëΩ,12797,857,2018,29435506,13654,0.05,66
122,Meeting with Trav tonight bet it never be a checks over stripes line again on a Trav song on Donda,93141,14611,2018,29435506,107752,0.37,98
123,Still waiting to host SNLü§îLauren in the goat. Ye gotta host,19831,1357,2018,29435506,21188,0.07,59
124,Heard Hideo Kojima is in NY    We need to meet   Does anyone know where he is or how to contact him,81843,16773,2018,29435506,98616,0.34,99
125,Brain üß† joggers make another appearance https://t.co/GYWtV05qvV,74387,6291,2018,29435506,80678,0.27,63
126,https://t.co/kY7UCcRrDT,23821,4171,2018,29435506,27992,0.1,23
127,Turrell üêê https://t.co/MTzZiWeTWS,17840,1371,2018,29435506,19211,0.07,33
128,Me and JPüôèüèø heal the world https://t.co/1KwJUA1Gb4,42619,3610,2018,29435506,46229,0.16,50
129,Vision https://t.co/W5E8w0jYZS,43524,4391,2018,29435506,47915,0.16,30
130,Meditate in positivity,62898,15269,2018,29435506,78167,0.27,22
131,All love,54374,14395,2018,29435506,68769,0.23,8
132,All positive vibes,43279,14837,2018,29435506,58116,0.2,18
133,I‚Äôve made mistakes and have karma   No man is perfect     The universe will test us,59739,15164,2018,29435506,74903,0.25,83
134,I‚Äôm a man about my family and integrity,45060,6022,2018,29435506,51082,0.17,39
135,Broke down doors for sneakers fashion music everything,40421,5633,2018,29435506,46054,0.16,54
136,No artist should ever diss me for clout   Period,50278,7085,2018,29435506,57363,0.19,48
137,I need that love and respect that we didn‚Äôt give Michael while I‚Äôm alive,68153,10450,2018,29435506,78603,0.27,72
138,If I wasn‚Äôt here all artist would do memorial songs,33588,4686,2018,29435506,38274,0.13,51
139,If I wasn‚Äôt hear all artist would be doing memorial songs,25787,2938,2018,29435506,28725,0.1,57
140,I actually like sickomode but I don‚Äôt like that that is was sneak disses,73740,9933,2018,29435506,83673,0.28,72
141,Love to all artist,27599,3859,2018,29435506,31458,0.11,18
142,I love everybody all positive energy    No one that is a musician should ever diss me     My existence is for the rights of all artist,27859,3666,2018,29435506,31525,0.11,134
143,All positive energy   I got love for everyone     Just don‚Äôt sneak diss or diss at all    I paid the dues for all weirdos,29179,4097,2018,29435506,33276,0.11,121
144,I have a problem with sneak disssing,50376,10485,2018,29435506,60861,0.21,36
145,I hit Trav earlier today    Now he just hit me    More threats,47640,6361,2018,29435506,54001,0.18,62
146,Drake called me threatening me,125195,26957,2018,29435506,152152,0.52,30
147,It‚Äôs not about rap     It‚Äôs about family   We have to be close as a family and never let these people infiltrate just for radio spins,23746,2655,2018,29435506,26401,0.09,133
148,Family first,30749,7413,2018,29435506,38162,0.13,12
149,Fuck clout,66374,18384,2018,29435506,84758,0.29,10
150,Fuck that sickomode song        Family first and always,125897,26143,2018,29435506,152040,0.52,55
151,It‚Äôs what I felt   And have been feeling for awhile   All positive   All love,20678,2365,2018,29435506,23043,0.08,77
152,Perhaps I should have been more like water today,58981,17259,2018,29435506,76240,0.26,48
153,All positive energy,29057,7908,2018,29435506,36965,0.13,19
154,We should all be on this planet working together,33872,8146,2018,29435506,42018,0.14,48
155,https://t.co/kdorJkJJqE,20730,2873,2018,29435506,23603,0.08,23
156,Trying to kick me while I‚Äôm down,35848,5688,2018,29435506,41536,0.14,32
157,Our brother is lost and confused,30085,4199,2018,29435506,34284,0.12,32
158,If Drake would go at Ye that there is interviews that he loves me then he doesn‚Äôt give a fuck about anyone,24168,2956,2018,29435506,27124,0.09,106
159,You tried to hurt my pockets,32184,4792,2018,29435506,36976,0.13,28
160,You threatened the safety of me and my family,24525,2816,2018,29435506,27341,0.09,45
161,Noooooo moooooore fake playing with peoples lives kids and mental health,25575,3470,2018,29435506,29045,0.1,72
162,Noooooooo moooooore cap,35284,10084,2018,29435506,45368,0.15,23
163,He passes Drakes the crib everyday,17782,1841,2018,29435506,19623,0.07,34
164,To the right    It‚Äôs   On sight     Saint stays to the right,19485,2261,2018,29435506,21746,0.07,60
165,This clout shit done got outta hand bro,39776,8355,2018,29435506,48131,0.16,39
166,Trav is my family and let this met throw sneak disses at me for clout,30727,3890,2018,29435506,34617,0.12,69
167,I heard Drake had more bars dissing me that were removed,25401,3394,2018,29435506,28795,0.1,56
168,I used to bring Travis with me everywhere with me    Im an inspiration to both him and Drake,38820,5861,2018,29435506,44681,0.15,92
169,Only positive energy,68275,24466,2018,29435506,92741,0.32,20
170,I will never put negative energy into a song,42753,4828,2018,29435506,47581,0.16,44
171,I will never make a diss record,48287,5074,2018,29435506,53361,0.18,31
172,You‚Äôre mad at me for something I didn‚Äôt do,70511,15558,2018,29435506,86069,0.29,42
173,I would never mention your (blank),46357,6375,2018,29435506,52732,0.18,34
174,I‚Äôm Ye bro    Remember that   I love you   I would never intentionally hurt you     That‚Äôs what I‚Äôve been saying to you,41887,5758,2018,29435506,47645,0.16,119
175,This year has been really tough and you have added to the confusion,45836,9927,2018,29435506,55763,0.19,67
176,Leave me and my family alone bro,49863,6880,2018,29435506,56743,0.19,32
177,But you‚Äôre playing into it    Why?   A false runner???  A beat???,20366,1965,2018,29435506,22331,0.08,65
178,You would be so sad if anything ever happened to me,78733,22015,2018,29435506,100748,0.34,51
179,Drake this is what they want,32276,5409,2018,29435506,37685,0.13,28
180,This is a man speaking to a man that has been placed in the program to fuck with Kanye West head and set me up,25754,3364,2018,29435506,29118,0.1,110
181,These tweets are not emotional,54889,15592,2018,29435506,70481,0.24,30
182,To the right it‚Äôs on sight    Saint stays to the right bro,21456,2478,2018,29435506,23934,0.08,58
183,Never threaten north saint and Chicago‚Äôs dad bro,35388,5087,2018,29435506,40475,0.14,48
184,Never threatened north and saint and Chicago‚Äôs daddy bro,28584,3866,2018,29435506,32450,0.11,56
185,Trust god bro    God sees all    Stop the act     Cut the program,25437,3981,2018,29435506,29418,0.1,65
186,Fear no man,44239,15888,2018,29435506,60127,0.2,11
187,Nobody scared of anything but god,28013,6399,2018,29435506,34412,0.12,33
188,Nobody scared of anything but gods,19289,2671,2018,29435506,21960,0.07,34
189,Nobody scared of anything,20954,3385,2018,29435506,24339,0.08,25
190,Some true artist are a bit crazy   Everybody is not Programed,31435,5660,2018,29435506,37095,0.13,61
191,It‚Äôs not just you the world stigmatizes is and calls us crazy,21094,2639,2018,29435506,23733,0.08,61
192,You are disrespectful to all people with mental health conditions so this is an opportunity for growth,33443,4673,2018,29435506,38116,0.13,102
193,Trust God,32780,9163,2018,29435506,41943,0.14,9
194,God sees all,28285,6906,2018,29435506,35191,0.12,12
195,Please take the devil üëø up out you bro,37067,6433,2018,29435506,43500,0.15,38
196,We‚Äôre making the world better at all times,19487,2506,2018,29435506,21993,0.07,42
197,This is for no ones entertainment,26296,3343,2018,29435506,29639,0.1,33
198,Or the Mandingo part on Jango,27144,3908,2018,29435506,31052,0.11,29
199,Drake I‚Äôm not going to physically fight you like it‚Äôs MTV boxing,90392,19902,2018,29435506,110294,0.37,64
200,How you gone be on Trav‚Äôs song coming at me. Trav should have never allowed that,52504,7617,2018,29435506,60121,0.2,80
201,How you gone text Kriss but not speak to me,44231,6104,2018,29435506,50335,0.17,43
202,We need to show the world that we will speak without someone ending up dead or in jail,27282,3965,2018,29435506,31247,0.11,86
203,We need to show people we can talk without people ending up dead or in jail,22836,3147,2018,29435506,25983,0.09,75
204,We need to show the world that people can talk without someone ending up dead or in jail,28951,4910,2018,29435506,33861,0.12,88
205,I‚Äôm up for talking.  We need to show all of these fans that black men can@talk without someone ending up dead or in jail,39575,5767,2018,29435506,45342,0.15,120
206,Ye never been easy.  I navigated these waters before you.  That‚Äôs why you could be you,43944,8636,2018,29435506,52580,0.18,86
207,You try to pick targets you think are easy,27788,4569,2018,29435506,32357,0.11,42
208,Talk tough to real gangsters bro,33172,6927,2018,29435506,40099,0.14,32
209,You say all this shut to me but won‚Äôt say none of that to J prince,24045,4023,2018,29435506,28068,0.1,66
210,You send emojis,78128,22965,2018,29435506,101093,0.34,15
211,Bro stop,96648,40379,2018,29435506,137027,0.47,8
212,You get people hurt at concerts,29288,4164,2018,29435506,33452,0.11,31
213,You pick@on people with mental health issues,30228,4393,2018,29435506,34621,0.12,44
214,You trying to be a bully. I never been bullied in my life and I never will be.  That‚Äôs why I made it this far in a pink polo,89445,18602,2018,29435506,108047,0.37,124
215,We both too high profile for you to actually do something to me,33817,4499,2018,29435506,38316,0.13,63
216,Snoop is my elder and an inspiration to me,41662,6829,2018,29435506,48491,0.16,42
217,There would never be a drake without a Kanye west so never come out your mouth with a threat,167156,53562,2018,29435506,220718,0.75,92
218,If I‚Äôm bipolar      This kind of shit can get me ramped,29084,4536,2018,29435506,33620,0.11,55
219,Stop the act,21872,4099,2018,29435506,25971,0.09,12
220,Now it‚Äôs a kid in@critical condition,17038,1861,2018,29435506,18899,0.06,36
221,Cause we rather act cool than sit and have a convo,27277,5552,2018,29435506,32829,0.11,50
222,That‚Äôs why black people never get ahead and and we stay controlled,30285,5671,2018,29435506,35956,0.12,66
223,You wouldn‚Äôt send purple emojis to scooter but you wanna need with your brother,19350,2456,2018,29435506,21806,0.07,79
224,I‚Äôm your oxygen,68805,25753,2018,29435506,94558,0.32,15
225,Don‚Äôt ever speak on 350s,46980,10365,2018,29435506,57345,0.19,24
226,Now he‚Äôs so street,29069,5489,2018,29435506,34558,0.12,18
227,I‚Äôm the guy with the pink polo that made a way for him,47353,11634,2018,29435506,58987,0.2,54
228,When I go through shit he fucks with me and I‚Äôm his idol,29577,5043,2018,29435506,34620,0.12,56
229,When Cudi was in the hospital he sent shots,39686,7328,2018,29435506,47014,0.16,43
230,He be texting people I know like it‚Äôs cool     But won‚Äôt sit and talk with me,24876,3768,2018,29435506,28644,0.1,77
231,He running around like he pac,49024,11569,2018,29435506,60593,0.21,29
232,Everybody knows somebody,24662,5100,2018,29435506,29762,0.1,24
233,I got a family and kids. 69 is locked up xxx is dead.  The kid that ran on stage is in the hospital,56805,11564,2018,29435506,68369,0.23,99
234,It just doesn‚Äôt sit right on my spirit,29199,6530,2018,29435506,35729,0.12,38
235,So drake if anything happens to me or anyone from my family you are the first suspect    So cut the tough talk,105460,24859,2018,29435506,130319,0.44,110
236,Since the pool line he‚Äôs been trying to poke at me and fuck with me,23288,3416,2018,29435506,26704,0.09,67
237,The kid he had run on stage at Pushas concert is in critical condition,28566,5359,2018,29435506,33925,0.12,70
238,Drake called trying to  threatened me,125559,29345,2018,29435506,154904,0.53,37
239,Trust God,50109,16304,2018,29435506,66413,0.23,9
240,By the way... not clearedüòÇ,81686,13498,2018,29435506,95184,0.32,26
241,Mission accomplished,60723,11680,2018,29435506,72403,0.25,20
242,Drake finally called,176160,32782,2018,29435506,208942,0.71,20
243,https://t.co/p22p3Eivdq,21112,4132,2018,29435506,25244,0.09,23
244,Stop this already bro      You getting people hurt out here     And over what,32235,5159,2018,29435506,37394,0.13,77
245,Buying first two rows at Pusha show  got me hot bro,45057,7462,2018,29435506,52519,0.18,51
246,https://t.co/YcnbZEnaKX,15464,2238,2018,29435506,17702,0.06,23
247,https://t.co/bKIxvMefT3,13743,1870,2018,29435506,15613,0.05,23
248,This ain‚Äôt about who could pay to have something done to somebody    This man to man bro    This been bothering me too long,28491,4819,2018,29435506,33310,0.11,123
249,No tough talk either,25726,4647,2018,29435506,30373,0.1,20
250,I would never intentionally try to hurt you bro     I never even heard none of the diss records      That ain‚Äôt my MO  never did a diss record,28417,4820,2018,29435506,33237,0.11,142
251,Sending purple emojis   When I‚Äôm dealing with mental shit      I need my apologies now      Not through scooter either     Not through Travis,41894,7443,2018,29435506,49337,0.17,141
252,It‚Äôs all love bro bro but don‚Äôt play with me.  You stay too close to be playing all these industry games bro,44076,9021,2018,29435506,53097,0.18,108
253,I told you I ain‚Äôt tell Pusha about your son,121273,26037,2018,29435506,147310,0.5,44
254,Been trying to meet with you for 6 months bro       You sneak dissing on trav records and texting Kris talking bout how‚Äôs the family,69804,13118,2018,29435506,82922,0.28,132
255,Still need that apology for mentioning the 350s and trying to take food out your idols kids mouths,41250,8654,2018,29435506,49904,0.17,98
256,This proves shit faker than wrestling https://t.co/E9wzNycJna,34682,8024,2018,29435506,42706,0.15,61
257,üëΩ https://t.co/Mxqjxr4nRm,13105,777,2018,29435506,13882,0.05,25
258,Went to visit the James Turrell crater two days ago. This is life changing. We all will live in Turrell spaces,9058,758,2018,29435506,9816,0.03,110
259,God answers your prayer three ways.   Yes not yet of I have a better plan for you.,67980,20467,2018,29435506,88447,0.3,82
260,Talking tree @FairchildGarden https://t.co/pXudOf656F,30212,4221,2018,29435506,34433,0.12,53
261,Calling out to Bob Dylan   Let‚Äôs get together,74937,9699,2018,29435506,84636,0.29,45
262,https://t.co/4jVN7WmXYj,8626,673,2018,29435506,9299,0.03,23
263,Croc https://t.co/LneQ4RCpbE,32264,4097,2018,29435506,36361,0.12,28
264,Message for Elon from @FairchildGarden https://t.co/crZJsSfkoc,5459,474,2018,29435506,5933,0.02,62
265,Landscaping is a conversation with God,69849,10518,2018,29435506,80367,0.27,38
266,Every no gets closer to a yes @gdizzle99 Gil Dezer,6917,734,2018,29435506,7651,0.03,50
267,https://t.co/3EeMC4xoxt,39393,2763,2018,29435506,42156,0.14,23
268,https://t.co/U9wbKa8zFL,16957,1639,2018,29435506,18596,0.06,23
269,https://t.co/PmECn2umP7,9271,964,2018,29435506,10235,0.03,23
270,https://t.co/ppoA8lYZbR,5196,350,2018,29435506,5546,0.02,23
271,Visit Fairchild Tropical Botanic Garden,6751,857,2018,29435506,7608,0.03,39
272,https://t.co/vqKmMDKOB8,5360,357,2018,29435506,5717,0.02,23
273,https://t.co/6GRIPN58yM,27726,3427,2018,29435506,31153,0.11,23
274,Orchids meant to plant throughout south Florida https://t.co/SKYuCegUSJ,9815,704,2018,29435506,10519,0.04,71
275,https://t.co/EAontNzOvb,4995,323,2018,29435506,5318,0.02,23
276,https://t.co/45kd1oCN4F,63897,16495,2018,29435506,80392,0.27,23
277,https://t.co/wZlaMucRX6,3680,408,2018,29435506,4088,0.01,23
278,https://t.co/NrSpU6oKZE     My favorite app https://t.co/cJlk8khVhU,42790,7837,2018,29435506,50627,0.17,67
279,"undrcvr jn tkhsh jkt 
vn clf brclt 
yzy ssn 6 t 
chrstn trssr dsgnd 700s stvn smth bttm 
brn dd swts frm dvr st mrkt jpn https://t.co/7KLNcpI4Gz",42328,6033,2018,29435506,48361,0.16,148
280,https://t.co/JoYM432L3N,11445,841,2018,29435506,12286,0.04,23
281,https://t.co/TPQLmXFvl3,5167,529,2018,29435506,5696,0.02,23
282,https://t.co/a652v6EbVq,27883,3859,2018,29435506,31742,0.11,23
283,https://t.co/8cEwJ84KGl,22345,1991,2018,29435506,24336,0.08,23
284,https://t.co/1PFwNkdW9s,8228,740,2018,29435506,8968,0.03,23
285,https://t.co/afZLCTvr8n,32001,3725,2018,29435506,35726,0.12,23
286,https://t.co/wLv1qBqccB,5169,343,2018,29435506,5512,0.02,23
287,Oscar Niemeyer https://t.co/Cdbr2fezA2,8934,1224,2018,29435506,10158,0.03,38
288,Vanessa Beecroft https://t.co/OL50oW9Mse,5658,541,2018,29435506,6199,0.02,40
289,https://t.co/qZbZT6Y2AY,5695,403,2018,29435506,6098,0.02,23
290,https://t.co/E2pL0YkHHu,22574,1303,2018,29435506,23877,0.08,23
291,We believe in love    We don‚Äôt just try we do.. we are... We are love,57911,12777,2018,29435506,70688,0.24,69
292,https://t.co/Nx4tMbooNK,11899,1559,2018,29435506,13458,0.05,23
293,Building a fireproof community,33000,3165,2018,29435506,36165,0.12,30
294,https://t.co/Pn4bdtmrsf,5866,808,2018,29435506,6674,0.02,23
295,I‚Äôd like to do an interview with Van Jones within the next 7 days üôåüèø,18429,1279,2018,29435506,19708,0.07,68
296,https://t.co/v8YKErjQ2V,4224,252,2018,29435506,4476,0.02,23
297,https://t.co/JuAxdZAc9z,2618,249,2018,29435506,2867,0.01,23
298,https://t.co/5IWo771bKc,3394,345,2018,29435506,3739,0.01,23
299,We sang Backstreet Boys I want it that way https://t.co/IzGHk7i7OP,81509,10050,2018,29435506,91559,0.31,66
300,Office shopping https://t.co/ghJTPTf9iV,43678,2877,2018,29435506,46555,0.16,39
301,"It felt so good being on the stage last night with my brother Cudi. After performing again, I realize the new album I‚Äôve been working on isn‚Äôt ready yet.  I‚Äôll announce the release date once it‚Äôs done. Thank you for understanding.",114985,11793,2018,29435506,126778,0.43,230
302,https://t.co/zicL4YTxCq,50937,6889,2018,29435506,57826,0.2,23
303,Show day https://t.co/RGE9MYZKnF,80088,10776,2018,29435506,90864,0.31,32
304,Loading in https://t.co/tEF8SEU4DR,58794,6173,2018,29435506,64967,0.22,34
305,https://t.co/efTSqIpMED,34875,4788,2018,29435506,39663,0.13,23
306,https://t.co/4ZdooNGEpR,36081,3959,2018,29435506,40040,0.14,23
307,"In light of these situations, I am so inspired by the firefighters and first responders who are risking their lives to do whatever they can to help. They are our true heroes.

We must all come together during these difficult times to support each other 

May God Bless us all",37721,3837,2018,29435506,41558,0.14,279
308,"My sincere condolences to everyone suffering from the loss of their homes, loved ones and the unknown certainty of how much damage the fires will have caused.",22388,2052,2018,29435506,24440,0.08,158
309,Thank you for everyone‚Äôs prayers.  Our family is safe and close,63713,4225,2018,29435506,67938,0.23,63
310,https://t.co/jSSXzisJom,34964,4085,2018,29435506,39049,0.13,23
311,Break the internet https://t.co/SKdC94OMQB,35290,3550,2018,29435506,38840,0.13,42
312,https://t.co/HC1ZbTYNlP,22430,4451,2018,29435506,26881,0.09,23
313,Raise confidence and consciousness,45668,12523,2018,29435506,58191,0.2,34
314,Remove stress,138017,46821,2018,29435506,184838,0.63,13
315,https://t.co/EYfZdq9X8w,79182,8632,2018,29435506,87814,0.3,23
316,McDonald‚Äôs is my favorite restaurant,267314,63851,2018,29435506,331165,1.13,36
317,https://t.co/4UMmxdK5Ow,10492,1068,2018,29435506,11560,0.04,23
318,https://t.co/yeEWzkeyrh,5565,755,2018,29435506,6320,0.02,23
319,https://t.co/q4poCymHYK,2895,254,2018,29435506,3149,0.01,23
320,Scoop https://t.co/7aykoIzr8L,199490,21581,2018,29435506,221071,0.75,29
321,https://t.co/EIYKuEEDjz,112601,25029,2018,29435506,137630,0.47,23
322,My eyes are now wide open and now realize I‚Äôve been used to spread messages I don‚Äôt believe in. I am distancing myself from politics and completely focusing on being creative !!!,319365,66657,2018,29435506,386022,1.31,178
323,I introduced Candace to the person who made the logo and they didn‚Äôt want their name on it so she used mine. I never wanted any association with Blexit. I have nothing to do with it.,26784,4064,2018,29435506,30848,0.1,182
324,"I would like to thank my family, loved ones, and community for supporting my ACTUAL beliefs and my vision for a better world.",37994,4707,2018,29435506,42701,0.15,125
325,"I support those who risk their lives to serve and protect us and I support holding people who misuse their power accountable.
 
I believe in love and compassion for people seeking asylum and parents who are fighting to protect their children from violence and war.",50825,7568,2018,29435506,58393,0.2,266
326,"I support creating jobs and opportunities for people who need them the most, I support prison reform, I support common-sense gun laws that will make our world safer.",43585,6084,2018,29435506,49669,0.17,165
327,https://t.co/e3nmwhdRZe,34269,3808,2018,29435506,38077,0.13,23
328,https://t.co/SsVqb4jCZ1,18036,1453,2018,29435506,19489,0.07,23
329,With Jacques Herzog   Office out in Basel https://t.co/8OESRCpkdY,9596,623,2018,29435506,10219,0.03,65
330,https://t.co/hiQwDn9czk,17448,3492,2018,29435506,20940,0.07,23
331,https://t.co/CxPOQ8RO0E,7960,2233,2018,29435506,10193,0.03,23
332,We‚Äôre about love unity and we design for the world,30856,4690,2018,29435506,35546,0.12,50
333,Hey mama https://t.co/kKZFLrHe2A,43109,3594,2018,29435506,46703,0.16,32
334,https://t.co/bqlhseb4UM,35416,4916,2018,29435506,40332,0.14,23
335,"‚ÄúBe anxious about nothing, but in everything, by prayer and supplication with thanksgiving, let your requests be made known to God.‚Äù - Philippians 4:6-7",33320,8230,2018,29435506,41550,0.14,152
336,Beautiful Detroit https://t.co/xNVGpCgY8R,16843,1538,2018,29435506,18381,0.06,41
337,"LaMelo Ball, JBA Has It's Face... Basketball Has Changed Forever https://t.co/UryBCcOCDA via @YouTube",4841,882,2018,29435506,5723,0.02,101
338,https://t.co/RSUroiB678,51976,5473,2018,29435506,57449,0.2,23
339,And TODAY on ESPN https://t.co/gRq1ONHpGW,42865,6963,2018,29435506,49828,0.17,41
340,https://t.co/7bvPWYJEDv,49732,6779,2018,29435506,56511,0.19,23
341,Trevi fountain https://t.co/gUO1wFowvq,15688,1375,2018,29435506,17063,0.06,38
342,Levels https://t.co/Z8U84USzAa,14311,970,2018,29435506,15281,0.05,30
343,Amazing Grace from Uganda https://t.co/uhqwWsv7kr,12764,1212,2018,29435506,13976,0.05,49
344,https://t.co/XOV5wwOtv4,57537,7519,2018,29435506,65056,0.22,23
345,https://t.co/9cTZmASBkT,134654,20058,2018,29435506,154712,0.53,23
346,https://t.co/o8euLSFTBV,4811,830,2018,29435506,5641,0.02,23
347,https://t.co/VVZ1KjgF2X,2061,196,2018,29435506,2257,0.01,23
348,https://t.co/IvwEpPHAdC       Our favor    All love,2970,337,2018,29435506,3307,0.01,51
349,https://t.co/trjAmzwUxL        Still my favorite,5587,672,2018,29435506,6259,0.02,48
350,https://t.co/9hrjwsgcvX,2479,278,2018,29435506,2757,0.01,23
351,https://t.co/JYN0ZXIsPx,3698,447,2018,29435506,4145,0.01,23
352,I love Dave La Chapelle‚Äôs art https://t.co/v1K5QxYXs9,18516,1458,2018,29435506,19974,0.07,53
353,All love https://t.co/PkXNeRff73,25088,2688,2018,29435506,27776,0.09,32
354,All love https://t.co/0j6Ut8IBC6,31249,3842,2018,29435506,35091,0.12,32
355,https://t.co/3jxISlskWP,2870,257,2018,29435506,3127,0.01,23
356,Yzy means solutions,16174,1793,2018,29435506,17967,0.06,19
357,Xxx the 18th your energy is with us üôèüèøüôèüèøüôèüèø https://t.co/XSI1qISNO4,25499,4213,2018,29435506,29712,0.1,66
358,https://t.co/6XVkrga1FG,10895,1186,2018,29435506,12081,0.04,23
359,https://t.co/jesE1VNzbQ,6220,966,2018,29435506,7186,0.02,23
360,Dancing,16642,2368,2018,29435506,19010,0.06,7
361,We Got Love https://t.co/5BnG8185LE,6030,1058,2018,29435506,7088,0.02,35
362,We got love https://t.co/8cuhHmhOKa,6995,1253,2018,29435506,8248,0.03,35
363,In the wild https://t.co/GR1HyBeoeg,3555,493,2018,29435506,4048,0.01,35
364,https://t.co/XQ4X2yfwpm,17383,2999,2018,29435506,20382,0.07,23
365,https://t.co/a0QrRcif4M,3174,406,2018,29435506,3580,0.01,23
366,https://t.co/jbq43pkVGf,8308,685,2018,29435506,8993,0.03,23
367,Spaceship calling earth| 3 Domes Uganda  https://t.co/8rlv7aTSav,7368,1943,2018,29435506,9311,0.03,64
368,Spaceship call earth| 3 Uganda Domes https://t.co/TtJgWrG7IS,3632,643,2018,29435506,4275,0.01,60
369,Running with North https://t.co/FRUg3tT7u7,4588,559,2018,29435506,5147,0.02,42
370,Mind control  https://t.co/YDYXQ45bDL,25666,8659,2018,29435506,34325,0.12,37
371,Mind control  https://t.co/EyvGLbulUJ,4130,634,2018,29435506,4764,0.02,37
372,Mind control https://t.co/rPzEXJWJ2f,3229,521,2018,29435506,3750,0.01,36
373,Aha https://t.co/in5yvHSbNh,6691,1138,2018,29435506,7829,0.03,27
374,https://t.co/pIvNpIABbd,3802,335,2018,29435506,4137,0.01,23
375,https://t.co/t6jYEP4sBH,11470,2962,2018,29435506,14432,0.05,23
376,https://t.co/h0UfWY6X1r,3608,377,2018,29435506,3985,0.01,23
377,https://t.co/pn8EE7JwSJ,3152,248,2018,29435506,3400,0.01,23
378,https://t.co/KfHMfuKMPa,2211,201,2018,29435506,2412,0.01,23
379,https://t.co/qM3jQrDZ5K,2841,242,2018,29435506,3083,0.01,23
380,https://t.co/sQtuXPKNL8,3326,273,2018,29435506,3599,0.01,23
381,https://t.co/n5bDyhU7M1,3156,356,2018,29435507,3512,0.01,23
382,https://t.co/tL6YOdzO6q,13227,1745,2018,29435507,14972,0.05,23
383,https://t.co/HxaBDteHmC,3960,489,2018,29435507,4449,0.02,23
384,https://t.co/8dnSUq2BGB,3056,300,2018,29435507,3356,0.01,23
385,https://t.co/ykJBI5sp2w,2646,320,2018,29435507,2966,0.01,23
386,https://t.co/ivHTfui2TC,2714,319,2018,29435507,3033,0.01,23
387,https://t.co/4HrbQk5r6E,2566,381,2018,29435507,2947,0.01,23
388,https://t.co/6DkTr1dC4q,2210,233,2018,29435507,2443,0.01,23
389,https://t.co/EDVNNejcsT,2461,276,2018,29435507,2737,0.01,23
390,https://t.co/m1CDyvsnIj,3161,250,2018,29435507,3411,0.01,23
391,https://t.co/2LU5NdbE7x,4167,315,2018,29435507,4482,0.02,23
392,we're at Pitbulls school SLAM https://t.co/byhISS7jPL,3860,398,2018,29435507,4258,0.01,53
393,reaching out to Colin Kaepernick. I would like you to speak with the president to tell him your experience directly. Let‚Äôs have a dialogue not a diatribe.,57666,7779,2018,29435507,65445,0.22,154
394,"We have to operate as one eco system. 

Poly Plastic in clothes get released into the environment when we wash those clothes",12756,1228,2018,29435507,13984,0.05,126
395,sitting here talking with my dad about issues with plastic. proposing initiatives/solutions. Use glass bottles/recycle. Transform used plastic to other usable forms. One of the forms will be canteens.,22601,2100,2018,29435507,24701,0.08,200
396,https://t.co/wgImASxi7I,10953,1637,2018,29435507,12590,0.04,23
397,"Why Do Inmates Fight Wildfires for Dollars a Day? The Origins of Prison Slavery in America.
https://t.co/sYLiQAHXv8",7595,1507,2018,29435507,9102,0.03,116
398,https://t.co/orKDyDKKJg,3552,535,2018,29435507,4087,0.01,23
399,https://t.co/EKIT3umtyM,7389,697,2018,29435507,8086,0.03,23
400,bedrock Detroit https://t.co/57m9pwKD2B,9485,1147,2018,29435507,10632,0.04,39
401,"overcome fear

My dad and I are going to eat this plate of bugs to celebrate him beating cancer. No more fear https://t.co/b3ywEX13v2",61160,6515,2018,29435507,67675,0.23,135
402,where‚Äôs the flying car department? Dan Gilbert,10352,907,2018,29435507,11259,0.04,46
403,https://t.co/VchXm0rZvD,4915,544,2018,29435507,5459,0.02,23
404,https://t.co/64ouji20rb,11627,1393,2018,29435507,13020,0.04,23
405,https://t.co/G5zbVyBPj2,4722,506,2018,29435507,5228,0.02,23
406,trying is lying - Dan Gilbert,9596,1469,2018,29435507,11065,0.04,29
407,https://t.co/Tm3fHlDbt2,4968,417,2018,29435507,5385,0.02,23
408,home is where the heart is,97374,26247,2018,29435507,123621,0.42,26
409,"Thank you Washington post
https://t.co/y8BcgVp8Lk",23409,3680,2018,29435507,27089,0.09,50
410,meeting with Big U and the Developing Options organization and the Crenshaw Rams football team https://t.co/2dvisPJFpK,10518,1005,2018,29435507,11523,0.04,118
411,Amer-I-Can https://t.co/OVWuRqs6qv,20314,2259,2018,29435507,22573,0.08,34
412,Meeting with members of Jim Browns Amer-I-Can program https://t.co/FIiaeAH0Q4,8734,906,2018,29435507,9640,0.03,77
413,"not abolish but. let‚Äôs amend the 13th amendment 

We apply everyone‚Äôs opinions to our platform",18741,1874,2018,29435507,20615,0.07,96
414,the 13th Amendment is slavery in disguise     meaning it never ended    We are the solution that heals,29326,4603,2018,29435507,33929,0.12,102
415,so lit üî•üî•üî• https://t.co/aqKIfBRUMx,87483,11387,2018,29435507,98870,0.34,34
416,this represents good and America becoming whole again.¬†¬†We will no longer outsource to other countries. We build factories here in America and create jobs.¬†¬†We will provide jobs for all who are free from prisons as we abolish the 13th amendment. Message sent with love https://t.co/a15WqI8zgu,114238,25553,2018,29435507,139791,0.47,292
417,no more cancel culture,38611,5427,2018,29435507,44038,0.15,22
418,Miuccia Prada is one my earth moms and I need to meet her in the next 2 weeks #facts,5878,425,2018,29435507,6303,0.02,84
419,by the way Unprogrammed is a new word,15700,2104,2018,29435507,17804,0.06,37
420,"just reached HARVEY we‚Äôre going to TMZ 2mrw morning 100 strong. We need strong beings dancers. Unprogrammed to bring love 

#wegotlove",8254,737,2018,29435507,8991,0.03,136
421,there is no such thing as one sides.  There‚Äôs infinite sides,22709,3536,2018,29435507,26245,0.09,60
422,Pardison Fontaine wrote the Violent Crimes verses. I changed 2 lines. He wrote the entire song though. Cyhi Cons Pardi. The ghost in the industry,14181,1718,2018,29435507,15899,0.05,145
423,We also work for Eddie Qüòä and all 123 thousand üçé crew members,8189,528,2018,29435507,8717,0.03,61
424,I will never be Steve. I will always be YE. We are here in service to Steve‚Äôs vision. Let‚Äôs make the planet üçé level,24600,2140,2018,29435507,26740,0.09,115
425,YZY Is a for purpose (non profit) arm (branch) of Apple.  We unofficially work for Steve Johnny Tim and Lorraine.  Everything we do at YZY is to be an arm (branch) of what our hero Steve has created. With love.,13091,1092,2018,29435507,14183,0.05,210
426,had so much fun at SNL. Lorne agreed that I would host before the year is out. Need to set a date. Gonna be sooooooooo lit.  In the words of Lil Pump ...Esskeetit !,51517,5054,2018,29435507,56571,0.19,164
427,üòÇüòÇüòÇ https://t.co/chUjeXmLRi,180683,26694,2018,29435507,207377,0.7,27
428,pull up with the YZY slides https://t.co/MClKJVJ4nq,89470,11975,2018,29435507,101445,0.34,51
429,"the being formally known as Kanye West   

I am YE",218588,38506,2018,29435507,257094,0.87,52
430,nino blu https://t.co/Mk9IlU6AcZ,50233,8073,2018,29435507,58306,0.2,32
431,let me put this in context. My reference to the word NO is never letting people stop your ambitions and dreams. As an artist We have had doors slammed in our face our whole lives. The freest place for an artist is the ability to get our ideas out. No more no‚Äôs to our ideas. https://t.co/hK1jHuQLP4,20404,3758,2018,29435507,24162,0.08,298
432,my favorite graphic ever. No more no‚Äôs¬†¬†¬†by Cali https://t.co/jaAw5jC3fk,12614,1132,2018,29435507,13746,0.05,72
433,https://t.co/dDhrjO8Xp0,5302,508,2018,29435507,5810,0.02,23
434,https://t.co/sH7sq5UxDB,13355,1211,2018,29435507,14566,0.05,23
435,https://t.co/rICnq4VnLF,5522,413,2018,29435507,5935,0.02,23
436,https://t.co/xAFnIdfi5z,6616,505,2018,29435507,7121,0.02,23
437,SNL https://t.co/VZuaffZwCR,73112,9227,2018,29435507,82339,0.28,27
438,we got love https://t.co/t0Ff8VhOvA,16608,1348,2018,29435507,17956,0.06,35
439,"YANDHI 9 29 18 

YANDHI IS RELEASING THIS SATURDAY https://t.co/ysqMrtc1RP",150315,51476,2018,29435507,201791,0.69,76
440,"We need Apple geniuses to aid us in making this happen. I also envision all TV shows and movies being shot on IPhone

Will be a lot easier for camera human beings üòÇüòÇüòÇ",11549,903,2018,29435507,12452,0.04,168
441,I see YZY as an arm of Apple    I‚Äôm at SNL rehearsal and we‚Äôre ‚Äútrying‚Äù to have the performance shot on an IPhone  Were receiving some push back.,8856,739,2018,29435507,9595,0.03,145
442,YZY is becoming a for purpose service organization,8629,773,2018,29435507,9402,0.03,50
443,not for profit is now for purpose,12231,1557,2018,29435507,13788,0.05,33
444,CHICAGO STATE colored adidas socks üß¶ https://t.co/stekcBS7hs,10765,913,2018,29435507,11678,0.04,60
445,"pharcyde other fish üê† playing at SNL

My love recites the lyrics to Passing me By. This is why I know this is my soul mate",7117,669,2018,29435507,7786,0.03,124
446,YZY SZN https://t.co/P0s3S41miG,30299,2999,2018,29435507,33298,0.11,31
447,https://t.co/S4X43suh9C,14603,1050,2018,29435507,15653,0.05,23
448,"we‚Äôre releasing Yandhi Saturday night 

We know it will come in number 2 to my brother Lil Wayne and that‚Äôs lovely 

The universe needs Ye and Wayne music at the same time",255883,69196,2018,29435507,325079,1.1,175
449,"The term literally means ""place of the¬†Way &lt;https://t.co/M1T31yUQax&gt;"" in Japanese

Schools will be dojos",4585,461,2018,29435507,5046,0.02,112
450,"Dojo
A¬†d≈çj≈ç¬†(ÈÅìÂ†¥ &lt;https://t.co/BMDKrR5vzG&gt;)¬†is a hall or space for immersive learning or meditation. This is traditionally in the field of martial arts, but has been seen increasingly in other fields, such as meditation and software development.",4478,589,2018,29435507,5067,0.02,251
451,"Words and names are vital when bringing something like the school into existence.¬†¬†Couple thoughts:¬†¬†Dao
The word for this concept,¬†dao, indicates a ‚Äúway‚Äù in the sense of a road or a path.",7104,719,2018,29435507,7823,0.03,189
452,over 300 samples and 3 years in the making and I give my pair to Ant Clemons for his Bday https://t.co/wC7Ox5gs0P,9014,703,2018,29435507,9717,0.03,113
453,Jedi training camp. We need a¬†light saber emoji¬†¬†I guess this crayon will have to do üñçüò≠ https://t.co/rnKSYk3yaz,19505,3004,2018,29435507,22509,0.08,111
454,ALPHA BEING SNL VIBES https://t.co/SCcYxHTBuR,6940,646,2018,29435507,7586,0.03,45
455,https://t.co/SSyk7GNc8G,11232,1430,2018,29435507,12662,0.04,23
456,Bari I appreciate your perspective and vision. You brought me closer to Rocky too. Jedis never let perception and cancel culture get between them.,9223,1043,2018,29435507,10266,0.03,146
457,Bari challenged me when no one else did and when he got in trouble I was scared to say he was my friend just like I did with xxx and that was some pussy shit on my part. I let the perception and the robots control me. That‚Äôs the true sunken place.,30110,3600,2018,29435507,33710,0.11,247
458,üôåüôåüôåüíúüíúüíú there‚Äôs no way I would have the number 1 record in the world without this man here.¬†¬†He broke me out of my pretentious rich nigga shell. https://t.co/PKQzE07xam,13056,1087,2018,29435507,14143,0.05,167
459,https://t.co/m8v3H4NGYd,12618,1175,2018,29435507,13793,0.05,23
460,https://t.co/DoBY5dA2n0,5870,643,2018,29435507,6513,0.02,23
461,https://t.co/MUfcM0bIq3,3406,342,2018,29435507,3748,0.01,23
462,https://t.co/eQb0RscFRw,3358,334,2018,29435507,3692,0.01,23
463,https://t.co/imBhc2zkEY,4183,471,2018,29435507,4654,0.02,23
464,Happy birthday Ant https://t.co/8qCgOqC5A4,13604,1039,2018,29435507,14643,0.05,42
465,"üôà‚ò∫Ô∏èüåçüíØüëΩüíúüöÄüôå 

üçélevel https://t.co/c7eY5jkjuI",30739,2322,2018,29435507,33061,0.11,44
466,working on the YZY operating system with Nick Knight and team https://t.co/fViQMFqJO6,9603,880,2018,29435507,10483,0.04,85
467,https://t.co/TWWaPMt2Lj,7005,542,2018,29435507,7547,0.03,23
468,YZY FD CLTHNG SHLTR XPSR https://t.co/VO890WArE6,9431,869,2018,29435507,10300,0.03,48
469,https://t.co/LhjJiGqYCT,7328,606,2018,29435507,7934,0.03,23
470,I think I stand pigeon toed cause of Michael Jordan üòä https://t.co/bDW5lSp3y2,26418,1968,2018,29435507,28386,0.1,77
471,https://t.co/z9sOHIeu65,33380,3472,2018,29435507,36852,0.13,23
472,namaste means the divine in me sees the divine in you.   Namaste - the divine is us,36176,7741,2018,29435507,43917,0.15,83
473,the term followers should be changed to observers. We need to follow our spirit,50158,8348,2018,29435507,58506,0.2,79
474,art gives people the freedom to think - President Z Scott of Chicago State,11155,1643,2018,29435507,12798,0.04,74
475,same field https://t.co/2lwQF6jhOY,49882,4853,2018,29435507,54735,0.19,34
476,happy Sunday https://t.co/0TKouJckov,129771,13796,2018,29435507,143567,0.49,36
477,our minds and spirits are endless https://t.co/f8pGZPxoqa,25179,3882,2018,29435507,29061,0.1,57
478,we‚Äôre upgrading our operating systems,19665,2239,2018,29435507,21904,0.07,37
479,https://t.co/Ud82Hod3Vk,4830,290,2018,29435507,5120,0.02,23
480,https://t.co/llaC6ZaQTu,5074,420,2018,29435507,5494,0.02,23
481,"when you at the sugar factory make sure you get that mirror shot 

This is not a paid tweet üòÇ https://t.co/t66gbDEkSN",82499,7247,2018,29435507,89746,0.3,119
482,convo with Ben Schwerin from Snapchat https://t.co/FElSmLI43e,16270,1471,2018,29435507,17741,0.06,61
483,"I‚Äôd rather someone give me INSIGHT than to EXCITE me 

People always try to get you EXCITED so they can manipulate you. They will have the INSIGHT and not share it with you 

EXPOSURE is key",49234,10880,2018,29435507,60114,0.2,194
484,https://t.co/cnLijHSjaN,40363,7522,2018,29435507,47885,0.16,23
485,a lot of human beings think this is what love means https://t.co/9JgLBvEiSt,36258,8418,2018,29435507,44676,0.15,75
486,YANDHI 9 29 18 https://t.co/iYWFUJ07oo,29516,5479,2018,29435507,34995,0.12,38
487,YANDHI 9 29 18 https://t.co/kaAUj1iTVt,21225,3849,2018,29435507,25074,0.09,38
488,YANDHI 9 29 18 https://t.co/CfpIBe5gBs,13188,1990,2018,29435507,15178,0.05,38
489,YANDHI 9 29 18 https://t.co/nAgOzWLuut,17515,2849,2018,29435507,20364,0.07,38
490,we‚Äôre building DONDA schools in Chicago,17017,1868,2018,29435507,18885,0.06,39
491,Having your amount of likes on display for the world to see and judge is like showing how much money you have in the bank or having to write the size of your dick on your t shirt,64058,11830,2018,29435507,75888,0.26,178
492,Speaking for myself I personally want to participate in social media with the option of not having to show my followers or likes,22448,3357,2018,29435507,25805,0.09,128
493,There are people who are committing suicide due to not getting enough likes. Seeking validation in the simulation.¬†¬†We need a live-streamed meeting with Jack Dorsey Kevin Systrom Mike Krieger Mark Zuckerberg and Evan Spiegal. https://t.co/boAbEDqIyG,17087,2570,2018,29435507,19657,0.07,249
494,Just got this pic from Mikkey https://t.co/LiVjHEudtP,8838,682,2018,29435507,9520,0.03,53
495,https://t.co/OF3HtCqgbP,14066,2683,2018,29435507,16749,0.06,23
496,need a slide emoji https://t.co/OMe4nrWuOf,15949,1319,2018,29435507,17268,0.06,42
497,relearning how to code.  I knew how to in 7th grade when I was programming a video game,56536,5787,2018,29435507,62323,0.21,87
498,we design everything we put our soul in,23572,4606,2018,29435507,28178,0.1,39
499,https://t.co/ecWZiHQ0NN,21042,2226,2018,29435507,23268,0.08,23
500,https://t.co/KNaLXXQ2lG,6821,687,2018,29435507,7508,0.03,23
501,https://t.co/faO1r5bvi6,5219,416,2018,29435507,5635,0.02,23
502,https://t.co/EuYTmA43md,4334,354,2018,29435507,4688,0.02,23
503,https://t.co/vhPd7dFtd7,2857,259,2018,29435507,3116,0.01,23
504,https://t.co/DVpg73qYBg,3843,416,2018,29435507,4259,0.01,23
505,https://t.co/gKMOamzALJ,3094,314,2018,29435507,3408,0.01,23
506,https://t.co/j8X4peqTnm,3061,297,2018,29435507,3358,0.01,23
507,https://t.co/ez6VtIW26K,2788,264,2018,29435507,3052,0.01,23
508,https://t.co/aNzvg3XH9w,2594,253,2018,29435507,2847,0.01,23
509,https://t.co/tzkHCxq6Re,2499,233,2018,29435507,2732,0.01,23
510,https://t.co/0kTfTDcFaK,2821,378,2018,29435507,3199,0.01,23
511,https://t.co/RyZQc8Ms8o,3011,299,2018,29435507,3310,0.01,23
512,https://t.co/DoKeVlitgf,2930,316,2018,29435507,3246,0.01,23
513,Gaudi https://t.co/xKTpteUBAF,7819,563,2018,29435507,8382,0.03,29
514,activity on the 350 today https://t.co/nch4PffRNz,7718,710,2018,29435507,8428,0.03,49
515,holographic https://t.co/Xm4pjuflES,139091,26043,2018,29435507,165134,0.56,35
516,with the zoom in for anyone concerned with the man made construct of numbers.¬†¬†The universe is infinite and also obviously on our mthrfckng side https://t.co/G3EWrLjYwh,9628,1002,2018,29435507,10630,0.04,168
517,Holographic,21322,2453,2018,29435507,23775,0.08,11
518,a conversation with My friend Jack the head of twitter https://t.co/9WawmuCAg1,5168,583,2018,29435507,5751,0.02,78
519,https://t.co/jhSWjt56uL,2550,277,2018,29435507,2827,0.01,23
520,famleeeeee https://t.co/sqhHtxIRPh,4006,668,2018,29435507,4674,0.02,34
521,my love is so beautiful üòç https://t.co/Tjm9W86iak,6681,801,2018,29435507,7482,0.03,49
522,https://t.co/1n0yM79SIt,2257,215,2018,29435507,2472,0.01,23
523,https://t.co/jP0bxGltvD,2180,211,2018,29435507,2391,0.01,23
524,Apple üçé and YZY¬†¬†sounds about right üöÄüöÄüöÄüöÄüíúüíúüíúüíúüîÆüîÆüîÆüîÆüëΩüëΩüëΩüôã‚Äç‚ôÇÔ∏è https://t.co/Uq5ArSlcdd,5557,660,2018,29435507,6217,0.02,79
525,https://t.co/nxIQNp3zHV,2494,367,2018,29435507,2861,0.01,23
526,https://t.co/OxiM6Cpr0O,2690,403,2018,29435507,3093,0.01,23
527,https://t.co/tgyl4Z3jpQ,2901,464,2018,29435507,3365,0.01,23
528,https://t.co/oj7OTIyyNe,2507,378,2018,29435507,2885,0.01,23
529,this is lovely. Ben from Snapchat text my wife this. https://t.co/veB6DdEjvm,4268,362,2018,29435507,4630,0.02,76
530,Social media can be good but we have to hold the heads responsible for the psychological damage it sometimes causes. https://t.co/g81IBjqqaK,10714,1931,2018,29435507,12645,0.04,140
531,we should be able to participate in social media without having to show how many followers or likes we have. Just like how we can turn off the comments we should be able to turn off the display of followers. This has an intense negative impact on our self worth.,211240,44502,2018,29435507,255742,0.87,262
532,YZY BSKTBL https://t.co/jRIISnZr2Y,7011,972,2018,29435507,7983,0.03,34
533,https://t.co/uxxbP9elUS,34723,5663,2018,29435507,40386,0.14,23
534,https://t.co/7mRgxIOcQC,4078,368,2018,29435507,4446,0.02,23
535,#wegotlove campaign/photos shot by Rita Minissi,6583,471,2018,29435507,7054,0.02,47
536,music is space between noise,79118,17271,2018,29435507,96389,0.33,28
537,https://t.co/PuN8QhnxNV,159526,49525,2018,29435507,209051,0.71,23
538,https://t.co/vZ6wXq9GTD,11730,1104,2018,29435507,12834,0.04,23
539,https://t.co/iYz8ZM1wjp,8005,804,2018,29435507,8809,0.03,23
540,https://t.co/VBLhl3lydG,31156,3733,2018,29435507,34889,0.12,23
541,https://t.co/QUDGJruPoN,9441,1218,2018,29435507,10659,0.04,23
542,https://t.co/AhYmLnLUl5,6864,658,2018,29435507,7522,0.03,23
543,https://t.co/Sp5ZGqDM1P,6926,679,2018,29435507,7605,0.03,23
544,https://t.co/u2Iqeg8L97,5574,468,2018,29435507,6042,0.02,23
545,https://t.co/oUaXoYwusu,5918,584,2018,29435507,6502,0.02,23
546,https://t.co/LbuBNAxn97,10704,1003,2018,29435507,11707,0.04,23
547,https://t.co/fLGcmeSawc,11766,1720,2018,29435507,13486,0.05,23
548,https://t.co/2ggHxbHpTp,7238,756,2018,29435507,7994,0.03,23
549,https://t.co/CHeh2KwsUW,6946,757,2018,29435507,7703,0.03,23
550,https://t.co/oQRLgsGCRp,6165,642,2018,29435507,6807,0.02,23
551,https://t.co/om59nr2qRt,9326,1035,2018,29435507,10361,0.04,23
552,https://t.co/FY2apn2hzd,22579,2417,2018,29435507,24996,0.08,23
553,https://t.co/b8yeRkR6yx,9994,1001,2018,29435507,10995,0.04,23
554,https://t.co/GwCcmAe1WN,163479,38122,2018,29435507,201601,0.68,23
555,https://t.co/lopkmtvqE5,9116,848,2018,29435507,9964,0.03,23
556,https://t.co/O3pjH3CuGU,12500,1268,2018,29435507,13768,0.05,23
557,https://t.co/r1lZx6de4t,6477,492,2018,29435507,6969,0.02,23
558,https://t.co/7OeBE7lGSj,4278,433,2018,29435507,4711,0.02,23
559,https://t.co/zDNc2Y4Rco,3726,383,2018,29435507,4109,0.01,23
560,https://t.co/TOqX4LNEWM,6039,712,2018,29435507,6751,0.02,23
561,we don‚Äôt need to ever be excited we need to just be,24816,4506,2018,29435507,29322,0.1,51
562,no if ands or buts,20644,5474,2018,29435507,26118,0.09,18
563,we need consideration,14534,3226,2018,29435507,17760,0.06,21
564,we are divine,31664,7750,2018,29435507,39414,0.13,13
565,üåúüåçüåõ,23799,4297,2018,29435507,28096,0.1,3
566,love is the absence of pride,93832,28260,2018,29435507,122092,0.41,28
567,https://t.co/Ftsd5KdCQF https://t.co/xlNnjtmDZ4,8131,1077,2018,29435507,9208,0.03,47
568,https://t.co/uHihkTGrCS https://t.co/uhLhqbNjA4,6191,619,2018,29435507,6810,0.02,47
569,Donda House üôèüëΩüëΩ https://t.co/i4pfZiZmeN,4709,417,2018,29435507,5126,0.02,39
570,"üòÇüòÇüèà

https://t.co/wc41OWpHoo",3613,287,2018,29435507,3900,0.01,30
571,https://t.co/9o45sTcogJ,3312,281,2018,29435507,3593,0.01,23
572,enhance structure,31806,4416,2018,29435507,36222,0.12,17
573,"Film concept: a being purchases a Merriam-Webster‚Äôs dictionary from Walgreens to  highlight positive words in orange and negative words in yellow crafting language charged by African parables willing universal power manifesting world peace 

https://t.co/YLmJZYWCDR",13927,1514,2018,29435507,15441,0.05,267
574,Me Troy Justin and Scooter will have dinner and build on how we will make our world better. Sending positive energy,37381,2708,2018,29435507,40089,0.14,115
575,"sending good energy to my brother Ricardo for his first Burberry show 

https://t.co/seuuw0Wj8C",8525,652,2018,29435507,9177,0.03,97
576,yoga dance meditation,38772,5300,2018,29435507,44072,0.15,21
577,we‚Äôre creating a film called Spiritual Telephone.,44136,3874,2018,29435507,48010,0.16,49
578,eating dishes served with Gullah Geechee heritage,14880,1118,2018,29435507,15998,0.05,49
579,https://t.co/FLASwktK0g,10840,2096,2018,29435507,12936,0.04,23
580,our whole culture is about balance,62960,10139,2018,29435507,73099,0.25,34
581,when you think of something positive say it out loud. Keep putting that vibe into the universe.,279251,92463,2018,29435507,371714,1.26,95
582,love is serving others - Maurice Armitage,38558,7300,2018,29435507,45858,0.16,41
583,change I want to we need,76606,14327,2018,29435507,90933,0.31,24
584,we don‚Äôt try we do,149963,50212,2018,29435507,200175,0.68,18
585,Love vs. Fear   I love when human beings are supported for using their voice,35486,5684,2018,29435507,41170,0.14,76
586,I stand for giving everyone a voice. Adidas giving me a voice and Nike giving Colin voice on a big business level makes the world a more advanced place.,74882,8685,2018,29435507,83567,0.28,152
587,"The triple white 350 release fulfills YEEZYS democracy philosophy. Removing the concept of making limited product this is the most widespread release today.

Sign up at https://t.co/HikjJEC4Tq and¬†¬†https://t.co/pU1Ld7X6Pa",18378,2692,2018,29435507,21070,0.07,223
588,fear is the absence of love and fear is the source of all of our evil. love is the absence of fear and love is the source of all of our greatness.,127174,36899,2018,29435507,164073,0.56,146
589,Neil Strauss is the only writer that Larry Hoover would trust to do his book and me and GLC bumped into him at dinner with Rick Rubin tonight. We put Neil on the phone with Ms Winndye. The universe is incredible,11461,920,2018,29435507,12381,0.04,211
590,We‚Äôre doing Chicago Comedy Jam.  We‚Äôre going to restore the Regal Theatre,20914,2017,2018,29435507,22931,0.08,73
591,I will teach a course at the Art Institute of Chicago and the American Academy of Art,70560,6603,2018,29435507,77163,0.26,85
592,we need to be overwhelmed with love and inspiration,117283,39037,2018,29435507,156320,0.53,51
593,it is super inspiring I‚Äôd even say it is overwhelming which is my favorite description,14379,1191,2018,29435507,15570,0.05,86
594,We visited theaster gates stony island art bank last week,8494,534,2018,29435507,9028,0.03,57
595,We‚Äôre putting a Yeezy office in Chicago,62197,5686,2018,29435507,67883,0.23,39
596,throne2 coming soon,255740,84535,2018,29435507,340275,1.16,19
597,2024,93889,16712,2018,29435507,110601,0.38,4
598,We are Gods,100261,25124,2018,29435507,125385,0.43,11
599,I can only be the boss. I don‚Äôt have the time otherwise. It takes time to talk people into things. It takes no time to tell people what to do.,88327,19049,2018,29435507,107376,0.36,142
600,https://t.co/d3w2h2tFF5 live in 15 min,12128,1685,2018,29435507,13813,0.05,38
601,This is all Jedi level. I will be coming to your show within the next seven days to give love and be inspired by the art you have created.,57070,7766,2018,29435507,64836,0.22,138
602,I understand Pusha‚Äôs issues as a man if someone mentions your fianc√© men go mask off. I‚Äôve done the same myself at times. I love you and I love Pusha and we all have an admiration for each other‚Äôs craft.,33117,5074,2018,29435507,38191,0.13,203
603,I did not have any conversations about your child with Pusha. I don‚Äôt play with the idea of people‚Äôs children after I spoke to Wiz a few years earlier.,70990,11224,2018,29435507,82214,0.28,151
604,I never listened to either diss track that followed but I did hear quotes from both songs after they were released,22228,3482,2018,29435507,25710,0.09,114
605,since we were building as friends and brothers I should have spoken to Pusha about the Quentin Miller bar. There should have been no songs with my involvement that had any negative energy towards you,25291,4155,2018,29435507,29446,0.1,199
606,plane taxiing for take off... because we spoke about doing Lift Yourself together I should have given you the opportunity for us to do this together before I released it,18149,2827,2018,29435507,20976,0.07,169
607,When I put the dates up I was a bit ramped up doing 25 tweets a day  TMZ happened shortly after ‚Ä¶    I have to hop on the plane now‚Ä¶  will type more when I land,20944,3023,2018,29435507,23967,0.08,160
608,Let me start by  apologizing for stepping on your release date in the first place ‚Ä¶  We were building a bond and working on music together  including squashing the issues with Cudi at our office.,35914,5333,2018,29435507,41247,0.14,195
609,"Sending good energy and love to Drake and family and crewüíúüíúüíú 

I haven‚Äôt seen the show in person but the images look incredible online 

I understand where the confusion started https://t.co/oxSEEbNB1g",53155,9351,2018,29435507,62506,0.21,205
610,"set in Goudy font, from Chicago https://t.co/75e3gX7uxQ",5629,452,2018,29435507,6081,0.02,55
611,https://t.co/UpRckAnGX4,7422,1098,2018,29435507,8520,0.03,23
612,Michael we love you,73500,14479,2018,29435507,87979,0.3,19
613,the world is the new art school,59456,12151,2018,29435507,71607,0.24,31
614,let‚Äôs make ourselves happy,188816,85034,2018,29435507,273850,0.93,26
615,If I don‚Äôt lose myself... it‚Äôs not me -George Condo,30633,5289,2018,29435507,35922,0.12,51
616,there‚Äôs no such thing as an old living person    people from thousands of years ago perhaps are old      if you‚Äôre alive you‚Äôre young,50985,7872,2018,29435507,58857,0.2,133
617,offering a service is having a purpose,32470,6460,2018,29435507,38930,0.13,38
618,Halloween is the only day you‚Äôre not in a costume,165683,42774,2018,29435507,208457,0.71,49
619,This is not only the greatest animation achievement in history       the subject matter is so relevant to the current state of the world,15111,1832,2018,29435507,16943,0.06,136
620,Every stage show I‚Äôve ever worked on       Every video    not just Stronger      every product    even when I was in the hospital   I would think‚Ä¶ oh shit this is like Akira,30583,4438,2018,29435507,35021,0.12,173
621,"https://t.co/48B0T5HeRk

When we work on our shoes   apparel and accessories   I just think  ...    If this thing was chasing you ...       what do you want to be wearing?",12539,1802,2018,29435507,14341,0.05,173
622,creating a universal language is super fun,49864,5600,2018,29435507,55464,0.19,42
623,My friend Anthony Schiller pointed out that I didn‚Äôt mention Ernest Cline when I tweeted about Ready Player one. Ernest I‚Äôd like to meet you.,17323,1086,2018,29435507,18409,0.06,141
624,spend as much time outside as possible     fresh air is healing,151161,36766,2018,29435507,187927,0.64,63
625,stay inspired,116885,39977,2018,29435507,156862,0.53,13
626,2015 feels like just yesterday   Adidas is a great partner,53189,4400,2018,29435507,57589,0.2,58
627,deprogram,26294,5492,2018,29435507,31786,0.11,9
628,we‚Äôre no longer fighting for change we‚Äôre simply changing things,96945,24289,2018,29435507,121234,0.41,64
629,operation try love    take someone you don‚Äôt like and say something you like about them out loud,67569,14669,2018,29435507,82238,0.28,96
630,no one is better than anyone,212898,73166,2018,29435507,286064,0.97,28
631,https://t.co/GMoi5FfJTp,8917,1658,2018,29435507,10575,0.04,23
632,https://t.co/hMvsSTpGv0   @trvisXX,13176,2084,2018,29435507,15260,0.05,34
633,I was so happy when I saw Jimmy walk out in the Yeezys. That was an olive branch. He lead with love. I appreciate Jimmy and his team. You guys are Jedi‚Äôs.   much love.,60703,4185,2018,29435507,64888,0.22,167
634,The question was so important I took time to think. And then I was hit with the let‚Äôs go to commercial break. That interview showed strong personalities with different opinions having a civil conversation.,89578,12217,2018,29435507,101795,0.35,205
635,On Jimmy Kimmel  we had a great time having a dialogue. I‚Äôm reading that I was stumped by a question. Let me clarify the click bait. I wasn‚Äôt stumped. I wasn‚Äôt given a chance to answer the question.,110242,17882,2018,29435507,128124,0.44,198
636,üî•üî•üî• https://t.co/qcPA5Pjhlj,102771,22211,2018,29435507,124982,0.42,27
637,Tadao Ando https://t.co/dpROMvnrCF,5286,640,2018,29435507,5926,0.02,34
638,turn shame to power,72607,19385,2018,29435507,91992,0.31,19
639,I‚Äôm working on removing the word I ...correction we‚Äôre working on removing the word I,59849,7350,2018,29435507,67199,0.23,85
640,https://t.co/2H00wzVl87,17673,3681,2018,29435507,21354,0.07,23
641,"üî•üî•üî•üî•Caiden Cop Shot The Kid

https://t.co/otyccZCACH",8133,881,2018,29435507,9014,0.03,54
642,You guys are so important and what you do is so special and inspiring to our planet       Thank you for being so great,114638,17152,2018,29435507,131790,0.45,118
643,Steve Jobs you are one of my biggest inspirations and your story spirit and drive helps to push me everyday      congratulations on Apple hitting a trillion dollars also congrats to Eddie Q and Johnny Ives and Tim Cook and the entire Apple team,64887,8202,2018,29435507,73089,0.25,244
644,when speaking about sections of the company I like to use the word arms instead of divisions,35257,3080,2018,29435507,38337,0.13,92
645,inject a bit of love like it‚Äôs an IV drip,41479,9571,2018,29435507,51050,0.17,41
646,do things from love    not ego and not pride,183008,67273,2018,29435507,250281,0.85,44
647,instead of saying I‚Äôm proud you can say I love this,32994,5981,2018,29435507,38975,0.13,51
648,replace pride with love,67807,25267,2018,29435507,93074,0.32,23
649,Follow your heart and find your tribe. Your tribe are people with similar passions,139556,40417,2018,29435507,179973,0.61,82
650,you can love people that you don‚Äôt want to go to lunch with everyday,105957,23834,2018,29435507,129791,0.44,68
651,you can love everyone but everyone isn‚Äôt your tribe,71516,20523,2018,29435507,92039,0.31,51
652,love everyone,43433,12394,2018,29435507,55827,0.19,13
653,love is infectious,31336,8123,2018,29435507,39459,0.13,18
654,love is generous,33250,8796,2018,29435507,42046,0.14,16
655,pride is one of the deadliest sins,70938,22739,2018,29435507,93677,0.32,34
656,pride is selfish,37407,10327,2018,29435507,47734,0.16,16
657,"How to NOT kill yourself pt 1

Avoid being around people who make you want to kill yourself",581291,188989,2018,29435507,770280,2.62,93
658,"To make this clear and not weird 
I‚Äôve had these kinds of thoughts and I‚Äôm going to tell you things I‚Äôve done to stay in a content place.",27562,3143,2018,29435507,30705,0.1,138
659,I saw the Alexander McQueen documentary and I connected with his journey. I know how it feels to want to take your life back into your own hands even if it means taking your own life.,31574,3764,2018,29435507,35338,0.12,183
660,trust your feelings don‚Äôt calculate your perception,105586,33434,2018,29435507,139020,0.47,51
661,break the status quo,38852,8875,2018,29435507,47727,0.16,20
662,stop trying     start doing,192734,71933,2018,29435507,264667,0.9,27
663,love everyone,102843,32686,2018,29435507,135529,0.46,13
664,I‚Äôm not taking no advice for the rest of my life,179051,49163,2018,29435507,228214,0.78,48
665,I hate talking about things I‚Äôm supposed to talk about,102057,28168,2018,29435507,130225,0.44,54
666,feeling super creative,140952,25864,2018,29435507,166816,0.57,22
667,"this is amazing  @Project2one5 and @TEYANATAYLOR 
We gotta send them some Yeezys though üôåüôåüôå  https://t.co/c1yCTEm6ql",10362,980,2018,29435507,11342,0.04,117
668,"The universe is on our side, I‚Äôm so excited",162762,37032,2018,29435507,199794,0.68,43
669,"It‚Äôs just another example of elitism and classism.   If you read Prince or Michael‚Äôs Wikipedia their title is recording artist     

Moving forward anyone working in music should be referred to as a recording artist",28554,3481,2018,29435507,32035,0.11,217
670,"Music is an art form.   When reporters call me ‚Äúthe singer,‚Äù the rapper"" or even the ""pop star"" there‚Äôs an air of condescension and patronization.   Those kinds of  journalist are acting like they‚Äôre better than us.",63092,8375,2018,29435507,71467,0.24,215
671,I had a sinus headache on a flight once and I got a fucking cat scan after because it was so bad,70359,7342,2018,29435507,77701,0.26,96
672,Whenever you‚Äôre feeling down bored irritated or disgruntled just say‚Ä¶ thank god I don‚Äôt have a sinus headache ‚Ä¶ they feel like the episode of black mirror when the bee went into the guys ear...,147770,24984,2018,29435507,172754,0.59,193
673,creatives need each other,164342,49082,2018,29435507,213424,0.73,25
674,when in doubt... don‚Äôt,226123,72259,2018,29435507,298382,1.01,22
675,wholesale is dangerous for creatives,36393,5093,2018,29435507,41486,0.14,36
676,Yeezy is an organization ran by the creative. The creative make the final decisions here.,63202,6825,2018,29435507,70027,0.24,89
677,Chasing validation is like putting your soul in a plank position,195337,57358,2018,29435507,252695,0.86,64
678,"I used to spend every moment I had free at the Moss store 

https://t.co/8Mo2AkKGVx",7580,642,2018,29435507,8222,0.03,85
679,https://t.co/keACtfDvtD,6942,846,2018,29435507,7788,0.03,23
680,https://t.co/hUzYzgu45U,11384,1437,2018,29435507,12821,0.04,23
681,the universe is on our side bro,247108,64996,2018,29435507,312104,1.06,31
682,sometimes I have trouble saying no because I want to help everyone,264771,95978,2018,29435507,360749,1.23,66
683,this is new for me but it‚Äôs just how I feel now. I don‚Äôt know why. I thought my ego protected me from doubters so that I wouldn‚Äôt doubt myself but there has to be a better way to do this,36598,5296,2018,29435507,41894,0.14,186
684,Who or what is Kanye West with no ego? Just Ye,80826,11599,2018,29435507,92425,0.31,46
685,I killed my ego,95537,19750,2018,29435507,115287,0.39,15
686,your pride can be and will be used against you,68268,22266,2018,29435507,90534,0.31,46
687,be great without pride,40031,12056,2018,29435507,52087,0.18,22
688,give without pride,30153,7744,2018,29435507,37897,0.13,18
689,üò¢üôèüôèüôèüôè https://t.co/0Z5HDZFnx4,37753,4515,2018,29435507,42268,0.14,29
690,Leaders create leaders,156469,46593,2018,29435507,203062,0.69,22
691,Supermoon YEEZY desert rat campaign shot by Eli Linnetz üî•üî•üî•üî•üî•üî•üî•üî•üî•üî•üî•üî•üî•üî•üî•üî•üî•üî•,16135,1403,2018,29435507,17538,0.06,74
692,freeeeeeeeeee https://t.co/ioKUaaVy2a,6396,579,2018,29435507,6975,0.02,37
693,I be taking naps,315072,162735,2018,29435507,477807,1.62,16
694,Bloody Dior in Wyoming hoodie https://t.co/RkRAtb0BfL,7236,786,2018,29435507,8022,0.03,53
695,https://t.co/V7ZeBuufOB,10903,2095,2018,29435507,12998,0.04,23
696,your guys writing and approach is so innovative ‚Ä¶ I love how you guys break the 4th wall‚Ä¶ thank you for being innovative and please know I‚Äôm down to clear next time,34937,2733,2018,29435507,37670,0.13,164
697,I love both Deadpool moviesüî•üî•üî•üî•üî•üî•üî•üî•üî•‚Ä¶  I heard tracks in it that sound similar to mine‚Ä¶  bro I would have cleared my music for Deadpool ‚Ä¶,163405,15269,2018,29435507,178674,0.61,137
698,Thank you to everyone who supported our 8th number 1 album  üôåüôåüôåüî•üî•üî•üî•üî•üî•üî•üî•üî•üî•üî•üî•üî•üî•üî•üî•üî•üî•üî•üî•üî•   all love   all great energy    all new soundtracks to the summer    all great vibes     all great frequencies,145630,17913,2018,29435507,163543,0.56,196
699,https://t.co/PsUa8R6g67,9391,887,2018,29435507,10278,0.03,23
700,We‚Äôre trying new ideas without the fear of not being perfect‚Ä¶  It‚Äôs just a gut feeling sometimes‚Ä¶ just making stuff with your friends‚Ä¶,107431,20500,2018,29435507,127931,0.43,134
701,We‚Äôre here creating in real time just having fun.     I hear the albums blasting out of the cars when I walk down the street.  Kids come up to me and tell me their favorite songs.   We‚Äôre experimenting with new sounds structures and ideas.,60109,7762,2018,29435507,67871,0.23,239
702,Just wanted to say I‚Äôm up in the morning working on the Nas album  and I‚Äôm so humbled by all the love we‚Äôre getting on these albums.   We‚Äôre still the kids we used to be.,151328,20017,2018,29435507,171345,0.58,170
703,üòÇ https://t.co/0cbuZDQSuO,10886,1122,2018,29435507,12008,0.04,25
704,Download the @WAV_Media app https://t.co/HxSvFHiSrY to watch the livestream of the KIDS SEE GHOSTS listening party tonight @ 8pm PST,18326,3501,2018,29435507,21827,0.07,132
705,https://t.co/ssV4UeFpiL,54651,5938,2018,29435507,60589,0.21,23
706,https://t.co/r2idQETRCQ,25313,4691,2018,29435507,30004,0.1,23
707,https://t.co/bYVgnuMASB,9190,925,2018,29435507,10115,0.03,23
708,#1 in 83 countries üôåüôåüôå  https://t.co/Z8FC9LPL7W,56462,8164,2018,29435507,64626,0.22,47
709,I‚Äôve never been about beef¬†¬†¬†¬†I‚Äôm about love ¬† ¬†lines were crossed and it‚Äôs not good for anyone ¬† ¬†so this is dead now,156752,27503,2018,29435507,184255,0.63,118
710,https://t.co/xYu7lH1rZ7,20897,3140,2018,29435507,24037,0.08,23
711,"Download the @WAV_Media app https://t.co/HxSvFHiSrY¬†¬†to watch the livestream of my album listening tonight in Jackson Hole, Wyoming 7PM MDT",25445,5819,2018,29435507,31264,0.11,139
712,New  Flacko üî•üî•üî•üî•üî•üî•üî•üî•üî•üî•üî•üî•üî•üî•üî•üî•üî• https://t.co/F3lAEVGX4A,77075,18244,2018,29435507,95319,0.32,53
713,gratitude and happiness best describe what my wife means to me. I‚Äôm deeply grateful and purely happy üòä,139119,14250,2018,29435507,153369,0.52,102
714,Daytona is the first project out of Wyoming.  I‚Äôm really proud of what we put together.   We‚Äôve spent a year and a half digging for samples and writing. I really appreciate the overwhelmingly positive response that we‚Äôve been receiving.  üôèüôèüôè,64354,8792,2018,29435507,73146,0.25,241
715,before Edward Bernays Americans purchased things based off needs       There was a a time in the 20s when women didn‚Äôt smoke in public so Edward Bernays masterminded a campaign to make it culturally acceptable so that companies could sell more cigarettes..it‚Äôs that kind of vibe..,16217,2452,2018,29435507,18669,0.06,280
716,the century of self   https://t.co/JVvJby2TFq        It‚Äôs 4 hours long but you‚Äôll get the gist in the first 20 minutes      Basically Sigmund Frued‚Äôs nephew Edward Bernays capitalized off of his uncle‚Äôs philosophies and created modern day consumerism,14694,2332,2018,29435507,17026,0.06,250
717,Google dopamine,26217,4840,2018,29435507,31057,0.11,15
718,there was a time when we completely operated without phones.  We're addicted to our phones.,130641,28304,2018,29435507,158945,0.54,91
719,Look at your phone as tool not an obligation.    Would you walk around with a hammer in your pocket?    You would pick up a hammer when you needed it   you would never be addicted or obligated to it.  Use your phone like a hammer only pick it up when you need it.,226165,56227,2018,29435507,282392,0.96,263
720,sometimes we all need hugs,289878,115163,2018,29435507,405041,1.38,26
721,"ü§£ü§£ü§£
https://t.co/I8lcHB8gxf",16133,1979,2018,29435507,18112,0.06,28
722,for anyone whose tried to text or call me in the past 2 weeks   I got rid of that phone so I could focus on these albums,149545,15928,2018,29435507,165473,0.56,120
723,rules are structure for people who can‚Äôt carve their own path successfully,161928,43414,2018,29435507,205342,0.7,74
724,https://t.co/eUnzwhr72z¬†¬†¬†¬†¬†¬†This is the greatest news¬†¬†¬†¬†¬†¬†This is my favorite show¬†¬†¬†¬†¬†I‚Äôve seen every episode at least 5 times each,126380,29689,2018,29435507,156069,0.53,134
725,free thinking is a super power,193760,49343,2018,29435507,243103,0.83,30
726,I‚Äôm hyper focused on the now,85233,17342,2018,29435507,102575,0.35,28
727,Childish Gambino - This is America     https://t.co/sknjKSgj8c,68864,12915,2018,29435507,81779,0.28,62
728,üòÇüòÇüòÇüî•üî•üî• https://t.co/KmvxIwKkU6,40022,6929,2018,29435507,46951,0.16,30
729,we‚Äôre starting a Yeezy architecture arm called Yeezy home. We‚Äôre looking for architects and industrial designers who want to make the world better,71051,7985,2018,29435507,79036,0.27,146
730,naps are awesome,390349,167677,2018,29435507,558026,1.9,16
731,All music coming out of Yeezy sound has to ride like the new Tesla   Yeezy sound is Tesla radio,68180,7076,2018,29435507,75256,0.26,95
732,take a walk outside.  Fresh air is healing,240153,61214,2018,29435507,301367,1.02,42
733,"In a moment of inspiration, energy and excitement I had posted this sketch and would like to acknowledge the true creator of this amazing work, Tony Spackman.",21961,2000,2018,29435507,23961,0.08,158
734,Today I learned that a newly hired designer on the Yeezy team presented work that was not of their own. This person has immediately been let go from the Yeezy brand.,67520,5776,2018,29435507,73296,0.25,165
735,enjoy the present,115831,34976,2018,29435507,150807,0.51,17
736,if you‚Äôre in the way of your own life you‚Äôll end up in the way of other people‚Äôs lives too,91932,21765,2018,29435507,113697,0.39,90
737,I can‚Äôt wait for electric planes.  Elon please hurry up with the ‚ö°Ô∏è jetsüò≠,56276,5355,2018,29435507,61631,0.21,73
738,I can still feel the love,141479,25292,2018,29435507,166771,0.57,25
739,most fear is learned,112286,26289,2018,29435507,138575,0.47,20
740,"when the media masses and scholars talk about what started today. Here's a title ... 

the overground hell road",26525,3299,2018,29435507,29824,0.1,113
741,in school we need to learn how magic Johnson built his business not always about the past. Matter fact I've never even heard of a high school class that presents future ideas,59368,10790,2018,29435507,70158,0.24,174
742,we are programmed to always talk and fight race issues. We need to update our conversation.,65366,13974,2018,29435507,79340,0.27,91
743,the universe has a plan. I knew that TMZ would be awesome.,26119,2856,2018,29435507,28975,0.1,58
744,we need to have open discussions and ideas on unsettled pain,32819,6395,2018,29435507,39214,0.13,60
745,https://t.co/Br5kIafXtG   Charlamagne interview also on YouTube,29109,6995,2018,29435507,36104,0.12,63
746,https://t.co/V7ZeBuufOB     Charlamagne interview,14901,2847,2018,29435507,17748,0.06,49
747,Making of ye vs the people        https://t.co/1xvft3175J,41116,7344,2018,29435507,48460,0.16,57
748,stop thinking about things for a long time without saying what you think,156998,46295,2018,29435507,203293,0.69,72
749,we're starting WORLD LOVE 1 right now the opposite of a WORLD WAR,75329,14528,2018,29435507,89857,0.31,65
750,Through speech it may be saying simply the word love at the end of a phone call or just saying much love.,15751,1979,2018,29435507,17730,0.06,105
751,"I feel it was heavy handed for me to tell people to tell people ""I love you""  I would ask that we show love how ever we want to show love.  It may be a hug it may be a smile or a head nod.",35569,5340,2018,29435507,40909,0.14,188
752,We are all great artists. I said something ego driven in the Charlamagne interview that I'd like to update. I said I was the greatest artist but we're all great artists.,33849,4048,2018,29435507,37897,0.13,169
753,https://t.co/sIVjyPJslJ,5394,669,2018,29435507,6063,0.02,23
754,love is infinite,94460,29498,2018,29435507,123958,0.42,16
755,Axel Vervoordt the globe,6912,687,2018,29435507,7599,0.03,24
756,"we‚Äôre opening up the conversation to the psychologists sociologists and philosophers of the world and we're moving away from infiltrating the youth and using them as a tool to create a cult following based off of a desire to fit in    

people have their own voice",74359,13895,2018,29435507,88254,0.3,266
757,"Yeezy is also food shelter communication education and now a VC 

we've invested in 3 companies since last week",20545,2078,2018,29435507,22623,0.08,113
758,There has never been a Disney or Apple of apparel and now there is. We are hiring the greatest technical and industrial designers in the world to deliver the highest level of product to ALL CLASS,22203,2037,2018,29435507,24240,0.08,195
759,Try to avoid repetition     do meetings in different places and at different times than the normal     break the normal,52353,7558,2018,29435507,59911,0.2,119
760,https://t.co/JAw0pMKGqb,12891,1663,2018,29435507,14554,0.05,23
761,https://t.co/R1BecN4mMf,13392,1431,2018,29435507,14823,0.05,23
762,I'm at Sci-arc and just learned about desalination   Looking at a project by Ashley Morgan Hastings   But I can't tweet the photos üôà there's a lot of great projects here,16268,1257,2018,29435507,17525,0.06,169
763,There's a silent majority of people that have been silenced for too long,112205,22397,2018,29435507,134602,0.46,72
764,we're being starved and anyone who starts asking unpopular questions gets demonized. Only free thinkers can change the world,113746,23880,2018,29435507,137626,0.47,124
765,we‚Äôre in this so-called information age but we're starving for wisdom,75930,17118,2018,29435507,93048,0.32,69
766,we're dying to be ourselves,62163,16707,2018,29435507,78870,0.27,27
767,Or we‚Äôre dying because we've lost our inner child,32990,6239,2018,29435507,39229,0.13,49
768,or at least we're dying to be kids,22049,3685,2018,29435507,25734,0.09,34
769,We‚Äôre all kids,42759,9622,2018,29435507,52381,0.18,14
770,What would you do today if you are not afraid of the consequences of failure?,99054,25169,2018,29435507,124223,0.42,77
771,what makes kids so important to learn from psychologically is that they are not afraid to fail,30221,5147,2018,29435507,35368,0.12,94
772,Art is the escape hatch from oppression,28851,5940,2018,29435507,34791,0.12,39
773,Art is the threat to authority,37234,8111,2018,29435507,45345,0.15,30
774,energy is contagious,120063,42226,2018,29435507,162289,0.55,20
775,We can shape our future. I'm an optimist at my core. I know there will be harmony,66942,10910,2018,29435507,77852,0.26,81
776,Remove worry,117081,35208,2018,29435507,152289,0.52,12
777,"https://t.co/szDOyewQLK¬†¬†¬†¬†

I'm posting this but not as a diss to J Cole. I love J Cole. I also love where Purp took his flow",45199,10133,2018,29435507,55332,0.19,128
778,today is the best day ever and tomorrow's going to be even better,171050,43861,2018,29435507,214911,0.73,65
779,Trust your feelings. Stop thinking so much,255500,96025,2018,29435507,351525,1.19,42
780,I've got a new challenge for everyone today. Pick somebody that you had an argument with that you think you hate maybe even someone you haven't spoken to in years and contact that person and tell them I love you.,182394,46265,2018,29435507,228659,0.78,212
781,Lift Yourself¬†¬†https://t.co/shjFIROujA,81880,23333,2018,29435507,105213,0.36,38
782,"I'm going to drop a song with a verse that will bring Ebro the closure he's been seeking 

The bars üî•üî•üî•üî•üî•üî•üî•üî•üî•üî•üî•üî•üî•üî•üî•üî•üî•üî•üî•üî•üî•üî•üî•üî•üî•üî•üî•üî•üî•üî•üî•üî•üî•üî•üî•

It's called Lift Yourself",100245,13726,2018,29435507,113971,0.39,166
783,I haven't done enough research on conservatives to call myself or be called one. I'm just refusing to be enslaved by monolithic thought.,183058,24929,2018,29435507,207987,0.71,136
784,Artist transform tragedy into beauty,65838,14810,2018,29435507,80648,0.27,36
785,spread love. Put more love into the universe.,122322,39469,2018,29435507,161791,0.55,45
786,we are more worried about what we can lose than what we feel,127118,39295,2018,29435507,166413,0.57,60
787,it's really cool to say I hate you. But it's not cool to say I love you. Love has a stigma,78285,16185,2018,29435507,94470,0.32,90
788,"Instead of doing what you feel 
you just do what other people think you should do",60089,14406,2018,29435507,74495,0.25,82
789,Your conscience should allow a physical manifestation of your subconscious but right now most peoples conscious is too affected by other people‚Äôs thoughts and it creates a disconnect from you doing what you actually feel now,82797,19771,2018,29435507,102568,0.35,224
790,try telling people you love them it actually feels weird at first. We're really good at hating each other. We have to get good at loving each other.,194791,52946,2018,29435507,247737,0.84,148
791,the concept of loving people has a stigma,30905,5493,2018,29435507,36398,0.12,41
792,my friend said he texted all his friends this morning and said I love you,32143,3196,2018,29435507,35339,0.12,73
793,John Legend new single on line now üòÇ,56799,5090,2018,29435507,61889,0.21,36
794,This is year one. We can't ad empathy to MAGA by hating. We can only ad empathy with love and time and truly hearing all sides,41341,5936,2018,29435507,47277,0.16,126
795,I really appreciate this dialogue with John Legend because I'm actually very empathetic. Im still the kid from the telethon. I  feel when people think of MAGA they don't think of empathy.,34367,3249,2018,29435507,37616,0.13,187
796,if you feel something don't let peer pressure manipulate you,114660,27352,2018,29435507,142012,0.48,60
797,I tweeted the John text to show that there are people around me that disagree with me and voice their opinion. I respect everyone's opinion but I stand my ground.,99434,12474,2018,29435507,111908,0.38,162
798,People usually don't agree with people who don't agree with them,108619,27626,2018,29435507,136245,0.46,64
799,The world is our family,44703,7686,2018,29435507,52389,0.18,23
800,just think of someone you hate and try saying even to yourself that you love that person.,47789,8774,2018,29435507,56563,0.19,89
801,Though hate is a similar emotion to love. Hate is not the answer.  Love is.,57760,12420,2018,29435507,70180,0.24,75
802,that's the last tweet of the day. I did that one for my god-brother Puff.  Now ima go watch the Cavs.,63629,5602,2018,29435507,69231,0.24,101
803,2 of my favorite people,28708,2081,2018,29435507,30789,0.1,23
804,Obama was in office for eight years and nothing in Chicago changed.,271439,74037,2018,29435507,345476,1.17,67
805,Claudio will be awesome when me and Chance build new homes in Chicago,34905,3567,2018,29435507,38472,0.13,69
806,Claudio Silverstein is a free thinker,17236,1379,2018,29435507,18615,0.06,37
807,Love is the most powerful force in the universe,162395,54941,2018,29435507,217336,0.74,47
808,let's move in love not fear,69105,18120,2018,29435507,87225,0.3,27
809,And any fan of me wants Ye to be Ye even when they don't agree because I represent the fact that they can be themselves even when people don't agree with them. Drops mic üé§Yeezy shrug ü§∑‚Äç‚ôÇÔ∏è,123326,23422,2018,29435507,146748,0.5,187
810,"whenever someone mentions the word ""fan"" to me it's super manipulative. It's like ""don't do or say this because of your fans""  My fans are fans of themselves.",78751,11752,2018,29435507,90503,0.31,158
811,I want to see a tour with Nikki Minaj and Cardi B,189988,36336,2018,29435507,226324,0.77,49
812,I'd like to meet with Tim Cook. I got some ideas,39724,3862,2018,29435507,43586,0.15,48
813,need Hype Williams for Nas movie,21065,2419,2018,29435507,23484,0.08,32
814,I'm sitting with Lucian discussing the future of the music industry. Lets bring in David Joseph and Frank Bridgman and Olivier Nusse.,12885,1107,2018,29435507,13992,0.05,133
815,I'd like Scooter Braun to be a part of this new platform we're creating. Scooter is a genius.  He's more than a manager so is Irving.  We all need to sit together.,25205,1997,2018,29435507,27202,0.09,163
816,I'm so happy to hear that Peter Thiel would like to take a meeting. I feel very optimistic about the future.,32252,3535,2018,29435507,35787,0.12,108
817,I need to meet with Larry from google,26024,2847,2018,29435507,28871,0.1,37
818,Google supports YEEZY in ending violence in Chicago to start with,37435,3598,2018,29435507,41033,0.14,65
819,we'd be a strategic investor. Not just a VC,13995,1242,2018,29435507,15237,0.05,43
820,I'm 40 years old and I'm just now becoming my parents child.,54058,4670,2018,29435507,58728,0.2,60
821,I‚Äôm nice at ping pong,195505,60465,2018,29435507,255970,0.87,21
822,Kids See Ghost short film will be shot by Dexter Navy,42950,6034,2018,29435507,48984,0.17,53
823,my wife just called me and she wanted me to make this clear to everyone. I don't agree with everything Trump does. I don't agree 100% with anyone but myself.,335358,54552,2018,29435507,389910,1.32,157
824,Yeezy VC invests in and develops food clothing shelter and communications,18571,1808,2018,29435507,20379,0.07,73
825,burn that excel spread sheet üî•üòÇ,31428,6040,2018,29435507,37468,0.13,31
826,decentralize,37213,9242,2018,29435507,46455,0.16,12
827,fear takes strategy   Unlearn linear thinking   Hit you with these zig zag thoughts,27016,5314,2018,29435507,32330,0.11,83
828,no race religion region or political party can argue with the power of love,74008,17269,2018,29435507,91277,0.31,75
829,When my daughter acts out she actually says afterwards I just want to hear you say I love you more.,53039,5659,2018,29435507,58698,0.2,99
830,"I said express love more because we have love but we don't express it.  My friend Tmills will always say ""I love you"" and it used to make me feel weird to hear that. Now I tell everyone I love them.  He sparked me to start expressing love more.",52885,8894,2018,29435507,61779,0.21,244
831,with love I am invincible. Truth is subjective but love is the most powerful force in the world and the world needs to express more of it.,50068,15539,2018,29435507,65607,0.22,138
832,And also I'm all the way out the sunken place. And I'm not scared anymore. I'm not scared of the media. I'm not scared of the past and I'm optimistic about the future. This tweet is in love not fear.,88896,14459,2018,29435507,103355,0.35,199
833,"I love when people have their own ideas. You don't have to be allowed anymore. Just be. 

Love who you want to love.  That's free thought. I'm not even political. I'm not a democrat or a republican",54441,10959,2018,29435507,65400,0.22,199
834,"If your friend jumps off the bridge you don't have to do the same. Ye being Ye is a fight for you to be you. For people In my life the idea of Trump is pretty much a 50 50 split but I don't tell a Hillary supporter not to support Hillary   
I love Hillary too.",46070,6508,2018,29435507,52578,0.18,261
835,You don't have to agree with trump but the mob can't make me not love him. We are both dragon energy. He is my brother. I love everyone. I don't agree with everything anyone does. That's what makes us individuals. And we have the right to independent thought.,307442,71469,2018,29435507,378911,1.29,259
836,Free thinkers don't fear retaliation for your thoughts.  The traditional thinkers are only using thoughts and words but they are in a mental prison. You are free. You've already won. Feel energized. Move in love not fear. Be afraid of nothing.,92975,24708,2018,29435507,117683,0.4,243
837,Rocky we gotta release our songs ASAP,192858,47204,2018,29435507,240062,0.82,37
838,I'm turn the Grammys into the Yammys,77966,15181,2018,29435507,93147,0.32,36
839,I leave my emojis bart Simpson color,143977,26117,2018,29435507,170094,0.58,36
840,I'm used to the heat of independent thoughts,28996,4994,2018,29435507,33990,0.12,44
841,yes I said we. We the people like my brother Q Tip said on the final Tribe album that should have won the Grammy,24433,3335,2018,29435507,27768,0.09,112
842,when we become president we have to change the name of the plane from Air Force one to Yeezy force one ‚òùÔ∏è,74123,16453,2018,29435507,90576,0.31,105
843,the Charlamagne interview just got an offer on 10 million. Yo @cthagod should we hold off for a hundred million??? Jay Virgil Obama Trump and Mental Health.  Just a few things that were discussed. Charlamagne the new Oprah,40046,6019,2018,29435507,46065,0.16,222
844,adidas have been great partners and they've let Yeezy be Yeezy.  This could've never happened at Nike,67631,10113,2018,29435507,77744,0.26,101
845,the Yeezy 700 is adidas most requested shoe,26644,3068,2018,29435507,29712,0.1,43
846,the desert rat 500 sold 250 thousand in one hour on Coachella weekend.  Please do not try to play Yeezy or anyone who wears Yeezy. We are the future.,27828,5006,2018,29435507,32834,0.11,149
847,the Yeezy 350s sell 400 thousand pair in four hours. Only thing close to this is the iPhone.,30289,5331,2018,29435507,35620,0.12,92
848,let‚Äôs be like water üòÇ,23164,4405,2018,29435507,27569,0.09,21
849,oh and Ebro I love you. Ima let you finish but the Charlamagne interview is one of the best interviews of all time. üòÇ,35684,5829,2018,29435507,41513,0.14,117
850,now can I get back to my positive vibes üòÇüòÇüòÇüòÇüòÇüòÇüòÇüòÇüòÇüòÇüòÇüòÇüòÇüòÇüòÇüòÇüòÇüòÇüòÇüòÇüòÇüòÇüòÇüòÇüòÇüòÇüòÇüòÇüòÇüòÇüòÇüòÇüî•üî•üî•üî•üî•üî•üî•üî•üî•üî•üî•üî•üî•üî•üî•üî•üî•üî•üî•üî•üî•üî•üî•üî•üî•üî•üî•üî•üî•,47164,9828,2018,29435507,56992,0.19,101
851,People magazine. Watch how you speak my name. You would love a pair of Yeezys.  Don't play yourself.,75956,13264,2018,29435507,89220,0.3,100
852,Harvey Levin of TMZ your hearing from your future president. Let's be friends. Please never use the word erratic to describe a person who is economically and psychologically empowered,42177,6601,2018,29435507,48778,0.17,183
853,I follow the shade room.  Please never try to play Ye.,27383,4727,2018,29435507,32110,0.11,54
854,I am this generations Ford Hughes Jobs Disney,31855,6007,2018,29435507,37862,0.13,45
855,We will reach the prices I've promised,23055,2929,2018,29435507,25984,0.09,38
856,there's been a lot of fake news so I just wanted to give you the facts. Yeezy will become the biggest apparel company in human history by working with the most genius level talents and creating product at an affordable price. I hired the head of supply chain from the Gap.,48220,6365,2018,29435507,54585,0.19,272
857,I am currently the single highest paid person in footwear. That means I make more money on shoes than Michael Jordan.,76961,14270,2018,29435507,91231,0.31,117
858,We have 160 positions to fill by the end of the year. Yeezy will hit a billion dollars this year. It is the 2nd fastest growing company in history. It is a unicorn on its way to becoming a decacorn.,62855,7582,2018,29435507,70437,0.24,198
859,yes I got rid of my last lawyer why? Because he wouldn't come to work full time. I also asked my last manager to come work full time for Yeezy of course the last lawyer and manager said no. So now I hired a CEO and a CFO and i have two full time lawyers as of now.,24640,2588,2018,29435507,27228,0.09,264
860,"I'm nobody's ""client""",50482,6566,2018,29435507,57048,0.19,21
861,I no longer have a manager. I can't be managed,226280,50473,2018,29435507,276753,0.94,46
862,spread love,112925,43537,2018,29435507,156462,0.53,11
863,2024,143350,29905,2018,29435507,173255,0.59,4
864,never a master. Always a student.,173325,47261,2018,29435507,220586,0.75,33
865,to be great is to be misunderstood,137275,44706,2018,29435507,181981,0.62,34
866,"dragon üêâ energy 
Natural born leaders
Very instinctive 
Great foresight",43132,7197,2018,29435507,50329,0.17,74
867,you can say anything as long as you put the right emoji next to it.,240915,67063,2018,29435507,307978,1.05,67
868,If your foresight is incredible   Stay stubborn to your vision,64254,15553,2018,29435507,79807,0.27,62
869,I‚Äôve always had a desire to do things people wouldn‚Äôt even think to do,93394,21932,2018,29435507,115326,0.39,70
870,everyone should be their own biggest fan,278950,106993,2018,29435507,385943,1.31,40
871,even Prince once had an access pass,31790,3256,2018,29435507,35046,0.12,35
872,life is more exciting than the movies,65733,14068,2018,29435507,79801,0.27,37
873,Donald Glover is a free thinker,226444,43918,2018,29435507,270362,0.92,31
874,I feel like im 18 year old again when I make beats for Nas,130559,16425,2018,29435507,146984,0.5,58
875,new ideas will no longer be condemned by the masses. We are on the frontier of massive change. Starting from breaking out of our mental prisons.,83478,19164,2018,29435507,102642,0.35,144
876,we're evolving at warp speed,49574,8354,2018,29435507,57928,0.2,28
877,This is the funnest car I‚Äôve ever driven,61647,4857,2018,29435507,66504,0.23,40
878,I'm super chaaaaaarged.  Bout to take this whole thing to mars,76752,13154,2018,29435507,89906,0.31,62
879,I heard these are really good for the environment üôè,32708,2874,2018,29435507,35582,0.12,51
880,I really love my Tesla. I'm in the future. Thank you Elon.,225461,24513,2018,29435507,249974,0.85,58
881,Nas June 15th,156462,44686,2018,29435507,201148,0.68,13
882,I'm hand producing all the albums I tweeted about. Been chopping samples from the sunken place üòÇPusha May 25th My album June 1st me and Cudi June 8th and Teyana June 22nd and oh yeah...,132471,30915,2018,29435507,163386,0.56,185
883,practice pure love,117782,49765,2018,29435507,167547,0.57,18
884,It‚Äôs no more baring people because they have different ideas.,29100,4810,2018,29435507,33910,0.12,61
885,self victimization is a disease,208134,68357,2018,29435507,276491,0.94,31
886,there was a time when slavery was the trend and apparently that time is still upon us. But now it's a mentality.,69061,16218,2018,29435507,85279,0.29,112
887,People respect people for following the general  trend and consensus,43910,9912,2018,29435507,53822,0.18,68
888,We live in a time where people don‚Äôt respect people for being themselves,197023,71953,2018,29435507,268976,0.91,72
889,Constantly bringing up the past keeps you stuck there,287817,115110,2018,29435507,402927,1.37,53
890,The thought police want to suppress freedom of thought,65588,14955,2018,29435507,80543,0.27,54
891,we have freedom of speech but not freedom of thought,112725,28308,2018,29435507,141033,0.48,52
892,People demonize people and then they demonize anybody who sees anything positive in someone whose been demonized,66343,16876,2018,29435507,83219,0.28,112
893,The psychological zombie effect,22676,3668,2018,29435507,26344,0.09,31
894,Demonization has metastasized,22757,3406,2018,29435507,26163,0.09,29
895,the blinders are off,33605,5745,2018,29435507,39350,0.13,20
896,question everything,168946,59720,2018,29435507,228666,0.78,19
897,The more people contribute to real time global consciousness the faster we evolve,58693,11950,2018,29435507,70643,0.24,81
898,get past the past,222003,92683,2018,29435507,314686,1.07,17
899,be fearless. Express what you feel not what you've been programmed to think.,142146,51711,2018,29435507,193857,0.66,76
900,live in love not in fear,143567,56247,2018,29435507,199814,0.68,24
901,I don't subscribe the term and concept of God fearing.  That's a dated mentality that was used to control people. We are in the future. If God is love and love it's the opposite of fear then...ü§îü§∑‚Äç‚ôÇÔ∏è to fear God makes no sense ü§∑‚Äç‚ôÇÔ∏èü§∑‚Äç‚ôÇÔ∏èü§∑‚Äç‚ôÇÔ∏èü§∑‚Äç‚ôÇÔ∏èü§∑‚Äç‚ôÇÔ∏è,88897,18503,2018,29435507,107400,0.36,246
902,only free thinkers,57168,12810,2018,29435507,69978,0.24,18
903,I love the way Candace Owens thinks,81098,18803,2018,29435507,99901,0.34,35
904,the world is our office,50040,9876,2018,29435507,59916,0.2,23
905,Yeezy is based in Calabasas but will also be setting up offices in New York London and Wyoming,58492,5881,2018,29435507,64373,0.22,94
906,style is genderless,188347,53369,2018,29435507,241716,0.82,19
907,strive for universal consciousness not segregated consciousness,41636,9491,2018,29435507,51127,0.17,63
908,everything is so planned these days. People appreciate spontaneity and honesty.,102637,25759,2018,29435507,128396,0.44,79
909,iterations of ideas are how culture evolves.,26781,4597,2018,29435507,31378,0.11,44
910,sharing is community holding information is capitalism,42504,8029,2018,29435507,50533,0.17,54
911,images are limitless and words aren't. Words are defined,33142,7168,2018,29435507,40310,0.14,56
912,I don‚Äôt believe in horizontal hierarchy. If you build a ladder too high it‚Äôs actually most dangerous for the people at the top.,33189,5702,2018,29435507,38891,0.13,127
913,all you have to be is yourself,224770,96835,2018,29435507,321605,1.09,30
914,I need a water proof silk nylon as soon as possible.,32481,3901,2018,29435507,36382,0.12,52
915,people are celebrating real ideas and vibe. Not just hype,49682,9464,2018,29435507,59146,0.2,57
916,we need to Aman Giri the world,17099,1999,2018,29435507,19098,0.06,30
917,the beauty is in the imperfection(s),128411,46827,2018,29435507,175238,0.6,36
918,Pusha T May 25th,118338,31645,2018,29435507,149983,0.51,16
919,Teyana Taylor June 22nd,75066,16964,2018,29435507,92030,0.31,23
920,it's called Kids See Ghost. That's the name of our group,169371,47635,2018,29435507,217006,0.74,56
921,me and Cudi album June 8th,489508,213165,2018,29435507,702673,2.39,26
922,June 1st,239342,94258,2018,29435507,333600,1.13,8
923,my album is 7 songs,267811,81769,2018,29435507,349580,1.19,19
924,it's not where you take things from.  It's where you take them to,107482,32778,2018,29435507,140260,0.48,65
925,we're all servants,72684,15848,2018,29435507,88532,0.3,18
926,today will be the greatest day so far. Life keeps getting better and better.,174211,55122,2018,29435507,229333,0.78,76
927,if you wanna see the true character of person watch the way they treat someone who can't do anything for them.,480268,205988,2018,29435507,686256,2.33,110
928,truth is my goal. Controversy is my gym. I'll do a hundred reps of controversy for a 6 pack of truth,148154,32235,2018,29435507,180389,0.61,100
929,don't trade your authenticity for approval,322811,150048,2018,29435507,472859,1.61,42
930,let's be less concerned with ownership of ideas. It is important that ideas see the light of day even if you don't get the credit for them. Let's be less concerned with credit awards and external validation.,102226,20101,2018,29435507,122327,0.42,207
931,"I find myself getting stuck in the idea of originality and letting my ego push me to say things like ""this person stole this from me"" and the funny thing is it'll be a reference I took from somewhere üòÇ",113211,17023,2018,29435507,130234,0.44,201
932,Cars have four wheels. Hoodies have hoods. It's amusing to me when some one says this is an original hoodie. Bro... it's a hoodie ü§∑‚Äç‚ôÇÔ∏è,106501,20422,2018,29435507,126923,0.43,134
933,too much emphasis is put on originality. Feel free to take ideas and update them at your will all great artist take and update.,111976,25617,2018,29435507,137593,0.47,127
934,There's love stories.  Pain happiness. It's 3 dementional. There's taste touch sound. It's the most entertaining for of entertainment. Just being. We believe time is a man made construct. Actually time and money are both man made currency. Because you can spend them both.,67066,15127,2018,29435507,82193,0.28,272
935,Be here now. Be in the moment. The now is the greatest moment of our lives and it just keeps getting better. The bad parts the boring parts the parts with high anxiety. Embrace every moment for its greatness. This is life. This is the greatest movie we will ever see.,297865,119985,2018,29435507,417850,1.42,267
936,me and my friend Anthony Schiller always ask questions about time. Is time linear? I recently did an interview where I placed a high value on time. Everything means nothing until you make it something. You are your validator.,55887,11281,2018,29435507,67168,0.23,225
937,"I will work on this ""book"" when I feel it. When We sit still in the mornings We get hit with so many ideas and so many things We want to express. When I read this tweet to myself I didn't like how much I used the word I so I changed the I's to We's.",66272,9719,2018,29435507,75991,0.26,249
938,oh by the way this is my book that I'm writing in real time. No publisher or publicist will tell me what to put where or how many pages to write. This is not a financial opportunity this is an innate need to be expressive.,88329,12775,2018,29435507,101104,0.34,222
939,"everyone will say he needs to learn how to act. At home parental acting classes are one of the first steps to us loosing who we really are to ""the simulation"".  Parents are our first acting coaches.",38636,7592,2018,29435507,46228,0.16,198
940,"in life, we are all trained actors. When we're born we're ourselves and then one of the first things we're thought is how to act.  If you see a kid screaming at a restaurant because he feels something and can't express himself in a conventional manner",46888,9880,2018,29435507,56768,0.19,251
941,just stop lying about shit. Just stop lying.,228788,112464,2018,29435507,341252,1.16,44
942,You will be a drop of water with the ocean as your army. If you move out of fear than your on your own. Then it's just you and the money and the countless people you have to lie to and manipulate to build a man made path that will never lead to true happiness.,40410,8644,2018,29435507,49054,0.17,260
943,I don't believe in the concept of an enemy. We have been conditioned to always be in competition. Stop looking for something to beat and just be. You don't have to do all the work. Once you start moving in love the universe will assist you.,193891,62790,2018,29435507,256681,0.87,240
944,Don't follow crowds. Follow the innate feelings inside of you. Do what you feel not what you think. Thoughts have been placed in our heads to make everyone assimilate. Follow what you feel.,163250,57420,2018,29435507,220670,0.75,189
945,You have the best ideas. Other people's opinions are usually more  distractive than informative. Follow your own vision. base your actions on love. Do things you love and if you don't absolutely love something stop doing it as soon as you can.,221687,77192,2018,29435507,298879,1.02,243
946,when you first wake up don't hop right on the phone or the internet or even speak to anyone for even up to an hour if possible. Just be still and enjoy your own imagination. It's better than any movie.,325344,83750,2018,29435507,409094,1.39,201
947,trend is always late,123990,30671,2018,29435507,154661,0.53,20
948,be transparent as possible. Stop setting plays. Stop playing chess with life. Make decisions based on love not fear.,264496,105156,2018,29435507,369652,1.26,116
949,Fear often causes people to be manipulative,136718,43633,2018,29435507,180351,0.61,43
950,everything you do in life stems from either fear or love,226122,89924,2018,29435507,316046,1.07,56
951,Sometimes you have to get rid of everything,243592,106876,2018,29435507,350468,1.19,43
952,distraction is the enemy of vision,197530,87811,2018,29435507,285341,0.97,34
953,try to avoid any contractual situation where you are held back from your ideas,129029,34315,2018,29435507,163344,0.55,78
954,You have to protect your ability to create at all cost,196043,65219,2018,29435507,261262,0.89,54
955,As a creative your ideas are your strongest form of currency,157874,52549,2018,29435507,210423,0.71,60
956,often people working with the existing consciousness are jealous of those who are more in touch and they become hard-core capitalist in hopes of creating the illusion that the value of money is worth more than the value of time and  friends,228725,67503,2018,29435507,296228,1.01,240
957,Some people have to work within the existing consciousness while some people can shift the consciousness,163838,52389,2018,29435507,216227,0.73,104
