,full_text,favorite_count,retweet_count,created_at,user.followers_count,engagement,performance,twtlength
0,‚ú® https://t.co/KYGI6Afj7F,40177,3087,2019,62585118,43264,0.07,25
1,‚ú® https://t.co/iDaxejM0Pi,16912,1426,2019,62585118,18338,0.03,25
2,Date Night https://t.co/0OvjobOtiM,22752,1664,2019,62585118,24416,0.04,34
3,Diddy‚Äôs 50th Birthday ‚ú® https://t.co/0sZUuFyrUf,67927,3905,2019,62585118,71832,0.11,47
4,"Had so much fun on the @theellenshow‚Äôs 12 Days of Giveaways! We surprised the audience with gifts from @kkwbeauty @KKWFRAGRANCE courtesy of @ultabeauty, @skims and a last minute surprise from my husband @kanyewest! Tune in today at 3pm PST üéÅüéÑ https://t.co/c0LaY88kHX",5237,240,2019,62585118,5477,0.01,266
5,Shop the new @skims Sleep Collection now at https://t.co/Qsy51Sl2Sd! I can‚Äôt wait for you to try my favorite pajamas. üí§ https://t.co/yYOJTVpZnj,5288,324,2019,62585118,5612,0.01,143
6,Our season finale of Keeping Up With the Kardashians airs tonight on E! This dinner where we all dress up and act like each other is legendary! You don‚Äôt want to miss it! https://t.co/dTCx4R1LXw,66428,3231,2019,62585118,69659,0.11,194
7,"Text KKWB to 72716 to receive  @kkwbeauty text updates about restocks, promotions, new launches and more! https://t.co/mbTZpQW5QG",2193,127,2019,62585118,2320,0.0,129
8,The @KKWFRAGRANCE Crystal Pear &amp; Peony fragrance is now available exclusively in-store and online at @ultabeauty! I love this spirited oriental scent - and it makes a great holiday gift! üçê https://t.co/W7KmIQiEbG,3370,181,2019,62585118,3551,0.01,216
9,Don‚Äôt miss the Keeping Up with Kardashians season finale tonight! 9/8c on E! @KUWTK https://t.co/lpV0r6PzzS,3985,257,2019,62585118,4242,0.01,107
10,‚ú® https://t.co/GfOnfzEU0T,98639,6422,2019,62585118,105061,0.17,25
11,Diddy‚Äôs 50th https://t.co/nSzBgaR7fx,301687,22278,2019,62585118,323965,0.52,36
12,Tonight ‚ú® https://t.co/Hj2o6dqKEL,21031,1120,2019,62585118,22151,0.04,33
13,‚ú® https://t.co/oIcZj7iXzH,58305,3654,2019,62585118,61959,0.1,25
14,Not a drop of body make up on my cream Vivienne Westwood gown THANK GOD! https://t.co/137eCkwyZK,9488,375,2019,62585118,9863,0.02,96
15,Feeling glam tonight https://t.co/8Zt4aL61X0,107032,7935,2019,62585118,114967,0.18,44
16,The West Family Christmas Card 2019 https://t.co/0rjGXxiWD1,656307,88663,2019,62585118,744970,1.19,59
17,"The @skims Cozy Collection is restocking just in time for the Holidays! It sold out quickly last time, so join the waitlist at https://t.co/Qsy51S3rtD to get first access! The restock will be available 12.16 at 9AM PST https://t.co/iWnFMmq5xf",3816,215,2019,62585118,4031,0.01,242
18,My girls!!!!! Everyone please watch this! They have been working so hard and deserve all of this shine!!! ‚ú®üôèüèº‚ú® everyone go check out these warriors!!!! https://t.co/NjqCAw89uY,2835,241,2019,62585118,3076,0.0,175
19,Yes!!! https://t.co/rHf2K4E1TN,1290,63,2019,62585118,1353,0.0,30
20,‚ú®üôèüèº‚ú® https://t.co/rjRCGGm1m8,2312,160,2019,62585118,2472,0.0,28
21,"Everyone has a story to tell. This Holiday Season, we‚Äôre giving our platform over to women whose stories inspire us and supporting the causes that inspire them.

https://t.co/7gOEFpwWyG",2243,176,2019,62585118,2419,0.0,187
22,"I‚Äôm so excited for another @skims launch... the Sleep Collection!! The jersey fabric is comfortable &amp; breathable, I‚Äôm always sleeping in these now. üò¥ See the full collection and join the waitlist at https://t.co/Qsy51S3rtD to be the first to shop! Available on 12.16 at 9am PST. https://t.co/Nf6qc4A0vc",3537,200,2019,62585118,3737,0.01,306
23,"Smart video calling from @PortalFacebook means @Jlo can help me study for law school from the other side of the country, even if she has some distractions on her end... looking at you @Arod! #FeelThere #PortalPartner https://t.co/W52DSoUXyY https://t.co/meSjpymkoX",5718,438,2019,62585118,6156,0.01,264
24,Stormi loves my Psalmy so much! https://t.co/TOgLJkLnht,217896,9962,2019,62585118,227858,0.36,55
25,So happy you like it ‚ú® https://t.co/nclRvUJUYh,2328,78,2019,62585118,2406,0.0,46
26,The @skims Waist Trainer is restocked now! Shop at https://t.co/Qsy51S3rtD before it sells out. https://t.co/MgMthbAKhG,2898,153,2019,62585118,3051,0.0,119
27,I‚Äôm happy David Sheppard can go home and make the most of the opportunity for a 2nd chance!!! üôèüèº https://t.co/eD6XuD9e4v,12331,668,2019,62585118,12999,0.02,120
28,Remember I spoke about David Sheppard a few days ago??? Well he‚Äôs finally home after more than 30 years! I can‚Äôt wait to share his journey with you all on my documentary coming in 2020 on @oxygen,6757,351,2019,62585118,7108,0.01,195
29,"Exactly what Brandon said!!!! NO ONE from I‚Äôm A Celeb even reached out and asked for letters, appearances or anything from any Kardashians or Jenners. https://t.co/dlzoodwDiz",53238,2948,2019,62585118,56186,0.09,174
30,"The @SKIMS Waist Trainer restock is coming tomorrow, 12.11 at 9AM PST. Join the waitlist now at https://t.co/Qsy51S3rtD to be the first to shop! https://t.co/WbPfxz1DJN",3952,214,2019,62585118,4166,0.01,168
31,The @kkwbeauty Glitz &amp; Glam Collection ‚Äî Gold Sparkle is one of my all-time favorite glosses! Shop it now at https://t.co/PoBZ3bhjs8 https://t.co/vrkfURCIae,2710,153,2019,62585118,2863,0.0,160
32,"Make sure to stay tuned to @SKIMS for the restock date. We will have some new news for you this week. 

Xo Kim",2038,97,2019,62585118,2135,0.0,112
33,I highly recommend joining the waitlist at https://t.co/8MYenT97Ii to receive early access to shop the collection before the widely publicized launch time to give yourself the best chance at purchasing before the specific items that you want sell out.,1059,71,2019,62585118,1130,0.0,251
34,I understand many of you weren‚Äôt able to get the @SKIMS Cozy Collection before it sold out within minutes today. We‚Äôre working very hard to restock the entire Cozy collection so everyone can have it before the Holidays and will give you another chance to buy soon.,4998,169,2019,62585118,5167,0.01,264
35,Make sure if you have joined our @skims wait list you go to https://t.co/qc7FuvGMzo because you can buy the cozy collection now even though it‚Äôs not live yet! Our wait list costumers get early access to all drops,1336,90,2019,62585118,1426,0.0,212
36,üôãüèª‚Äç‚ôÄÔ∏è https://t.co/xsc0R7DDdh,2236,81,2019,62585118,2317,0.0,29
37,That‚Äôs basically what this episode is all about!!! ü§¶üèª‚Äç‚ôÄÔ∏èü§∑üèª‚Äç‚ôÄÔ∏è https://t.co/eHiPwWH3Lh,4463,153,2019,62585118,4616,0.01,85
38,SAME https://t.co/CE0fHs5doW,1648,69,2019,62585118,1717,0.0,28
39,Watch a brand new Keeping Up tonight at 9/8c on E! #KUWTK https://t.co/4YxFstN9sh,4697,295,2019,62585118,4992,0.01,81
40,‚ú®üôèüèº https://t.co/EUhYwrYZvg,2510,192,2019,62585118,2702,0.0,27
41,Chicago in Tokyo https://t.co/9EMPTSkL4h,190749,10219,2019,62585118,200968,0.32,40
42,2 days until the @skims Cozy Collection! Join the waitlist now at https://t.co/Qsy51Sl2Sd https://t.co/k3IwYpiBiy,5544,246,2019,62585118,5790,0.01,113
43,It‚Äôs imperative that the judge corrects this wrong on Monday so he can regain the freedom he so rightfully deserves,3175,185,2019,62585118,3360,0.01,115
44,"David Sheppard should have been reunited with his family, but he remains in custody and must appear in court on Monday in Delaware County",2860,247,2019,62585118,3107,0.0,137
45,This is sheer abuse of prosecutorial authority on the part of the district attorney‚Äôs office and a shameful waste of public resources,5707,335,2019,62585118,6042,0.01,133
46,This morning after serving 25yrs David Sheppard was due to be released - instead he remains in custody over a 30yr old shoplifting case,5812,459,2019,62585118,6271,0.01,135
47,https://t.co/hq6VQv2357,1029,157,2019,62585118,1186,0.0,23
48,"I‚Äôm so excited to announce my holiday exclusive fragrance ULTA Crystal Pear &amp; Peony. The scent is sweet &amp; has notes of winter vanilla cr√®me, golden amber crystal, sparkling peony blossoms &amp; sugar-coated bergamot. The fragrance is $35 and now available online only at @ultabeauty. https://t.co/h4bHOS4M4N",2419,132,2019,62585118,2551,0.0,315
49,Only a few hours until the @kkwbeauty  Glitz &amp; Glam collection launches! Can‚Äôt wait for you to try the party-perfect essentials just in time for the holidays ‚ú® Shop it at 12PM PST at https://t.co/PoBZ3byUQI https://t.co/kMoyXY3deO,1909,119,2019,62585118,2028,0.0,234
50,It doesn‚Äôt get much sweeter than this https://t.co/0X8y7yMzuI,280984,30048,2019,62585118,311032,0.5,61
51,I‚Äôm so obsessed with this lip! We used the 90‚Äôs vogue liner &amp; matte lipstick. I wanted a glossy look so we used Black Cherry gloss on my lips &amp; then put a touch of it on my lids over the Glitz &amp; Glam palette shadows! It all drops tomorrow at NOON PST https://t.co/aIjp1MBlpZ https://t.co/PufzWNQjkh,4546,212,2019,62585118,4758,0.01,310
52,Here‚Äôs another closer look at the four colors of the new @skims Cozy Collection! Shop it 12.09 at 9AM PST at https://t.co/Qsy51S3rtD https://t.co/LfsFhmnEkI,2695,175,2019,62585118,2870,0.0,156
53,So obsessed with the new @skims Cozy Collection launching 12.09! Here‚Äôs a closer look! https://t.co/D65UgBKMOt,12957,715,2019,62585118,13672,0.02,110
54,These and the basketball shoes are my faveeeeee https://t.co/5lZ37OUIMN,5349,326,2019,62585118,5675,0.01,71
55,12 Days of Christmas @kkwbeauty ‚Äî Day 3: Buy One Get One FREE Lip Liners (exclusions apply) No code needed. Ends tonight at 11:59PM PST on https://t.co/PoBZ3bhjs8 and get free shipping on orders over $50! https://t.co/3iTZQspwGx,1070,69,2019,62585118,1139,0.0,228
56,"I have no words to describe how much I love your smile and those curls of yours Saint! You bring so much joy into my soul. You‚Äôre so kind, loving, and just so thoughtful and sweet! Happy 4th Birthday my sweet sweet Sainty https://t.co/hU7dLbDv7J",167287,9027,2019,62585118,176314,0.28,245
57,üôåüèº https://t.co/29mQfEod9e,19896,1537,2019,62585118,21433,0.03,26
58,"I‚Äôm wearing @kkwbeauty Icicle, Clove &amp; Moonlight Glow from the Glitz &amp; Glam Eyeshadow Palette and 90's Moment Matte Lipstick. Shop this iconic look on Friday, 12.06 at 12PM on https://t.co/PoBZ3bhjs8 #KKWBEAUTY https://t.co/ei0jbuBaT5",1261,68,2019,62585118,1329,0.0,242
59,The most comfortable pajamas and loungewear in the world!! I can‚Äôt wait for you guys to get the new @skims Cozy Collection launching 12.09 at 9AM PST! Join the waitlist now at https://t.co/Qsy51S3rtD to be the first to shop. https://t.co/X4oqBLWPqj,8445,425,2019,62585118,8870,0.01,248
60,"OMG I‚Äôve been dying to tell you about the new @skims Cozy Collection - pajamas &amp; loungewear pieces that I have been living in at home - I even sleep in this robe! Get it on Monday, 12.09 at 9AM PST at https://t.co/Qsy51S3rtD! The coziest holiday gift for yourself and loved ones! https://t.co/pJnVKMrJBZ",12322,819,2019,62585118,13141,0.02,307
61,ü§™ü§ì https://t.co/s74v1abxVk,131863,4935,2019,62585118,136798,0.22,26
62,"Introducing the @kkwbeauty Glitz &amp; Glam collection. The new collection features a 6-pan eyeshadow palette, three glosses, a matte lipstick set with 3 new colors and a new lip liner color. Shop on 12.06 at 12PM PST on https://t.co/PoBZ3bhjs8 https://t.co/sVDkITM4m2",2104,116,2019,62585118,2220,0.0,268
63,"Introducing the new limited-edition @kkwbeauty Skin Perfecting Body Shimmer in Rose Gold from our new Glitz and Glam collection. Shop on Friday, 12.06 at 12PM PST on https://t.co/PoBZ3bhjs8. #KKWBEAUTY https://t.co/2YRxZdK0xX",3435,210,2019,62585118,3645,0.01,225
64,"After last night‚Äôs episode, we received an outpouring of interest in the clean up of the Santa Susana Field Lab. The moms fighting to protect their kids need your help: click to send a message to @NASA demanding a FULL cleanup: https://t.co/SUiSMv3T8t",1805,203,2019,62585118,2008,0.0,251
65,"On this week's episode we met with Melissa Bumstead, who is fighting to clean up a toxic site which she believes gave her daughter cancer. She's one of several parents who need your help pressuring @NASA to clean up the site: https://t.co/SUiSMv3T8t",1473,157,2019,62585118,1630,0.0,249
66,NASA is attempting to break out of its cleanup agreement and leave most of its contamination not cleaned up. The public can weigh in on their plan by sending in comments to NASA by December 9.,19523,2502,2019,62585118,22025,0.04,192
67,"The timing of our Keeping Up With The Kardashians episode last night talking about Santa Susana is synergistic.
NASA has agreed legally to pay for the clean up knowing this was their test sight where they would test rockets but is now trying to back out",5393,332,2019,62585118,5725,0.01,254
68,I have that rock from Gracie in my kitchen #KUWTK,1488,73,2019,62585118,1561,0.0,49
69,The Santa Susana Field Lab stories are so heart breaking üíî To this day NOTHING has been done to start this clean up!,2348,159,2019,62585118,2507,0.0,116
70,Awww thank you! https://t.co/RudY3pBBw8,1687,62,2019,62585118,1749,0.0,39
71,I‚Äôm so sorry to hear about your loss. We have done research and it is a huge toxic problem! Something has to be done to fix this. It‚Äôs tearing so many families apart. üíî https://t.co/T6SSz90OD1,1209,82,2019,62585118,1291,0.0,192
72,Beyond!!! When you aren‚Äôt ready or expecting it https://t.co/DoXOP4eLvi,1026,48,2019,62585118,1074,0.0,71
73,Three big dogs is a lot!!!! #KUWTK,1125,60,2019,62585118,1185,0.0,34
74,Senator Stern is the best!!! He‚Äôs really doing what he can and believes in the Santa Susan‚Äôs Field Lab Clean Up,958,54,2019,62585118,1012,0.0,111
75,Oh yes!!!! Just kidding I‚Äôm not that evil. This was fully moms idea so I was helping out https://t.co/byUQSG7pRg,1097,57,2019,62585118,1154,0.0,112
76,üíï https://t.co/U0cuzrZ3pz,768,36,2019,62585118,804,0.0,25
77,The Santa Susana Field Lab story is so sad. @kourtneykardash and I have been meeting with these cancer survivor moms and it‚Äôs heart breaking. Hearing their stories how 54 kids have the same kind of cancer right near the lab.,993,87,2019,62585118,1080,0.0,224
78,Yes you can hear my voice https://t.co/K5mswNbYzX,875,34,2019,62585118,909,0.0,49
79,There are so many amazing pics that came out of the @CRFASHIONBOOK shoot that‚Äôs on #KUWTK right now,521,38,2019,62585118,559,0.0,99
80,Those are my favorite pajamas. I wear them every day and I need an alternative. #KUWTK,881,53,2019,62585118,934,0.0,86
81,The Dictionary Game!!!,2466,112,2019,62585118,2578,0.0,22
82,Live twitter chat tonight anyone?! New episode of #KUWTK starts now on E!,1017,75,2019,62585118,1092,0.0,73
83,New Keeping Up tonight! 9/8c on E! #KUWTK https://t.co/lgFlFlE0Lh,3080,196,2019,62585118,3276,0.01,65
84,New Keeping Up tonight! Watch with us at 9/8c on E! #KUWTK https://t.co/mSbPKwD29c,53724,5295,2019,62585118,59019,0.09,82
85,There‚Äôs a film called The Last Defense with Viola Davis I saw and have seen so many people fight for him but we need some help! Please got to https://t.co/2vsgNFVQ3M and sign his clemency petition!!!,1152,258,2019,62585118,1410,0.0,199
86,"I have been following the case of Julius Jones for little while now. Julius Jones is on death row in Oklahoma, despite maintaining his innocence and compelling evidence that he was wrongfully convicted. His case has also been strained with so much racial discrimination.",13504,1101,2019,62585118,14605,0.02,270
87,"Have you shopped the @kkwbeauty #BlackFriday sale yet? Get 30% off site wide while supplies last, no promo code needed! (Exclusions apply)¬†¬†Ends 12.02 at 11:59PM PST on https://t.co/PoBZ3bhjs8 https://t.co/hPzaKJtGx9",2211,114,2019,62585118,2325,0.0,216
88,"KYLIE JENNER by KKW Fragrance Red Lips. Shop for 20% off for our #BlackFriday sale, no code needed (exclusions apply) while supplies last! Ends 12.02 at 11:59PM PST on https://t.co/tbQezJs782 #KKWFRAGRANCE https://t.co/hIKSpBf6A2",1446,88,2019,62585118,1534,0.0,229
89,"‚ú® BLACK FRIDAY SALE ‚ú®Shop @kkwbeauty now and get 30% off site wide while supplies last. Get FREE shipping on orders over $50. Discount applied on site, no promo code needed. Sale ends 12.02 at 11:59PM PST on https://t.co/PoBZ3bhjs8 #KKWBEAUTY https://t.co/ZinTEBFcl3",1079,83,2019,62585118,1162,0.0,266
90,Shop the KKW Fragrance Diamonds Trio Gift Set for only $45 + 20-30% off site wide (exclusions apply) while supplies last for our #BlackFriday sale now on https://t.co/tbQezJs782 #KKWFRAGRANCE https://t.co/Pfc8XLX7L6,962,80,2019,62585118,1042,0.0,215
91,The @skims Black Friday Event is happening now! Save on my essential underwire bras and panties exclusively at https://t.co/Qsy51S3rtD. Shop now while supplies last. https://t.co/MvdagXn2c6,1071,82,2019,62585118,1153,0.0,189
92,So thankful for all of my babies https://t.co/Hu00Y8OWqA,186337,10451,2019,62585118,196788,0.31,56
93,So thankful for my babies https://t.co/pId1LSXTnd,75552,3072,2019,62585118,78624,0.13,49
94,Closed On Sunday‚Äôs                       https://t.co/qFUYvxrYGb,2786,373,2019,62585118,3159,0.01,64
95,Everyone please read his story below and if you can donate I‚Äôm sure he would be so grateful üôèüèº https://t.co/zZ9SsGABRM,22055,4363,2019,62585118,26418,0.04,118
96,I use it every day! #ConcealBakeBrighten https://t.co/eJJFvxk1EX,2174,68,2019,62585118,2242,0.0,64
97,My @KKWFRAGRANCE #BlackFriday sale starts this Thursday at 12PM PST! Shop all of my favorite fragrances for up to 30% off sitewide! #KKWFRAGRANCE ‚ú® https://t.co/66RwfZlmn6,4060,225,2019,62585118,4285,0.01,171
98,Happy Thanksgiving from all of us at Kim Kardashian Hollywood @KKHOfficial We hope you have fun playing the game this holiday season üçÅü¶ÉüçΩ.  https://t.co/YqSNsLCmSS https://t.co/J1uJwb8hjj,2829,166,2019,62585118,2995,0.0,186
99,My @kkwbeauty #BlackFriday sale starts this Thursday at 12PM PST! Shop all of my favorite essentials for 30% off sitewide! #KKWBEAUTY ‚ú® https://t.co/xVaHFMbghV,1614,79,2019,62585118,1693,0.0,159
100,My bestie @jlo and I are always on the move. But @PortalFacebook smart video calling always keeps up with us...and @arod too. üíóüíö#FeelThere #PortalPartner https://t.co/Bf6EE0UNQD https://t.co/pcGI50wFF7,11452,817,2019,62585118,12269,0.02,201
101,"Tonight, I'll be eating..... Making this Uber Eats ad for Australia was so much fun! The netball outfit is a vibe. #noice #ad @ubereats_aus https://t.co/SgT7MQD2aW",15425,1169,2019,62585118,16594,0.03,163
102,!!!!!! https://t.co/W62mERXCFu,6207,190,2019,62585118,6397,0.01,30
103,‚ô•Ô∏è‚ô•Ô∏è‚ô•Ô∏è https://t.co/3jvYZ9L4vF,2567,84,2019,62585118,2651,0.0,30
104,Oh yes she is!!! ‚ú®üíïüíé https://t.co/KdzYdbd7Hx,47411,1964,2019,62585118,49375,0.08,44
105,Yesssss!!! https://t.co/g4ch4vYREm,2894,99,2019,62585118,2993,0.0,34
106,"Introducing the brand new KKW Fragrance Diamonds Trio, a Gift Set with three travel sized 10mL bottles for only $45 ‚Äî the perfect stocking stuffer and great for a refresh on-the-go. Shop the set Thursday, 11.28 at 12PM PST on https://t.co/tbQezJs782 #KKWDIAMONDS https://t.co/l6skP4iK8a",1576,121,2019,62585118,1697,0.0,286
107,"Introducing the brand new KKW Fragrance Diamonds Trio, a Gift Set with three travel sized 10mL bottles for only $45 ‚Äî the perfect stocking stuffer and great for a refresh on-the-go. Shop the set Thursday, 11.28 at 12PM PST on https://t.co/tbQezJs782 #KKWDIAMONDS https://t.co/RvxB6M6qAp",1361,90,2019,62585118,1451,0.0,286
108,"New York Magazine
@nymag 
Photographer: @ruvenafanador
Writer: @jonathanvanmeter
Makeup: @makeupbymario
Hair: @michaelsilvahair
Styling: @LUXURYLAW https://t.co/RDhWqFhscq",2449,191,2019,62585118,2640,0.0,177
109,ü§£ü§£ü§£ https://t.co/tks49fGrts,12112,432,2019,62585118,12544,0.02,27
110,This is how you eat M&amp;M‚Äôs! Microwave them for 30 seconds then enjoy the melted magic! https://t.co/hkaK6vaaaN,163434,15338,2019,62585118,178772,0.29,113
111,!!!!! https://t.co/RCHL6UzHU6,4150,236,2019,62585118,4386,0.01,29
112,Yessss https://t.co/PcNYkVFTH1,864,45,2019,62585118,909,0.0,30
113,Trust me it is worth it!  Please tell me if you like it https://t.co/5bH9m8axuG,1503,55,2019,62585118,1558,0.0,79
114,Go to my IG stories and see my melted M &amp; M‚Äôs.,5140,276,2019,62585118,5416,0.01,50
115,Ok we will find you and make sure we get it! https://t.co/uglfA2oDrC,7198,200,2019,62585118,7398,0.01,68
116,Body Tape??? https://t.co/4uLboM6nnG,6327,143,2019,62585118,6470,0.01,36
117,We will find you tonight! This is so incredible ‚ú® https://t.co/SMWdLvz2bC,11594,537,2019,62585118,12131,0.02,73
118,"You know what they say: Diamonds by @KKWFRAGRANCE is a girl's best friend üòâüíé so excited to announce that our 3 sparkling scents, &amp; 3 luxe diamond bottles are now available at @ultabeauty store now! Shop them for $40 in Ulta Beauty! #ultabeauty https://t.co/lsTw8qzLHP",4686,216,2019,62585118,4902,0.01,271
119,"I‚Äôm excited that the @kkwfragrance Diamonds by @kourtneykardash, @khloekardashian and myself are officially at @ultabeauty stores! ‚ú® https://t.co/M0DxKvnIpp",2184,133,2019,62585118,2317,0.0,156
120,Put them on a plate then in the microwave for 30 seconds and it will change your life! Melted on the inside and crunch on the outside https://t.co/B0hOQHzfQe,218713,17963,2019,62585118,236676,0.38,157
121,The #KKWxMario: The Artist &amp; Muse collection is available on https://t.co/PoBZ3bhjs8 @kkwbeauty ‚ú® https://t.co/rzoMWP7HZs,4586,221,2019,62585118,4807,0.01,125
122,"Sabey wears The Artist &amp; I Need More Light from the #KKWxMario: The Artist &amp; Muse Eyeshadow Palette and Proud of You gloss, all available now on https://t.co/PoBZ3bhjs8 https://t.co/1RKJ59uQ3I",1809,92,2019,62585118,1901,0.0,200
123,I literally recorded this and set this as my alarm a few weeks ago! https://t.co/HNYmv8KJ9m,137503,7067,2019,62585118,144570,0.23,91
124,Such a beautiful look using the new collab with @MakeupByMario available now at https://t.co/aIjp1MBlpZ https://t.co/yvXORWayhn,2443,129,2019,62585118,2572,0.0,127
125,Today I‚Äôm wearing my new collection that I collaborated with @MakeupByMario on! Get the #KKWxMario: The Artist &amp; Muse collection now at https://t.co/5re4XdoRSp @kkwbeauty https://t.co/JeTpK3sme1,3478,227,2019,62585118,3705,0.01,198
126,Reposting this tweet of mine from 2010 on the anniversary of MBDTF ‚ú® https://t.co/aJ9wuVwKfw,13567,1574,2019,62585118,15141,0.02,92
127,I have two already! My VP of brand development is 100% Armenian!!! üá¶üá≤ https://t.co/mfayLFS827,3365,153,2019,62585118,3518,0.01,93
128,We really love naming shades but it‚Äôs also so hard to make sure they are unique #KKWXMARIO https://t.co/j5VnPBuIku,750,34,2019,62585118,784,0.0,114
129,No this collection is only available at https://t.co/aIjp1MBlpZ https://t.co/ZvVjjbqmHp,551,36,2019,62585118,587,0.0,87
130,No it‚Äôs not. When we sell out. That‚Äôs it! https://t.co/I7OumKuFmO,896,41,2019,62585118,937,0.0,65
131,‚ô•Ô∏è https://t.co/LZW1PmgbgJ,1096,47,2019,62585118,1143,0.0,26
132,"The blush. I always wear blush even if you don‚Äôt wear lots of make up, a little blush makes you feel alive https://t.co/CwAJl8EJyA",1654,85,2019,62585118,1739,0.0,130
133,He really loves my matte formulas bc they aren‚Äôt drying. And he knew he wanted a matte. We love a good peach tone too #KKWXMARIO https://t.co/mDXkqrlzfg,706,26,2019,62585118,732,0.0,152
134,Honestly all of the lip products are perfection but then this palette is so perfect for fall. So I can‚Äôt decide #KKWXMARIO https://t.co/8lDYnezou2,496,29,2019,62585118,525,0.0,146
135,I really trust him completely so we didn‚Äôt disagree with anything here #KKWXMARIO https://t.co/SOfETpwBDu,479,25,2019,62585118,504,0.0,105
136,I love seeing all of the content and doing shoots with him #KKWXMARIO https://t.co/99seBzWkGB,488,28,2019,62585118,516,0.0,93
137,We love working together that we wanted to do it again. #KKWXMARIO https://t.co/gk5LcpZg4S,475,26,2019,62585118,501,0.0,90
138,When it comes to a collab with @MakeupByMario he‚Äôs such a perfectionist and just THE BEST at picking formulas and colors that I left him take over. So maybe just the time it takes to create something that‚Äôs from his heart https://t.co/HmqYIIzMKg,476,29,2019,62585118,505,0.0,245
139,It is a must! It‚Äôs what Mario calls our deserted island collection https://t.co/g6Jz1luRCc,576,34,2019,62585118,610,0.0,90
140,Hey guys! I‚Äôm in the glam chair using my new collab with @MakeupByMario so thought I would love to chat with you guys about the collection! Any questions??? #KKWXMARIO,1330,62,2019,62585118,1392,0.0,167
141,üòÇüòÇüòÇ https://t.co/VYJYvdCpiD,60651,1597,2019,62585118,62248,0.1,27
142,Can‚Äôt wait for you to try! https://t.co/3aRTz5NNxC,671,31,2019,62585118,702,0.0,50
143,Hope you love it! https://t.co/2kglfFyYmj,714,34,2019,62585118,748,0.0,41
144,Watch my @voguemagazine ‚ÄúLife in Looks‚Äù video. I‚Äôm going through some of my most iconic and most regrettable looks! https://t.co/6be3OKKIpg,1226,115,2019,62585118,1341,0.0,139
145,This collection is totally little pieces of @makeupbymario and I. ‚ú®KKW x MARIO: The Artist &amp; Muse Collection available now https://t.co/aIjp1MBlpZ https://t.co/vd2T2sIcUd,1520,109,2019,62585118,1629,0.0,174
146,This eye shadow color ‚ÄúMario‚Äôs Muse‚Äù is one of my favorites and back in the day when I was obsessed with matching my shadow to my hair clips and outfits I loved a beautiful shimmer cranberry color like this! Be sure and shop the collection now at https://t.co/aIjp1MBlpZ https://t.co/snuij9dwpd,2219,118,2019,62585118,2337,0.0,294
147,The KKW X MARIO: The Artist and Muse Collection is now live on https://t.co/PoBZ3bhjs8 I love this look @makeupbymario did using the entire collection! https://t.co/TX93M88hwW,2525,176,2019,62585118,2701,0.0,175
148,My @kkwbeauty collaboration with @makeupbymario #KKWxMario: The Artist &amp; Muse collection is available to shop NOW at https://t.co/PoBZ3bhjs8 https://t.co/Jg4m4xINbY,867,68,2019,62585118,935,0.0,168
149,Swatches make me so happy! This palette is so delish! So neutral but warm can do some major looks too! Can‚Äôt wait to see what looks you create with this palette and post them! Just an hour and a half until launch time! KKW X MARIO: The Artist and Muse Collection https://t.co/EKSwMVYsaX,1831,97,2019,62585118,1928,0.0,286
150,Glam possibilities are endless with the new #KKWxMario: THE ARTIST &amp; MUSE collection. Get it today at 12PM PST! https://t.co/uSmcD153qK,6534,302,2019,62585118,6836,0.01,139
151,I am so proud of this collection! It was so important to @MakeupByMario to have our desert island collection. A collection that if we were stranded on a deserted island &amp; could only grab one forever this would be it! I truly can‚Äôt wait for you guys to get this! https://t.co/9TaenWZjzM,10951,409,2019,62585118,11360,0.02,289
152,So excited for the KKW x Mario: The Artist &amp; Muse collection launching *tomorrow* at 12PM PST! https://t.co/AYgc1pvzMS,6594,282,2019,62585118,6876,0.01,122
153,üíïüíé https://t.co/Z4ZWOp3BYu,2095,98,2019,62585118,2193,0.0,26
154,How good would this @versace dress have been if it fit üò≠ https://t.co/7rKjSkbCdp,68057,2793,2019,62585118,70850,0.11,80
155,"Hey Australia, @kkwfragrance is available now exclusively at @myer. Hope you love
them all as much as I do. You can buy in store or online at https://t.co/wHVTcO3hT5. #KKWMyer https://t.co/SE6ZRiGMXS",3181,170,2019,62585118,3351,0.01,200
156,üñ§ https://t.co/T43snvcZiy,12376,658,2019,62585118,13034,0.02,25
157,#KKWxMario: The Artist &amp; Muse launches tomorrow at 12PM PST on https://t.co/PoBZ3bhjs8 https://t.co/2XgsQWlO17,2283,134,2019,62585118,2417,0.0,114
158,"Best Friends!

üì∑ @mariotestino https://t.co/BAIBkcBazc",92454,4790,2019,62585118,97244,0.16,56
159,My goal is to make @skims as accessible as possible for everyone very soon &amp; I truly appreciate everyone‚Äôs patience and continued support.,5364,180,2019,62585118,5544,0.01,142
160,"If your desired @skims item is sold out, pls sign up for our waitlist for that item which helps us determine the quantities that we need to produce to meet the demand.",1911,86,2019,62585118,1997,0.0,167
161,Please know that our teams are doing everything possible to produce more to meet the high demand. We make our own fabric exclusive only to @skims products and the team is working tirelessly to continue to produce these high quality items at our prices.,1866,79,2019,62585118,1945,0.0,252
162,I understand some of you were unable to purchase @skims today before your wish list items sold out and I can only imagine how frustrating it is to not be able to get your hands on our products before they are gone.,3442,95,2019,62585118,3537,0.01,214
163,"Wow, I can‚Äôt believe how fast so many @skims items sold out this am! We still have some inventory including our core control brief, open bust slip dress &amp; bodysuit, long skirt slip, sculpting short mid thigh &amp; above the knee so shop https://t.co/qc7FuvGMzo before they're gone.",852,58,2019,62585118,910,0.0,285
164,Awww...Thank you!!! https://t.co/s9wAsFBDHB,1291,47,2019,62585118,1338,0.0,43
165,One of my favorite products from the line. You're going to love! https://t.co/GCPbNmpJ34,910,40,2019,62585118,950,0.0,88
166,Yes!!! https://t.co/mnsTp4fxKP,605,36,2019,62585118,641,0.0,30
167,Can't wait for you to try! Please let me know what you think when you receive your order! https://t.co/1lYbmZZLJC,737,39,2019,62585118,776,0.0,113
168,We still have large a variety of Solutionwear‚Ñ¢ sizes and styles still available at https://t.co/Qsy51S3rtD! Hurry and shop your favorites before they sell out and enjoy free shipping on all domestic orders over $75.,814,60,2019,62585118,874,0.0,215
169,So excited for you to finally get to experience @skims! Please let me know what you think when you get them! https://t.co/z0heB9cM9b,1234,50,2019,62585118,1284,0.0,132
170,Thank you for all that you do @innocence https://t.co/bd08a0lVTm,1549,108,2019,62585118,1657,0.0,64
171,Thank you so much! When researching Rodneys case I came across so many of your messages and was moved by all that you had spoken out about. https://t.co/1CPB6Ki10K,2766,170,2019,62585118,2936,0.0,163
172,Yes he does! I saw that episode of the @DrPhil show and learned so much about his case. Thank you Dr. Phil https://t.co/X26oyoKeEV,2437,140,2019,62585118,2577,0.0,130
173,This was exactly what I was going for! https://t.co/AMt6cxTC5l,4515,154,2019,62585118,4669,0.01,62
174,Last night in Christian Dior üì∑ Pierre https://t.co/YnrMgVX2oB,71893,4992,2019,62585118,76885,0.12,61
175,No one deserves this award more than @MakeupByMario I‚Äôm so proud of him! https://t.co/L6BdfnFqr9,9578,426,2019,62585118,10004,0.02,96
176,American Influencer Awards üì∑ Getty Images https://t.co/D7l6Nw0Dz4,21333,1182,2019,62585118,22515,0.04,65
177,My new favorite show is Long Lost Family ‚ú® I literally cry every single episode. Like sob cry üò≠ Anyone else watch this show and cry?,10603,286,2019,62585118,10889,0.02,132
178,Thanks @JennaBushHager for this amazing interview! Everyone tune into @TODAYshow this morning to hear about how how the country came together in support of Rodney Reed. https://t.co/sTeKPoHad8,3932,197,2019,62585118,4129,0.01,192
179,Our @skims INFOMERCIALS are here!!!! Thank you @krisjenner @kylerichards18 @lisarinna for making my 90‚Äôs infomercial dreams come true!!! https://t.co/Qsy51S3rtD RESTOCKING WEDNESDAY of ALL shapewear and new styles too!!!! https://t.co/upZ4F18jqq,7383,622,2019,62585118,8005,0.01,245
180,Tune in! https://t.co/M1f3LcQhxp,3601,269,2019,62585118,3870,0.01,32
181,üíéüíéüíé KKW DIAMONDS is available now at https://t.co/eAGj08RjbA üíéüíéüíé https://t.co/bPNZGvUmYf,8296,344,2019,62585118,8640,0.01,88
182,I had faith in him ‚ú® https://t.co/F6PlyBDzm2,405208,41808,2019,62585118,447016,0.71,44
183,"This Dutch ‚Äútradition‚Äù called: ‚Äúblack pete‚Äù is disturbing! 
https://t.co/fF26SP99OT",23754,7167,2019,62585118,30921,0.05,84
184,Always https://t.co/BPJQbqIdh6,143601,9763,2019,62585118,153364,0.25,30
185,"So grateful for the commitment and passion of everyone who voiced their support, the Texas Board of Pardons and Paroles for their recommendation to issue a 120 day reprieve, and the courts for issuing a stay!",5628,460,2019,62585118,6088,0.01,208
186,We have heard people all around the globe speak up. And all because of a deep belief that every man or woman accused of a crime - especially one punishable by death - deserves the chance to have all available evidence considered.,3788,360,2019,62585118,4148,0.01,229
187,Words cannot describe the relief and hope that swept over the room in that moment. That hope had been building over the last few weeks around Rodney‚Äôs case. We have seen Democrats and Republicans come together. We have seen grassroots activists and lawmakers link arms.,5305,428,2019,62585118,5733,0.01,269
188,"Today, I had the honor of meeting #RodneyReed in person and the privilege of sitting with him when he got the news that the highest court in Texas had issued a stay of execution and remanded the case back to the trial court for further consideration.",28596,2988,2019,62585118,31584,0.05,250
189,Be sure to join the waitlist at https://t.co/Qsy51S3rtD to be the first to shop when the collection drops!,950,64,2019,62585118,1014,0.0,106
190,"These are the original pieces we‚Äôre bringing back on November 20th, which will feature a super soft fabric SKIMS label! We‚Äôll also be introducing 4 new @skims Solutionwear‚Ñ¢ styles based on your comments and requests since we launched that I can‚Äôt wait to show you.",1335,63,2019,62585118,1398,0.0,264
191,"After the name change, we wanted to make sure we didn‚Äôt waste any of the original @skims product, so we tried and tested hundreds of different approaches to remove the old branding to ensure we saved it all.",3066,90,2019,62585118,3156,0.01,207
192,"I know it feels like we‚Äôve been out of stock for a long time but I am so excited to announce that we are finally restocking our original @skims Solutionwear‚Ñ¢ on Wednesday, November 20th at 9am PST / 12pm EST! https://t.co/xKIVj12q6g",6128,270,2019,62585118,6398,0.01,232
193,"HBD to @makeupbymario‚Äôs mom today, without her I wouldn‚Äôt be who I am today without Mario!  This is a typical glam session with Mario &amp; I. Me on my phone, him laser focused &amp; us testing out new formula 
&amp; colors. (Not our final palette) KKW X MARIO The Artist and The Muse Nov 22 https://t.co/N1vk3jOctG",3970,167,2019,62585118,4137,0.01,316
194,Wow just heard about another senseless shooting in Santa Clarita - absolutely devastated and heartbroken. Praying for the families and everyone who has been effected by this tragedy.,15078,1040,2019,62585118,16118,0.03,182
195,We still have a limited amount of SKIMS Tonal Body Tape and Pasties still available in Tiger‚Äôs Eye and Smokey Quartz! Shop now at https://t.co/Qsy51Sl2Sd and enjoy free shipping on domestic orders over $75.,791,48,2019,62585118,839,0.0,206
196,Available now: @skims Tonam Body Tape in Smokey Quartz at https://t.co/qc7FuvpbHQ https://t.co/G323uBfSyk,1784,96,2019,62585118,1880,0.0,105
197,Available now: @skims Tonal Body Tape in Tiger‚Äôs Eye at https://t.co/qc7FuvpbHQ https://t.co/zAkjOQrQi1,3039,145,2019,62585118,3184,0.01,103
198,Available now: @skims Pasties in Smokey Quartz at https://t.co/qc7FuvpbHQ https://t.co/3nczPYvUfX,1187,76,2019,62585118,1263,0.0,97
199,Available now: @skims Pasties in Tiger‚Äôs Eye at https://t.co/qc7FuvpbHQ https://t.co/MVHFgQtM0D,944,53,2019,62585118,997,0.0,95
200,Praying for everyone‚Äôs safety in Australia right now during these fires,9464,589,2019,62585118,10053,0.02,71
201,Check my earlier tweets from yesterday I shared pics from all styles wearing one shoulder tops and dresses https://t.co/eJ8qLpDFb2,1426,55,2019,62585118,1481,0.0,130
202,Even do it for 30 or 40 seconds and it‚Äôs a dream! https://t.co/g9JUwYpfpz,5348,214,2019,62585118,5562,0.01,73
203,FYI for the @skims Body Tape you can use other colors other than your skin tone. It also depends on the color of your dress or top if it will photograph underneath. You want to match the color of your clothes if it is slightly sheer. https://t.co/Qsy51S3rtD,923,59,2019,62585118,982,0.0,257
204,Shop Tonal Body Tape and Pasties now at https://t.co/Qsy51Sl2Sd and enjoy free shipping on domestic orders over $75. https://t.co/4tLEmCu7Sg,1803,113,2019,62585118,1916,0.0,140
205,"LAUNCHING IN 30 Minutes the SKIMS Tonal Body Tape and Pasties ‚Äî my styling solutions for invisible hold, support, coverage, and lift. Shop at 9AM PST / 12PM EST exclusively at https://t.co/Qsy51Sl2Sd. https://t.co/4g7qDk4kax",3890,238,2019,62585118,4128,0.01,224
206,You have to try it! Warm melted chocolate inside and the hard crunchy shell on the outside https://t.co/ykhX5Cj8nQ,4867,253,2019,62585118,5120,0.01,114
207,Part 2 @skims https://t.co/PiGLOBu1Lg,2886,199,2019,62585118,3085,0.0,37
208,Real stories from real women trying @skims body tape https://t.co/jDomnE9EZM,10648,546,2019,62585118,11194,0.02,76
209,The duct tape is so painful ugh! The key is out the nipple cover on first then tape up! https://t.co/Lc7pX34JSa,2898,111,2019,62585118,3009,0.0,111
210,Thank you! I know you will live it! It launches tomorrow https://t.co/EFAJ27l2eI,1303,50,2019,62585118,1353,0.0,80
211,‚ô•Ô∏è https://t.co/YraTyHLWjV,3137,83,2019,62585118,3220,0.01,26
212,True!!! https://t.co/W01fI3VDpT,14488,340,2019,62585118,14828,0.02,31
213,https://t.co/yFNxgHOKot,5949,264,2019,62585118,6213,0.01,23
214,https://t.co/m7sZT4Aa2T,15157,587,2019,62585118,15744,0.03,23
215,https://t.co/vr72uDGhXW,3731,193,2019,62585118,3924,0.01,23
216,https://t.co/KEdTFAFDDE,2876,146,2019,62585118,3022,0.0,23
217,https://t.co/uBYtzyZSSv,2704,145,2019,62585118,2849,0.0,23
218,https://t.co/r8M7BF3DLj,5450,210,2019,62585118,5660,0.01,23
219,https://t.co/TlyIiQ4hYR,2841,145,2019,62585118,2986,0.0,23
220,https://t.co/KbzAiO0ifi,3080,134,2019,62585118,3214,0.01,23
221,https://t.co/9RisqzPxgi,6663,230,2019,62585118,6893,0.01,23
222,https://t.co/4n9NhiYwPl,2818,124,2019,62585118,2942,0.0,23
223,I‚Äôm going to show you some examples of when I have used tape! https://t.co/wvThjRkbTp,3762,156,2019,62585118,3918,0.01,85
224,Taking the tape off has been so painful and left me with cuts and burns throughout the year; so it is important I made sure our @skims tape is gentle and less painful when removing it https://t.co/ac3b26DRaD,8858,487,2019,62585118,9345,0.01,207
225,Anytime I have a low cut top I tape up. https://t.co/DYq8qh3TsG,17975,1242,2019,62585118,19217,0.03,63
226,https://t.co/nHDNuk3wUf,2961,188,2019,62585118,3149,0.01,23
227,https://t.co/DSb97vgwAF,2215,161,2019,62585118,2376,0.0,23
228,I‚Äôm going to show you guys how to use it! @skims body tape and pasties launching soon! https://t.co/AcbEVR8GO0,1869,131,2019,62585118,2000,0.0,110
229,Body tape has been a huge part of my life! Can‚Äôt live without it and so excited @skims is launching three shades of the best boob tape! https://t.co/ipOvd7Hvas,2188,129,2019,62585118,2317,0.0,159
230,Also be sure to go and check out @kkwbeauty on Instagram because our images that will be sharing are a true journey of an artist and muse,1773,90,2019,62585118,1863,0.0,137
231,"Stay tuned for round 2 of KKW x MARIO: The Artist And Muse ‚ô•Ô∏è
You guys are going to love this collection!!!",2222,102,2019,62585118,2324,0.0,108
232,"He values hard work and is loyal  to the core. never one to follow trends, he‚Äôs become a trailblazer, pioneer, educator and an inspiration to artists around the world.",4254,186,2019,62585118,4440,0.01,167
233,"I‚Äôve watched him grow from a talented young artist who slowly and respectfully worked his way up through the years in the the old fashioned way, never expecting short cuts and always putting his work and others first.",4640,139,2019,62585118,4779,0.01,217
234,"For over 11 years, Mario and I have worked together and created some incredible glam moments. I‚Äôm so excited to finally announce our 2nd collaboration together. I‚Äôve watched him work passionately for the past year on this collection and campaign. https://t.co/MbOFBlP0Xb",28338,961,2019,62585118,29299,0.05,270
235,Hi Australia! I have some exciting news coming soon just in time for the holidays. Can you guess what is is? Stay tuned for the big announcement...üíã https://t.co/y0FoZpAhx2,16777,619,2019,62585118,17396,0.03,172
236,Such a good read. Everyone should read this entire thread from a journalist who has followed this case for 18 years! https://t.co/PHCbX7pCMd,2948,369,2019,62585118,3317,0.01,140
237,‚ù§Ô∏è https://t.co/Q1AMC7M6gk,2067,102,2019,62585118,2169,0.0,26
238,Thank you so much to everyone who voted for our family for Best Reality Show at the People‚Äôs Choice Awards. We are grateful for the win!!! https://t.co/Dy6nHpD5eF,48032,2592,2019,62585118,50624,0.08,162
239,"Happy Singles Day! Today only you can get @kkwbeauty glosses, contour and highlight stick singles and our powder highlight singles for $11. Ends at 11:59pm pst. No code necessary! #kkwbeauty #SinglesDay https://t.co/q7tnK56M8i",1297,84,2019,62585118,1381,0.0,226
240,Join the @skims waitlist now at https://t.co/Qsy51S3rtD to be the first to shop. https://t.co/2V2astiyFd,723,54,2019,62585118,777,0.0,104
241,"The new @skims collection features my styling solutions for invisible hold, support, coverage and lift, available in 3 colors. Launching 11.14 at 9AM PST / 12PM EST. https://t.co/B46b1hJ3HF",2505,146,2019,62585118,2651,0.0,189
242,New @skims announcement!COMING SOON: TONAL BODY TAPE AND PASTIES https://t.co/RrlVx9GiKA,4171,216,2019,62585118,4387,0.01,88
243,Oh yes! I will bring them all with me https://t.co/zbiaRVY6Xd,1698,85,2019,62585118,1783,0.0,61
244,Yes!!!! The clear diamond tonight! Feels sexy https://t.co/n7CjHVFhL9,1656,70,2019,62585118,1726,0.0,69
245,The high waisted bonded short https://t.co/tYbMLuxdlv,1282,48,2019,62585118,1330,0.0,53
246,Always https://t.co/CUFaupkoxr,894,38,2019,62585118,932,0.0,30
247,We are debating dying it again before the year is up. I can‚Äôt decide https://t.co/N32PzpLCgp,1902,50,2019,62585118,1952,0.0,92
248,"Me, my mom, Kourtney and Khloe https://t.co/UWkHGC65Ry",1431,57,2019,62585118,1488,0.0,54
249,Versace Archives https://t.co/RlGDcCdyRS,1869,68,2019,62585118,1937,0.0,40
250,Feeling this https://t.co/0sDP60ZnsX,849,39,2019,62585118,888,0.0,36
251,I want soft and pretty make up. Pink cheek and soft lip I think we‚Äôre going with https://t.co/4ukIv6xggZ,930,50,2019,62585118,980,0.0,104
252,I hope do! Did you vote? https://t.co/SNhEaKCxy0,905,45,2019,62585118,950,0.0,48
253,I loved this hair and so did North! https://t.co/borDPXxhEt,1102,41,2019,62585118,1143,0.0,59
254,Not happening tonight! BUTTT I need to do this again soon. It‚Äôs been so long since I‚Äôve worn a red lip üíã https://t.co/Zk8kIRhgQv,988,40,2019,62585118,1028,0.0,128
255,I have @MakeupByMario &amp; @ChrisAppleton1 doing glam today! I‚Äôm excited for this dress I‚Äôm wearing; I‚Äôve wanted to wear it for a long time ‚ú®,1261,65,2019,62585118,1326,0.0,142
256,"Happy Sunday! I‚Äôm getting ready for the People‚Äôs Choice Awards, what look should I do tonight?",16555,373,2019,62585118,16928,0.03,94
257,My favorite sister shoot ever! #kkwdiamonds We‚Äôre almost sold out! Such a successful launch! Thank you so much everyone who got your bottle! There‚Äôs still some left! https://t.co/x0WDr8PWWW https://t.co/UJWG6g9okU,5085,254,2019,62585118,5339,0.01,213
258,For the #kkwdiamonds shoot we wanted to do something different with glam! I love curly hair for this shoot &amp; saw such amazing amazing response w Khloe going brunette. Hope you guys got the new @kkwfragrance diamonds collection available now on https://t.co/eAGj098U38 https://t.co/4OG1APdWrN,4345,196,2019,62585118,4541,0.01,295
259,"Also for everyone asking, the autographed sister posters from the #kkwfragrance Diamonds campaign that we created just for our PR mailer we will be giving away for free. Stay tuned for details on how you can win one! üíã",2719,115,2019,62585118,2834,0.0,218
260,"So grateful for the overwhelming response for the @KKWFRAGRANCE Diamonds collection! We increased our order volume for this this launch to make it more accessible w/the holidays so if you haven‚Äôt had a chance yet, we still have some quantities left before they are gone! https://t.co/ic9nkoKjfB",5086,264,2019,62585118,5350,0.01,294
261,Awww Happy Belated Birthday!!! https://t.co/GlUbyAzMmM,3636,98,2019,62585118,3734,0.01,54
262,"When you shop our #KKWDIAMONDS fragrances, you get FREE SHIPPING on domestic orders over $75 or $30 off shipping on international orders over $110! https://t.co/tbQezJs782 https://t.co/dtNTIHqi7j",3343,213,2019,62585118,3556,0.01,195
263,You will love the trio! These could be my favorite fragrances to date!!!! https://t.co/NLnDy0vEnJ,1510,49,2019,62585118,1559,0.0,97
264,How beautiful is our @KKWFRAGRANCE Diamonds collection packaging? https://t.co/RS42f6gTRv,2805,107,2019,62585118,2912,0.0,89
265,Can‚Äôt wait for you to get them!!! https://t.co/4LCHWeQaCw,961,32,2019,62585118,993,0.0,57
266,Christmas time is coming up and I wanted to make it really easy for everyone especially the guys trying to get a really thoughtful gift. The trio set is the perfect gift! #KKWDIAMONDS https://t.co/eAGj098U38,974,71,2019,62585118,1045,0.0,207
267,The clear diamond! #KKWDIAMONDS https://t.co/eAGj098U38 https://t.co/xAFZvl2ohk,659,43,2019,62585118,702,0.0,79
268,The clear one! #KKWDIAMONDS  https://t.co/eAGj098U38 https://t.co/4z8teHcOzF,630,35,2019,62585118,665,0.0,76
269,Our @KKWFRAGRANCE Diamonds collection is now live!!! @khloekardashian @kourtneykardash. Link in bio. Pls message us and let us know which one you bought! üíã https://t.co/BKSyI6aWyF,1676,139,2019,62585118,1815,0.0,179
270,The Trio! https://t.co/L8kJPrPsFr,1049,45,2019,62585118,1094,0.0,33
271,The pink diamond! https://t.co/ZjH8BVE5Xg,1055,49,2019,62585118,1104,0.0,41
272,https://t.co/x0WDr8PWWW https://t.co/WTnHx9yB2K,424,21,2019,62585118,445,0.0,47
273,#1 with a lemonade https://t.co/s1FyY5wLOe,58680,3955,2019,62585118,62635,0.1,42
274,They are long wearing! https://t.co/UZtAAFndWL,566,24,2019,62585118,590,0.0,46
275,Absolutely!!! These three are especially really different https://t.co/HpbvO9uMxJ,617,23,2019,62585118,640,0.0,81
276,The clear diamond one! https://t.co/32BrptpS7P,826,29,2019,62585118,855,0.0,46
277,Currently only on line! https://t.co/2Plfje1QCu,476,27,2019,62585118,503,0.0,47
278,Yes! You will love them all so just pick your fave sister lol https://t.co/Z6gmxInLpO,1017,42,2019,62585118,1059,0.0,85
279,Pink diamond is what I‚Äôve been wearing every day lately https://t.co/6w4M4jHvGN,922,28,2019,62585118,950,0.0,79
280,Either the clear diamond or the yellow https://t.co/Ri7RUk9Qnm,750,24,2019,62585118,774,0.0,62
281,I feel like the yellow diamond is perfect for you then! https://t.co/Sp6tELdk1X,1364,55,2019,62585118,1419,0.0,79
282,"I‚Äôve been wearing this everyday for weeks and it‚Äôs really become my go to lately. Anyone who knows me knows how much I love white florals. I‚Äôve combined them with tropical florals, coconut milk cream, orange blossoms and white musk to create my most dreamy fragrance yet. https://t.co/iGnhNlOLh9",2002,101,2019,62585118,2103,0.0,295
283,Wow I remember this like it was yesterday!!! https://t.co/rEx13xfaWu,31142,971,2019,62585118,32113,0.05,68
284,"Cannot wait for you to smell @khloekardashian‚Äôs diamond fragrance, it‚Äôs exactly what you imagine she is would smell like, it‚Äôs gorgeous and it‚Äôs perfection! https://t.co/O5pYxLyfZX",2435,133,2019,62585118,2568,0.0,180
285,REMIX!!!!! @kourtneykardash @khloekardashian @KylieJenner  LOL!!! https://t.co/6RdZGGYT41,9814,674,2019,62585118,10488,0.02,89
286,Where are all of the Mr. Softee in NYC? I can‚Äôt find one anywhere!,11009,348,2019,62585118,11357,0.02,66
287,I am so very thankful to see Republicans &amp; Democrats in Texas working together and thoughtfully asking @GovAbbott to grant Rodney Reed a reprieve so that new evidence can be considered. https://t.co/BuSpOtcnPK,7484,1098,2019,62585118,8582,0.01,213
288,Fittings ‚ú® https://t.co/lwNR9zmvEd,80399,3238,2019,62585118,83637,0.13,34
289,"This was the most special, nostalgic day of my life and we felt my dad‚Äôs presence enjoying this day with us! 
I kept it together at lunch even though I cried during the planning process. But at the end I went into my old bathroom, closed the door &amp; cried so hard. https://t.co/0JLNtBItzR",86905,4725,2019,62585118,91630,0.15,292
290,I even remade the exact license plates. (Yes my mom had a 2 DIE 4 license plate!) We drove to the home in these cars and relived our childhood! This was the best day ever. I am so proud I was able to keep such a meaningful surprise a secret from my mom and sisters for weeks!,13539,370,2019,62585118,13909,0.02,275
291,I had some waiting outside so we could drive them to the house and the rest were lined up in the driveway of the house exactly how my parents used to have them parked.,8396,262,2019,62585118,8658,0.01,167
292,"We had lunch at the home as if it hadn‚Äôt changed and we cried the entire time. When we walked out to get our cars to drive there, I had another surprise! I had rented every car my parents ever owned.",15222,406,2019,62585118,15628,0.02,199
293,"All of our memories live here especially with our dad. It‚Äôs where each Kardashian child was born &amp; made us who we are. Growing up, the home had the most ridiculous wallpaper &amp; kitchen set! I remade all of our table settings out of the same fabric &amp; print as the wallpaper.",10824,346,2019,62585118,11170,0.02,284
294,I then gave everyone the REAL invitation and once everyone saw the address for where we would be going tears filled the room. I rented our childhood home. https://t.co/RL6QTP5l8d,67729,3743,2019,62585118,71472,0.11,178
295,"For her birthday I planned a small lunch, with just her kids and her closest friends of 40 + years. I sent out invites with a location where we all met. When everyone arrived, I told them I had a surprise and this wasn‚Äôt where we would be eating.",12640,337,2019,62585118,12977,0.02,246
296,"Today we celebrate my mom. Anyone that knows her, knows how sentimental she is.",11678,348,2019,62585118,12026,0.02,79
297,My sisters and I had so much fun stopping by @TheRealDaytime to talk about our new @KKWFRAGRANCE collab which launches this Friday at 12pm pst! The show airs today - check your local listings! https://t.co/6PW5rKkV77 https://t.co/eUt4axfeL6,3421,227,2019,62585118,3648,0.01,240
298,"Join me, @KourtneyKardash and @KhloeKardashian as we sit down with our friends @TheRealDaytime today and talk about our new @KKWFragrance! Check your local listings! https://t.co/6PW5rKkV77",1320,97,2019,62585118,1417,0.0,189
299,You‚Äôve given us the tools to be the best we can be and have taught us that kindness rules the world!  I can‚Äôt wait to celebrate you today! I love you so much! Happy Birthday @KrisJenner,5548,224,2019,62585118,5772,0.01,185
300,"Today is your day! You are the best mom in the entire world. I don‚Äôt know how you do it! Seriously my love and respect for you grows every single day seeing how you  manage to take care of 6 kids, a million grand kids and make everyone feel so loved and special. https://t.co/zHObV2LL3p",44465,1690,2019,62585118,46155,0.07,286
301,I hope everyone has a good night! üåô,26533,1723,2019,62585118,28256,0.05,35
302,Nobu celebrating @caitlynjenner birthday! Made me happy most of us were together again celebrating! Happy 70th birthday üéÇ https://t.co/den3U3097F,26746,785,2019,62585118,27531,0.04,145
303,Goooo Kenny @KendallJenner üèéüèéüèé https://t.co/r7xHACvyoR,30732,1750,2019,62585118,32482,0.05,54
304,For @kendalljenner birthday yesterday went to the race track! https://t.co/7ibVqNfiK4,6335,194,2019,62585118,6529,0.01,85
305,Happy Birthday @KendallJenner üèé https://t.co/E4O7TLqeWe,68960,5849,2019,62585118,74809,0.12,55
306,Omg i was crying laughing at them and then got so sleepy. I was just tired https://t.co/0vkSETsm7w,19077,635,2019,62585118,19712,0.03,98
307,Kanye West's 'Jesus Is King' Arrives as His Record-Tying Ninth Consecutive No. 1 Debut on Billboard 200 Chart https://t.co/8PAlpSHshw,11262,1110,2019,62585118,12372,0.02,133
308,Wait until you see the new commercial for @skims! Sneak peek tonight on Keeping Up! #KUWTK @krisjenner https://t.co/2xvbMz8JVJ,3268,164,2019,62585118,3432,0.01,126
309,"‚ÄúJESUS IS KING‚Äù 
IMAX FILM
IN THEATERS NOW

https://t.co/Kx8mLUAHdD https://t.co/A0fZxMfjOm",6359,628,2019,62585118,6987,0.01,95
310,https://t.co/OW9ZPFLbum,15943,608,2019,62585118,16551,0.03,23
311,https://t.co/SJoHwATw6F,11037,534,2019,62585118,11571,0.02,23
312,Realized I posted these images filtered but you can see the detail so much better when they aren‚Äôt filtered. So reposting them üêõü¶üü¶óüêú https://t.co/KZjiLsDmup,30577,1583,2019,62585118,32160,0.05,155
313,"From the movie Sing üé§

Saint as Johnny
Kanye as Johnny‚Äôs dad
Psalm as Johnny‚Äôs brother 
Chicago as Ash 

Kanye went trick or treating like this and could hardly fit in the car üöô üòÇ https://t.co/MmXyo3CHhv",41740,2541,2019,62585118,44281,0.07,210
314,üíïüíïüíï https://t.co/1Bk0kpiQr3,13605,421,2019,62585118,14026,0.02,27
315,üêõ https://t.co/uLBqwmhaXp,45388,1418,2019,62585118,46806,0.07,25
316,"A bugs life! üêõü¶üüêú

My costume glowed
Kanye‚Äôs costume moved and was all anamatronics https://t.co/cGmwHFlR4F",37829,2007,2019,62585118,39836,0.06,109
317,"West Worms üêõ üêõüêõüêõüêõüêõ
Prelude 1 
Set to üé∂ Lorna Anderson https://t.co/MvTPSnKI5s",32294,2588,2019,62585118,34882,0.06,79
318,West Worms üêõ üêõüêõüêõüêõüêõ https://t.co/juc2wqZC4t,166720,14875,2019,62585118,181595,0.29,42
319,Aliens üëΩ https://t.co/8HQOmrbQF1,78812,4241,2019,62585118,83053,0.13,32
320,Just added new items to my store on #kardashiankloset https://t.co/SUNF70bPuY https://t.co/8qPPeqc2zn,2122,92,2019,62585118,2214,0.0,101
321,Old interviews are the best! Mary Phillips and I just spoke about this look last week https://t.co/Bmle55D3sn,7589,334,2019,62585118,7923,0.01,109
322,This family pic was such a challenge because Chicago was so scared of Dino! LOL We tried to explain and show her that it was just daddy but she didn‚Äôt get the concept yet! So shout out to the photographer for editing her in &amp; making our family Flinstones dreams come true! https://t.co/FwWwKVaPCo,209832,19802,2019,62585118,229634,0.37,300
323,Yabba Dabba Doo! https://t.co/cWKnalkaBM,70608,4097,2019,62585118,74705,0.12,40
324,Flintstones ü¶¥ https://t.co/8pqmUkhQYV,249662,19488,2019,62585118,269150,0.43,37
325,üíïüíïüíï https://t.co/evVEnYUr32,16533,349,2019,62585118,16882,0.03,27
326,OMG this is the cutest thing ever!!!! https://t.co/AHHPzoZqM0,17988,655,2019,62585118,18643,0.03,61
327,‚ô•Ô∏è‚ô•Ô∏è‚ô•Ô∏è https://t.co/ZMvTmxqHdD,9960,322,2019,62585118,10282,0.02,30
328,‚ô•Ô∏è‚ô•Ô∏è‚ô•Ô∏è https://t.co/xZKVaHVqdm,3378,117,2019,62585118,3495,0.01,30
329,Harvard Law.... What? Like it‚Äôs hard??? https://t.co/tKDzC3r8lb,95982,7437,2019,62585118,103419,0.17,63
330,Essential @skims Cotton Collection pieces are still available at https://t.co/Qsy51S3rtD. Shop now and receive free shipping on domestic orders over $75. https://t.co/TDDY2nWreO,2498,113,2019,62585118,2611,0.0,177
331,This is soooo good! I sent it to the designer Riccardo Tisci and Kanye on a group chat! https://t.co/Z9DHKvcslZ,68647,2832,2019,62585118,71479,0.11,111
332,Shop the @skims Cotton Collection now at https://t.co/Qsy51S3rtD and receive free shipping on domestic orders over $75. https://t.co/XjVw45IG8V,2176,90,2019,62585118,2266,0.0,143
333,"Elle Woods Harvard Video Essay

Elias Tahan video and editing 
Ricki Alvarez video and photo
Lauren Drablier producer
Chris Appleton hair
Ash K Holm makeup
Music:
‚ÄúOne Girl Revolution‚Äù
Superchick
Courtesy of Whizbang, Inc.
and Inpop Records",8306,358,2019,62585118,8664,0.01,251
334,Elle Woods Harvard Video Essay https://t.co/PNMBs2dl0C,407884,89000,2019,62585118,496884,0.79,54
335,Legally Blonde https://t.co/7deqdWVv60,183298,19455,2019,62585118,202753,0.32,38
336,Legally Blonde! https://t.co/8OIffq7f3f,381293,37565,2019,62585118,418858,0.67,39
337,I love this!!!! https://t.co/tFy2Xslk4n,51097,1902,2019,62585118,52999,0.08,39
338,How insane!!!! New witness comes forward that Rodeny was NOT the murderer!!!! He is set to be executed Nov 20th. https://t.co/AgGcqVpjV6,3317,700,2019,62585118,4017,0.01,136
339,üôèüèº.   https://t.co/d40kg1m8MZ,2361,372,2019,62585118,2733,0.0,29
340,Yesterday was such a huge victory for the Armenian people when the US House Of Representatives acknowledged the Armenian Genocide! This photo was taken of me and my children this month in Armenia üá¶üá≤ by Jackie Nickerson https://t.co/uIM8DroGEv,94187,7895,2019,62585118,102082,0.16,242
341,Shop the @kkwbeauty Mattes Collection Restock TODAY at https://t.co/PoBZ3bhjs8!!! #KKWBEAUTY https://t.co/uBqfcRgXBe,1516,84,2019,62585118,1600,0.0,116
342,Shop the two new @kkwbeauty Body Foundation shades in Pale &amp; Deep for $45 each NOW at https://t.co/PoBZ3byUQI! #KKWBEAUTY https://t.co/nlOXESYtrt,2313,109,2019,62585118,2422,0.0,149
343,üá¶üá≤üá¶üá≤üá¶üá≤.   https://t.co/shKJjbZVVd,6765,868,2019,62585118,7633,0.01,33
344,WOW LOOK AT THESE INCREDIBLE NUMBERS!!! THE U.S. JUST RECOGNIZED THE ARMENIAN GENOCIDE!!!! üá¶üá≤üôèüèº‚ú® https://t.co/rEwPbZp5m0,12707,1815,2019,62585118,14522,0.02,120
345,The @skims Cotton Collection restock - coming OCTOBER 31 at 9AM PST / 12PM EST. Join the waitlist now at https://t.co/Qsy51Sl2Sd to be the first to shop. https://t.co/eZfnjgipuG,2903,156,2019,62585118,3059,0.0,177
346,"The @kkwfragrance Diamonds Collection by Kourtney x Kim x Khlo√© features three unique scents. Mine is a fresh white floral, Khloe‚Äôs is a sweet floral musk, and Kourtney‚Äôs is a warm jasmine and vanilla scent. Launching 11.08 at https://t.co/tbQezJJIwC https://t.co/vGInXPv1We",2160,185,2019,62585118,2345,0.0,274
347,The OG‚ÄôS for @KKWFRAGRANCE https://t.co/yMn6LbEnKY,26671,1601,2019,62585118,28272,0.05,50
348,I love Khloe as a brunette! I love that she changed it for this shoot! #DiamondsCollection #KKWFragrance,8572,308,2019,62585118,8880,0.01,104
349,Announcing the @kkwfragrance Diamonds Collection by Kourtney x Kim x Khlo√©!!! It‚Äôs the first fragrance collaboration I‚Äôve done with Kourtney and Khloe for my line. Each of the fragrances really capture us individually. Launching on 11.08 at 12PM PST at https://t.co/tbQezJJIwC https://t.co/3L7dtgiiFP,5292,432,2019,62585118,5724,0.01,300
350,"Today, the House of Representatives is voting on H.RES. 296 which would recognize the #ArmenianGenocide. This is personal for me, and millions of Armenians who descended from genocide survivors. Call Congress and tell them it‚Äôs time to act! https://t.co/SymQZNYPg1",7493,1813,2019,62585118,9306,0.01,264
351,"I was up until 1:30am shooting one look!  I have one w kids, one w Kanye and one solo. I have a 4th look but not sure if I will do it this year. Need to decide. https://t.co/ORFmrvUUiu",16878,431,2019,62585118,17309,0.03,184
352,‚ô•Ô∏è https://t.co/Wo4qzqItzM,30746,993,2019,62585118,31739,0.05,26
353,It‚Äôs hard but just have to stay focused and micro manage my day https://t.co/nqoHPqFJhU,3170,131,2019,62585118,3301,0.01,87
354,üôèüèº https://t.co/yoyJXlkllr,1189,54,2019,62585118,1243,0.0,26
355,‚ô•Ô∏è https://t.co/zsTKDgCcwQ,1770,88,2019,62585118,1858,0.0,26
356,üôèüèº @lyft https://t.co/nklIJP5v6U,4024,316,2019,62585118,4340,0.01,32
357,That‚Äôs my baby!!!! https://t.co/FjdXoOtfxf,1105,51,2019,62585118,1156,0.0,42
358,Glad you see a small glimpse https://t.co/y4mKCl86Kx,1162,46,2019,62585118,1208,0.0,52
359,He totally said exactly what I thought he would! #KUWTK https://t.co/ker3Y8JWJu,1599,77,2019,62585118,1676,0.0,79
360,Keeping up with the Kardashian starts right now! I‚Äôm watching with you guys and for once I‚Äôm on time! #KUWTK,2961,155,2019,62585118,3116,0.0,108
361,Omg performing Pablo Songs,11203,617,2019,62585118,11820,0.02,26
362,Go to my IG stories for the best Sunday Service videos ever!!!!! OMG Kenny G is right next to me! Praying he goes up on stage!!!!,4706,240,2019,62585118,4946,0.01,129
363,Sunday Service at the Forum today is going to be soooo good!!!,5710,257,2019,62585118,5967,0.01,62
364,Heading to The White House tonight on Keeping Up #KUWTK https://t.co/w2qMQcQwQ0,9025,655,2019,62585118,9680,0.02,79
365,üòÇüôèüèºü§Ø https://t.co/TdROzNUllR,10149,807,2019,62585118,10956,0.02,28
366,Our group chat is named LIFERS! We spent my birthday weekend in Palm Springs so comfy in our @skims https://t.co/xDoDXghICV,15361,553,2019,62585118,15914,0.03,123
367,üôèüèº https://t.co/XMAo51Xqb8,3830,190,2019,62585118,4020,0.01,26
368,üôèüèº‚ô•Ô∏è https://t.co/5PlVsFnAvr,5362,239,2019,62585118,5601,0.01,28
369,Everyone tune in tonight!!! https://t.co/HospvwyUIp,12041,642,2019,62585118,12683,0.02,51
370,üôèüèº https://t.co/Ce2Im7dVT1,5430,569,2019,62585118,5999,0.01,26
371,üôèüèº https://t.co/hMlaKC2Hrh,1764,137,2019,62585118,1901,0.0,26
372,üôèüèº https://t.co/Yu9OqilGjq,2611,148,2019,62585118,2759,0.0,26
373,Awww love you Harry! https://t.co/ld2ngn7ciT,3407,135,2019,62585118,3542,0.01,44
374,Introducing two NEW shades of @kkwbeauty Body Foundation in Pale and Deep!! Launching on 10.30 at 9AM PST at https://t.co/PoBZ3bhjs8 #KKWBEAUTY https://t.co/aZXTCEzg6r,1428,83,2019,62585118,1511,0.0,167
375,"The @skims High Waisted Bonded Brief ($78) in Onyx is available now in sizes XXS - XL and comes packaged in our signature neoprene pouch. Shop now at https://t.co/Qsy51S3rtD before it sells out.
Photo: #VanessaBeecroft https://t.co/jI71lN1sFG",1177,66,2019,62585118,1243,0.0,243
376,Glam or Goth this Halloween? Testing out costumes with @picsartstudio. #picsart #picsartpartner https://t.co/ZJHswYX67y https://t.co/6lo6ptThdZ,5478,227,2019,62585118,5705,0.01,143
377,Our strongest Solutionwear‚Ñ¢ is now available at https://t.co/Qsy51S3rtD. I‚Äôm wearing the @skims High Waisted Bonded Brief ($78) - AVAILABLE NOW as part of the exclusive Contour Bonded collection. Shop now and enjoy free domestic shipping on orders over $75 https://t.co/5bKh2nfCh8,2486,160,2019,62585118,2646,0.0,280
378,Yesssss üî•üî•üî• https://t.co/CC6hmzc6Rk,4586,263,2019,62585118,4849,0.01,35
379,I showed him this https://t.co/Tq6KFzrZFS,33567,1061,2019,62585118,34628,0.06,41
380,üòÇüòÇüòÇ https://t.co/1LcTzV2HWM,8425,663,2019,62585118,9088,0.01,27
381,SAME!!!!!! https://t.co/6Me9pZfLqV,90784,10060,2019,62585118,100844,0.16,34
382,Hahaha yesss!!! https://t.co/BbhKCUPdn6,3544,103,2019,62585118,3647,0.01,39
383,Our strongest Solutionwear‚Ñ¢ is coming soon!! The @skims Contour Bonded collection offers the highest level of support for super strength smoothing and lifting. Shop the Contour Bonded collection on October 24 at 9AM PST / 12PM EST at https://t.co/Qsy51S3rtD https://t.co/dxprDZfYSs,4990,235,2019,62585118,5225,0.01,281
384,I got amazing gifts from my whole family and Kanye for me the most amazing bags. But he also donated $1 million to my favorite charities that work so hard on prison reform on my behalf from him and the kids. This makes my heart so happy! https://t.co/chNkyPRQGW,105614,5876,2019,62585118,111490,0.18,261
385,My favorite Armenian restaurant Carousel came and catered and then was surprised with a beignet truck and churro stand! https://t.co/LPSJ1Ipk5R,10602,346,2019,62585118,10948,0.02,143
386,Thank you so much for all of the birthday love! I had the best most relaxing birthday ever! Spent the weekend w my amazing friends in Palm Springs and then had a family dinner at my house tonight thrown by my mom and Kanye. https://t.co/MRQWVjCwwc,76035,2749,2019,62585118,78784,0.13,247
387,She looks soooo good!!! https://t.co/LYyuYsXPxC,4901,196,2019,62585118,5097,0.01,47
388,Wow just WOW I love each and every one of you so much!!! https://t.co/jjNrU4TZZM,1767,113,2019,62585118,1880,0.0,80
389,‚ô•Ô∏è https://t.co/EFpOak3MT9,6244,202,2019,62585118,6446,0.01,26
390,Love you so much mom!!! https://t.co/UpJJBR6r3k,12170,339,2019,62585118,12509,0.02,47
391,Love you Alice!! https://t.co/4A1H0maM9Q,1826,73,2019,62585118,1899,0.0,40
392,Aww I love this thank you so much!!!! https://t.co/jjNrU4TZZM,1336,81,2019,62585118,1417,0.0,61
393,Celebrate my 39th Birthday with 39% off my @kkwbeauty must-haves! Ends tonight at 11:59PM PST at https://t.co/PoBZ3bhjs8 #KKWBEAUTY https://t.co/4mAJGireHH,1705,112,2019,62585118,1817,0.0,155
394,"TODAY ONLY: To celebrate my 39th Birthday, all of my essential @skims Underwire Bras are $39! Ends tonight at 11:59pm PST, no code needed. Shop now at https://t.co/Qsy51S3rtD and enjoy free domestic shipping on orders over $75. https://t.co/vJGeEliKxs",1113,62,2019,62585118,1175,0.0,251
395,Love you!!!! https://t.co/colWXUMdWp,1685,69,2019,62585118,1754,0.0,36
396,Celebrate my 39th birthday with 39% off @kkwfragrance sitewide at https://t.co/tbQezJs782! Exclusions apply. Ends tonight at 11:59PM PST #KKWFRAGRANCE https://t.co/odrS3faBmj,1356,111,2019,62585118,1467,0.0,174
397,Celebrate my 39th Birthday with 39% off my @kkwbeauty must-haves! Ends tonight at 11:59PM PST at https://t.co/PoBZ3bhjs8 #KKWBEAUTY https://t.co/ZHYpUu5Umb,1031,94,2019,62585118,1125,0.0,155
398,"TODAY ONLY: To celebrate my 39th Birthday, all of my essential @skims Underwire Bras are $39! Ends tonight at 11:59pm PST, no code needed. Shop now at https://t.co/Qsy51S3rtD and enjoy free domestic shipping on orders over $75. https://t.co/IoZxRATamj",1085,93,2019,62585118,1178,0.0,251
399,awww I love this!!! https://t.co/HLemF5dvDC,7661,596,2019,62585118,8257,0.01,43
400,thank you so much!!! https://t.co/gyyrdAQyOq,35586,1474,2019,62585118,37060,0.06,44
401,‚ô•Ô∏è https://t.co/pwtJWLpiiI,1528,56,2019,62585118,1584,0.0,26
402,‚ô•Ô∏èüò¢ https://t.co/lmazdJuoRm,2046,84,2019,62585118,2130,0.0,27
403,‚ô•Ô∏è https://t.co/nBZdkzLaQ8,980,38,2019,62585118,1018,0.0,26
404,Trips are the best memories! ‚ô•Ô∏è https://t.co/RzQW1TjwVX,852,45,2019,62585118,897,0.0,55
405,‚ô•Ô∏è‚ô•Ô∏è‚ô•Ô∏è https://t.co/ETCNDdzktO,761,56,2019,62585118,817,0.0,30
406,Should I screen grab the group chat?! She went off on us. We are driving home from Palm Springs so can‚Äôt watch it https://t.co/gVImPGmo07,1372,53,2019,62585118,1425,0.0,137
407,‚ô•Ô∏è‚ô•Ô∏è‚ô•Ô∏è https://t.co/x50BpCQtmh,621,34,2019,62585118,655,0.0,30
408,Perfection! All of my elementary school friends took time out of their busy schedules away from their kids to chill in Palm Springs and do absolutely nothing!!! Best time! https://t.co/oUwIszHMmU,3094,82,2019,62585118,3176,0.01,195
409,I love Turks &amp; Caicos!!! I‚Äôm so sad I missed this trip! I was on maternity leave and couldn‚Äôt leave my baby,5497,147,2019,62585118,5644,0.01,111
410,I loved this shoot! https://t.co/NJdCkvdCDs,715,35,2019,62585118,750,0.0,43
411,Who‚Äôs watching Keeping Up With The Kardashians? #KUWTK,3890,179,2019,62585118,4069,0.01,54
412,Last day to shop my @kkwbeauty #KKWXWINNIE Collection for 20% off at https://t.co/aIjp1MBlpZ!! What are you getting? ‚ú® https://t.co/U4th047n73,2348,108,2019,62585118,2456,0.0,142
413,Shop my @kkwbeauty #KKWXWINNIE Collection for 20% off!! Ends TONIGHT at 11:59pm pst at https://t.co/aIjp1MBlpZ https://t.co/oUhIxu17yo,1423,111,2019,62585118,1534,0.0,134
414,Today is the day!!! I‚Äôm so excited that @kkwbeauty is now available at all @ultabeauty stores! This is such a dream come true!! #kkwxultabeauty https://t.co/k1KAnsegC9,7033,410,2019,62585118,7443,0.01,167
415,I bought these when I was trying to find the perfect all Leopard Alaia look.            https://t.co/1VF6XpjNDa https://t.co/EGdEY72xwp,2175,107,2019,62585118,2282,0.0,135
416,"Thierry Mugler looks!!!

https://t.co/k2Stjhv5da https://t.co/8bVDK2H8nE",1202,76,2019,62585118,1278,0.0,74
417,Remember this iconic Celine bag?? https://t.co/EQ0iQkaDns https://t.co/Z8tfKysraW,2713,123,2019,62585118,2836,0.0,81
418,I was obsessed with this green Chanel bag! https://t.co/TcaDYxwwTJ https://t.co/JxaH7TqyKp,2639,102,2019,62585118,2741,0.0,90
419,I am selling 4 Herm√®s Birkins https://t.co/efl9hQUNG9 https://t.co/W9zu8MyHMg,1144,87,2019,62585118,1231,0.0,77
420,https://t.co/j1bjO0YKx9 https://t.co/OQuyGXnWYc,1087,65,2019,62585118,1152,0.0,47
421,https://t.co/TLw4EdH3Yl https://t.co/OiHLDtujjO,765,52,2019,62585118,817,0.0,47
422,My eBay auctions are coming to an end today!!! Don‚Äôt miss out! https://t.co/Yi1UfwA0k6,901,54,2019,62585118,955,0.0,86
423,"I‚Äôm so excited for @kkwbeauty to launch at all @ultabeauty stores tomorrow, on 10.20!!! I can‚Äôt wait for you guys to swatch and find your perfect shades in person #kkwbeauty https://t.co/WzBOyu3PeO",6399,299,2019,62585118,6698,0.01,197
424,‚ô•Ô∏è https://t.co/o5jwb00rXJ,17739,560,2019,62585118,18299,0.03,26
425,"Shop my @kkwbeauty #KKWXWINNIE Collection for 20% off!! Ends tomorrow, 10.20 at 11:59pm pst at https://t.co/aIjp1MBlpZ https://t.co/PfnWdLOHxz",2340,96,2019,62585118,2436,0.0,142
426,üôèüèº https://t.co/cz3Hy291y6,5297,449,2019,62585118,5746,0.01,26
427,"PLEASE @GovAbbott How can you execute a man when since his trial, substantial evidence that would exonerate Rodney Reed has come forward and even implicates the other person of interest. I URGE YOU TO DO THE RIGHT THING.",8751,1761,2019,62585118,10512,0.02,220
428,"After watching the movie I opened up my computer &amp; opened up my email about a case I had recently been investigating, @FreeRodneyReed. I have been hearing about him and his story for the last week. On Nov. 20, Texas will execute Rodney Reed. I believe he is innocent.",4606,753,2019,62585118,5359,0.01,271
429,"I just saw the movie Just Mercy, the film about Bryan Stevenson's book starring Jamie Foxx &amp; Michael B Jordan. wow I cried!!! I know it doesn't come out until January but you all have to see this!!! It's a true glimpse into the injustice that still happens today.",12231,618,2019,62585118,12849,0.02,267
430,üíï https://t.co/LA18G6AlcU,2375,96,2019,62585118,2471,0.0,25
431,"My @kkwbeauty Best of Nude, Pink and Red Lipstick Sets are RESTOCKED!!! Shop them at https://t.co/aIjp1MBlpZ üñ§ https://t.co/qy5fM01v9w",2009,122,2019,62585118,2131,0.0,134
432,"My @kkwbeauty #KKWXWINNIE Collection is 20% off this weekend only!! Shop it today at https://t.co/aIjp1MBlpZ ‚ú® Ends Sunday, 10.20 at 11:59pm pst https://t.co/Wy6x6FzK7H",2238,104,2019,62585118,2342,0.0,168
433,OBSESSED https://t.co/etIR7Xu5wf,11945,948,2019,62585118,12893,0.02,32
434,üòÇüòÇüòÇ https://t.co/NBecEFx8c4,467483,62879,2019,62585118,530362,0.85,27
435,"Oklahoma Pardon &amp; Parole Board

2915 N. Classen, Suite 405,
Oklahoma City, OK 73106
405-521-6600 (press 0) / 405-522-9227
Boardmembers@ppb.ok.gov
The Pardon &amp; Parole Board Members are:
C. Allen McCall, 
Larry Morris 
Adam Luck
Kelly Doyle
Robert Gilliland, J.D.",1856,319,2019,62585118,2175,0.0,280
436,"Governor Kevin Stitt
The Office of Governor Kevin Stitt
Oklahoma State Capitol 
2300 N. Lincoln Blvd., Room 212
Oklahoma City, OK 73105
405-521-2342
https://t.co/1wHtwyxO6X",1345,278,2019,62585118,1623,0.0,178
437,"I noticed lots of people are asking what they can do to help in the Julius Jones case. You can send letters to the Pardon &amp; Parole Board, and the Governor.",4466,382,2019,62585118,4848,0.01,159
438,"There is an amzing documentary that @violadavis did that featured the Julius Jones‚Äô case called The Last Defense. I believe in his innocence, let‚Äôs correct his wrongful conviction @GovStitt",2728,403,2019,62585118,3131,0.01,189
439,Yesterday Oklahoma death-row prisoner #JuliusJones asked the Pardon &amp; Parole Board for clemency.  Please help by asking the Board and @GovStitt to give careful and thoughtful consideration to his petition. @justice4julius Learn more at https://t.co/Q5IzUCghZu,1390,467,2019,62585118,1857,0.0,263
440,What an amazing launch we had yesterday with our @skims cotton collection. I know a lot is sold out but we still have some left. In this picture I‚Äôm wearing the cotton ribbed boxer and tank. I live in this! https://t.co/h087HSW2ek https://t.co/0u3VlnOALa,4225,172,2019,62585118,4397,0.01,254
441,Chicago in Armenia üá¶üá≤ ‚ú® https://t.co/M8lYThr2cC,89584,4068,2019,62585118,93652,0.15,47
442,Obsessed with these color tones. I‚Äôm wearing the color Mineral here. The fabric is really stretchy and I love wearing these tanks with jeans and sweats too! Available now at https://t.co/qc7FuvGMzo https://t.co/KOBJrnjg8f,6706,275,2019,62585118,6981,0.01,221
443,I‚Äôm wearing the @skims Cotton Rib Tank ($34) and the Cotton Rib Brief ($28) in Mineral. Shop the Cotton Collection now at https://t.co/Qsy51S3rtD and receive free domestic shipping on orders over $75! https://t.co/Z8ZETixEAl,2830,138,2019,62585118,2968,0.0,224
444,The @skims Cotton Collection is now available at https://t.co/Qsy51S3rtD. Shop now before it sells out and receive free domestic shipping on orders over $75. https://t.co/wdDtRdZmHq,2849,153,2019,62585118,3002,0.0,181
445,"I am so excited to announce that the @skims Cotton Collection is now available at https://t.co/Qsy51S3rtD! I‚Äôm wearing the Cotton T-Shirt and Cotton Rib Thermal Legging in Soot, made with ultra soft and breathable cotton. Shop the Cotton Collection now at https://t.co/Qsy51S3rtD https://t.co/CoGJb6wXqD",2718,142,2019,62585118,2860,0.0,303
446,Thank you so much! https://t.co/bZ5FHzfCQF,1640,76,2019,62585118,1716,0.0,42
447,üëèüèº @cut_50 https://t.co/t8q3flUGVv,984,57,2019,62585118,1041,0.0,34
448,üëèüèºüëèüèºüëèüèº https://t.co/n3erkcwD01,2254,83,2019,62585118,2337,0.0,30
449,The @skims Cotton Collection launches TOMORROW at 9AM PST / 12PM EST only at https://t.co/Qsy51S3rtD. Join the waitlist now to be the first to shop the Cotton Collection before it sells out. https://t.co/ByP8f97Wd3,2128,90,2019,62585118,2218,0.0,214
450,üëèüèºüëèüèºüëèüèº https://t.co/dMVcnNMiMQ,4533,217,2019,62585118,4750,0.01,30
451,Visiting the Armenian Genocide Museum was extremely emotional. I can‚Äôt believe with all of the photos from the massacres and published literature during this time that people still try to deny this ever happened. We will never forget that 1.5 million Armenians were murdered. üá¶üá≤ https://t.co/DqRFuCTL6A,8437,683,2019,62585118,9120,0.01,302
452,Visiting the Armenian Genocide Museum was extremely emotional. I can‚Äôt believe with all of the photos from the massacres and published literature during this time that people still try to deny this ever happened. We will never forget that 1.5 million Armenians were murdered. üá¶üá≤ https://t.co/zrA0kvTvGH,17635,1312,2019,62585118,18947,0.03,302
453,"My new @kkwbeauty Holiday 2019 Lip Trio!! Featuring Nude 3 Cr√®me Lipstick, 90‚Äôs Style Matte Lipstick and Ultralight Beams Gloss in Rose Gold. Coming exclusively to @ultabeauty stores on October 20th #KKWBEAUTY https://t.co/aBImzlz5rM",1412,94,2019,62585118,1506,0.0,233
454,"Mercedes wears the @skims Cotton Plunge Bralette ($36) and the Cotton Rib Boxer ($32) in Mineral, part of the exclusive Cotton Collection launching TOMORROW at 9AM PST / 12PM EST. Join the waitlist now at https://t.co/Qsy51S3rtD to be the first to shop. https://t.co/AqNSUSSHB5",2166,85,2019,62585118,2251,0.0,277
455,My new @kkwbeauty limited edition Cr√®me Lipstick &amp; Highlight Set!!Available exclusively at all @ultabeauty stores on October 20 #KKWBEAUTY https://t.co/8SrgbtXOfO,1448,82,2019,62585118,1530,0.0,166
456,Damn Lakeisha!!!!! Tasha did you wrong. I really feel for Tommy üíî @lala I love you!!!!,12814,1452,2019,62585118,14266,0.02,86
457,My first tweet lol #TrueHollywoodStory https://t.co/uySqSCS55Q,17526,777,2019,62585118,18303,0.03,62
458,I remember the day I signed up for Twitter! So crazy looking back. #TrueHollywoodStory https://t.co/u7gygXIp8E,928,65,2019,62585118,993,0.0,110
459,"No greater motivation than someone telling you you can‚Äôt achieve something. Never let anyone tell you who you are, and what you are capable of. #TrueHollywoodStory https://t.co/tul52Awk5p",4942,629,2019,62585118,5571,0.01,187
460,Yes!! #TrueHollywoodStory https://t.co/2dz3hKZi8D,838,38,2019,62585118,876,0.0,49
461,Starts in 5 mins! Right after Keeping Up! https://t.co/NkD7IpLaGs,1122,79,2019,62585118,1201,0.0,65
462,I love sharing everything from behind the scenes with you guys. So much work and preparation goes into these moments! #KUWTK https://t.co/EWAwb6I5x4,1019,64,2019,62585118,1083,0.0,148
463,Guys stick around after Keeping Up because my episode of E! True Hollywood Story is on right after! #THS,933,73,2019,62585118,1006,0.0,104
464,The most incredible night! How amazing did my sisters look? #KUWTK https://t.co/738jJX9mrd,1096,56,2019,62585118,1152,0.0,90
465,"Lol so impossible, but worth it! #KUWTK https://t.co/kgUWrateUs",1105,54,2019,62585118,1159,0.0,63
466,"My E! True Hollywood Story, tonight at 10pm after Keeping Up! https://t.co/jeDBZc9AWJ",4185,373,2019,62585118,4558,0.01,85
467,Tonight on #KUWTK! Watch with us at 9pm and then tune in right after for my episode of E! True Hollywood Story at 10pm #THS https://t.co/C42leelOKu,2137,174,2019,62585118,2311,0.0,147
468,Need Halloween costume ideas!!!,5252,469,2019,62585118,5721,0.01,31
469,"The @skims Cotton Collection: My essential underwear and lounge pieces made from ultra soft and breathable cotton, launching this Tuesday October 15 at 9AM PST / 12PM EST. Join the waitlist now to be the first to shop the Cotton Collection before it sells out. https://t.co/tsev4jVMRr",1395,95,2019,62585118,1490,0.0,284
470,"Made for lounging, I‚Äôm at home wearing the @skims Cotton Rib Tank ($34) and the Cotton Rib Boxer ($32) in Bone. Shop the Cotton Collection this Tuesday October 15 at 9AM PST / 12PM EST and join the waitlist now to be notified when it drops. https://t.co/oP80luWLD8",1126,69,2019,62585118,1195,0.0,264
471,Met Gala moments! Tonight on Keeping Up! 9/8c on E! @KUWTK https://t.co/Uo93CpyL7E,8616,408,2019,62585118,9024,0.01,82
472,"So excited for the @skims most comfy cotton collection to launch this Tuesday. I‚Äôm wearing the @skims Cotton Underwire Bra ($48) in kyanite, coming in 31 band &amp; cup sizes. Shop the Cotton Collection on October 15 at 9AM PST / 12PM EST https://t.co/Qsy51S3rtD https://t.co/kS9zaUPCbk",5689,245,2019,62585118,5934,0.01,286
473,"Mercedes wears the @skims Cotton Plunge Bralette ($36) in Kyanite, coming soon in sizes XXS - 4X. Shop the Cotton Collection on October 15 at 9AM PST / 12PM EST and join the waitlist now to be notified when it drops. https://t.co/ACYuKeEQfq",1524,64,2019,62585118,1588,0.0,240
474,‚ô•Ô∏è https://t.co/lRH45f2vf1,3727,161,2019,62585118,3888,0.01,26
475,Today was so good! üôèüèºüôèüèºüôèüèº https://t.co/H9HWKNvGHe,2485,129,2019,62585118,2614,0.0,49
476,Yes @TheRealHalim this is so powerful! https://t.co/7rjnlgzf8h,1262,91,2019,62585118,1353,0.0,62
477,"Ashourina wears the @skims Cotton Underwire Bra ($48) in Soot, coming soon in 31 band and cup sizes. Shop the Cotton Collection on October 15 at 9AM PST / 12PM EST and join the waitlist now at https://t.co/Qsy51S3rtD to be the first to shop. https://t.co/Q680l9pubj",1001,54,2019,62585118,1055,0.0,265
478,"Haley wears the @skims Cotton Triangle Bralette ($32) in Mineral, coming soon in sizes XXS - 4X. Shop the Cotton Collection on October 15 at 9AM PST / 12PM EST and join the waitlist now at https://t.co/Qsy51S3rtD to be the first to shop. https://t.co/xxuq0lf10H",982,49,2019,62585118,1031,0.0,261
479,üôèüèº https://t.co/2zn2bvSohH,5880,198,2019,62585118,6078,0.01,26
480,DC Howard University ready #SundayService https://t.co/xuEZBZpca1,78036,6513,2019,62585118,84549,0.14,65
481,üíö‚ù§Ô∏è https://t.co/w5gXjseEdb,158806,8450,2019,62585118,167256,0.27,27
482,I hate red velvet https://t.co/RrGGkgjtIp,37779,5826,2019,62585118,43605,0.07,41
483,Hmmmm can‚Äôt forget about my Haagen Dazs https://t.co/soEUFSXBH8,1627,67,2019,62585118,1694,0.0,63
484,üá¶üá≤ https://t.co/U9E10i0ok9,8795,431,2019,62585118,9226,0.01,26
485,My baby!!! https://t.co/qmeeN8SUeW,4622,130,2019,62585118,4752,0.01,34
486,üíã https://t.co/ITy5RPYU4O,2744,91,2019,62585118,2835,0.0,25
487,Skinny Cow ice cream sandwiches in the regular vanilla are so bomb OMG! Those could be my fave. And feel healthy,3948,155,2019,62585118,4103,0.01,112
488,What‚Äôs your favorite ice cream?,18733,667,2019,62585118,19400,0.03,31
489,So you know Oreos are my favorite thing ever and Oreo shakes. Well Breyers just came out w Oreo ice cream w chocolate chip cookies üç™ in it and OMG It‚Äôs probably my favorite ice cream ever. #NotAnAd just real life. Huge chunks or Oreos and Choc Chip Cookies,9890,338,2019,62585118,10228,0.02,256
490,"The @skims Cotton Rib Brief ($28) in Kyanite, coming soon in sizes XXS - 4X. Shop the Cotton Collection October 15 at 9AM PST / 12PM EST and join the waitlist now to be the first to shop before they sell out.
Photo: #VanessaBeecroft https://t.co/d74wVkqWJN",1151,63,2019,62585118,1214,0.0,257
491,"Breathable and comfortable, the @skims Cotton Collection is your new essential for underwear and lounge. Shop the Cotton Collection October 15 at 9AM PST / 12PM EST and join the waitlist now to shop before it sells out.
Photo: #VanessaBeecroft https://t.co/xzONlpBsol",1331,68,2019,62585118,1399,0.0,268
492,"Arame wears the @skims Plunge Bralette ($36) and the Cotton Rib Brief ($28) in Kyanite, coming soon in sizes XXS - 4X. Shop the Cotton Collection on October 15 at 9AM PST / 12PM EST and join the waitlist now to be notified when it drops.
Photo: #VanessaBeecroft https://t.co/rFKXrBQ5TS",1386,67,2019,62585118,1453,0.0,286
493,üôèüèºüïØ https://t.co/N4eNrIKX0j,131480,8283,2019,62585118,139763,0.22,27
494,"Your new essentials - the @skims Cotton Collection, launching October 15 at 9AM PST / 12PM EST. I‚Äôm wearing the Cotton Underwire Bra ($48) and the String Thong ($20) in Bone while at home, available in sizes XXS - 4X. Join the waitlist now at https://t.co/Qsy51S3rtD https://t.co/cukJxMryxp",3939,203,2019,62585118,4142,0.01,290
495,"Thank you Armenia for such a memorable trip. So blessed to have been baptized along with my babies at Mother See of Holy Etchmiadzin, Armenia's main cathedral which is sometimes referred to as the Vatican of the Armenian Apostolic Church. This church was built in 303 AD. https://t.co/bUrzHfyh3p",91942,5620,2019,62585118,97562,0.16,295
496,"I‚Äôm wearing the @skims Cotton Rib Tank ($34) and the Cotton Rib Brief ($28) in Mineral, part of the exclusive Cotton Collection dropping October 15 at 9AM PST. Join the waitlist now at https://t.co/Qsy51S3rtD to be the first to shop the Cotton Collection before it sells out. https://t.co/QgeBHB2U6Y",3341,148,2019,62585118,3489,0.01,299
497,Go to my IG stories now to see all of the styles and colors,3294,123,2019,62585118,3417,0.01,59
498,INTRODUCING THE SKIMS COTTON COLLECTION - LAUNCHING OCT 15 AT 9AM PST /12PM EST. My essential underwear and lounge pieces made from ultra soft cotton are coming soon!Join the waitlist now at https://t.co/Qsy51S3rtD to be the first to shop the Cotton collection before it sells out https://t.co/XHuUDb2gqH,3429,200,2019,62585118,3629,0.01,304
499,"The @skims Solution Short no. 1 ($42) - available now in select sizes in Clay, Sienna, Umber, Onyx at https://t.co/Qsy51S3rtD. Shop now before they sell out and receive free shipping on all domestic orders over $75. https://t.co/rP4GHWmpHb",1430,66,2019,62585118,1496,0.0,239
500,The @skims Solution Short no. 2 ($42) - available now in all sizes and in all colors at https://t.co/Qsy51S3rtD. Shop now while they are still available and enjoy free shipping on all domestic orders over $75. https://t.co/xUUtC11D1I,1202,58,2019,62585118,1260,0.0,233
501,Absolutely!!!! ‚ô•Ô∏èüá¶üá≤üíã https://t.co/BoGAEtMqZ2,31193,978,2019,62585118,32171,0.05,44
502,"The @skims Core Control Thong ($24) - available now in select sizes in Clay, Sienna, Umber, and Onyx at https://t.co/Qsy51Sl2Sd. Shop now before they sell out and receive free shipping on all domestic orders over $75. https://t.co/3EGE2HgQvE",1394,69,2019,62585118,1463,0.0,241
503,‚ù§Ô∏è thank you https://t.co/KynixkO4A9,4490,430,2019,62585118,4920,0.01,36
504,Vote for #KUWTK to win the @peopleschoice award for #TheRealityShow!! RT this tweet or go to https://t.co/WVDCgvcRDq to cast your votes! Thank you guys ‚ù§Ô∏è,1680,306,2019,62585118,1986,0.0,154
505,‚ô•Ô∏èüá¶üá≤üíã https://t.co/4HXGtcGiEM,117370,4549,2019,62585118,121919,0.19,29
506,"We still have a variety of @skims sizes and styles still available in Clay, Sienna, Umber, and Onyx at https://t.co/Qsy51S3rtD! Hurry and shop your favorites before they sell out and enjoy free shipping on all domestic orders over $75. https://t.co/QPDvH5iUtR",1783,72,2019,62585118,1855,0.0,259
507,"We just restocked @skims Solutionwear‚Ñ¢ in select styles and sizes in CLAY, SIENNA, UMBER, AND ONYX colors. Shop now at https://t.co/Qsy51S3rtD before they sell out and enjoy free domestic shipping on orders over $75. https://t.co/VUcDm4V6sE",2433,126,2019,62585118,2559,0.0,240
508,I‚Äôm so excited to launch @kkwbeauty in @ultabeauty on October 20!! I can‚Äôt wait to make KKW Beauty more accessible and available for you guys to swatch and find your perfect shades in person. #kkwbeauty https://t.co/CAtG3I6I7h,6039,320,2019,62585118,6359,0.01,226
509,I absolutely LOVE this https://t.co/sBd87Iuc6C,6238,210,2019,62585118,6448,0.01,46
510,Awwww thanks Leslie!!!! https://t.co/WstuNzDUvN,2073,79,2019,62585118,2152,0.0,47
511,I can‚Äôt wait for people to hear his story. I‚Äôm so happy he‚Äôs home üôèüèº https://t.co/kF2i6Bc8L4,3052,189,2019,62585118,3241,0.01,92
512,So breathable! That was my goal https://t.co/80FoZoMzfk,1473,55,2019,62585118,1528,0.0,55
513,‚ô•Ô∏è https://t.co/cuZnzgZcwi,964,37,2019,62585118,1001,0.0,26
514,"The Sculpting Short Above the Knee ($36) in Onyx. Shop @skims Solutionwear‚Ñ¢ TOMORROW in CLAY, SIENNA, UMBER, and ONYX colors only. Join the mailing list now at https://t.co/Qsy51S3rtD to be the first to be notified. https://t.co/DyW0K1312A",1027,57,2019,62585118,1084,0.0,239
515,"Brittney Valles of Guerrilla Tacos wears the Sculpting Bodysuit Mid Thigh ($68) in Umber. Shop @skims Solutionwear‚Ñ¢ in CLAY, SIENNA, UMBER, and ONYX colors TOMORROW only at https://t.co/Qsy51S3rtD. #ShowYourSKIMS https://t.co/UAZjXy1vKp",1466,72,2019,62585118,1538,0.0,236
516,Watch the full episode of my E! True Hollywood Story now before it airs this Sunday! https://t.co/MPxj91xfoO https://t.co/x9AoZOsodO,5313,420,2019,62585118,5733,0.01,132
517,"Tatiana wears the @skims Sculpting Bra ($32) in XXS/XS in Clay. Shop the Sculpting Bra in CLAY, SIENNA, UMBER, and ONYX colors OCTOBER 8 only at https://t.co/Qsy51S3rtD https://t.co/rHKhpdRzjV",1265,66,2019,62585118,1331,0.0,192
518,North really outed me üòÇ Tonight on #KUWTK @KUWTK @itsjojosiwa https://t.co/y1cFRqSRv7,64514,4527,2019,62585118,69041,0.11,85
519,Almost 3 am in Armenia üá¶üá≤ and I can‚Äôt sleep I‚Äôm so excited to be here and see everyone!,18569,697,2019,62585118,19266,0.03,87
520,Wow OMG https://t.co/grHDnRXAXx,4951,166,2019,62585118,5117,0.01,31
521,"My collab with @kyliejenner for #KKWFRAGRANCE arrives in store at @ultabeauty everywhere TODAY! These colorful lip-shaped fragrances offers notes of red gardenia, italian bergamot and vibrant amber. Reply to let us know which scent is your favorite! üíã https://t.co/lZptm7MNxE",3522,175,2019,62585118,3697,0.01,275
522,Wow! üôèüèº https://t.co/MtdvhJw4jv,9867,607,2019,62585118,10474,0.02,31
523,Squad https://t.co/UKfBUgBmEx,148655,7034,2019,62585118,155689,0.25,29
524,üôèüèºüôèüèºüôèüèº https://t.co/6gzZ3zGi3w,37005,2453,2019,62585118,39458,0.06,30
525,You guys notice everything!!! https://t.co/kaEDzUFVUc,371819,28560,2019,62585118,400379,0.64,53
526,‚ô•Ô∏è‚ô•Ô∏è‚ô•Ô∏è‚ô•Ô∏è https://t.co/qp7aWekErq,119501,8012,2019,62585118,127513,0.2,32
527,My baby Psalm is getting so big. He started off looking like Chicago but now looks like saints twin! https://t.co/pdlUxbaHX8,154925,7455,2019,62585118,162380,0.26,124
528,I‚Äôm excited to announce that you can  experience my newest fragrance Kylie Jenner x KKW Fragrances in person at @ultabeauty October 6th! Head into your nearest store this Sunday to try it! https://t.co/3wyhNQFQQm,3772,175,2019,62585118,3947,0.01,212
529,Kardashian Kloset launches at 9am PST today! Shop items from our closets at https://t.co/DzqVknpCxZ https://t.co/JkOga1Iarv,3296,168,2019,62585118,3464,0.01,123
530,Happy Birthday @colinags I hope today was a special one! ‚ú®,2717,84,2019,62585118,2801,0.0,58
531,üñ§ wearing @kkwbeauty x Winnie gloss in Aura over Classic Icon Lip Liner https://t.co/gLra37dIvJ https://t.co/9RVeK1jNX0,10644,451,2019,62585118,11095,0.02,119
532,‚ô•Ô∏è https://t.co/MSy0Yz6zOE,2520,72,2019,62585118,2592,0.0,26
533,ü§¶üèª‚Äç‚ôÄÔ∏è https://t.co/zsO4o6UD1f,222427,21869,2019,62585118,244296,0.39,29
534,The T-Shirt Bra: extra comfort and support with lightly molded cups that enhance your natural shape - this is your new everyday essential. Available in 9 colors and 28 band and cups sizes.¬†¬†Shop now at https://t.co/Qsy51S3rtD and enjoy free shipping on domestic orders over $75. https://t.co/eGGjmoQS7K,1361,71,2019,62585118,1432,0.0,302
535,‚úåüèº https://t.co/HjNNMvEJe5,58773,2278,2019,62585118,61051,0.1,26
536,Please @GovEvers Read this letter https://t.co/iiYVRlSfLK,6084,1055,2019,62585118,7139,0.01,57
537,"Tune in to a brand new episode of @wrongfulconviction SPECIAL EDITION: Un-making a Murderer first &amp; only interview with Brendan Dassey &amp; Laura Nirider  https://t.co/81rWnHUc51
.
.
#truecrime #wrongfulconviction #wrongfulconvictionpodcast
#makingamurderer #BringBrendanHome https://t.co/V0wSngQU3e",1947,291,2019,62585118,2238,0.0,308
538,Receive @kkwbeauty #KKWXARGENIS as a free gift with purchase for the entire month of October while supplies last! Ends on 10.31 at 11:59PM PST at https://t.co/PoBZ3bhjs8 #KKWBEAUTY https://t.co/zlpxjYIHFP,1471,78,2019,62585118,1549,0.0,204
539,CR FASHION BOOK https://t.co/n6oS5CpE5a,12369,776,2019,62585118,13145,0.02,39
540,üì∏ Heji Shin https://t.co/zwKIs9cKy7,41829,2238,2019,62585118,44067,0.07,35
541,"#CR15 Casual trip to 7/11 wearing @skims black sculpting short &amp; sculpting brief on top for @crfashionbook 
@carineroitfeld
Photographer: @hejishin 
Stylist: @ronnie_hart 
Nails: @modernpampersalon Make Up: @maryphillips  Hair: @chrisappleton1 https://t.co/2D0N2InOtx",3241,197,2019,62585118,3438,0.01,275
542,Fits Everyone Collection https://t.co/h087HSW2ek üì∏ Vanessa Beecroft for @skims https://t.co/6dAteJVGEE,5202,304,2019,62585118,5506,0.01,102
543,Enjoy 20% off @KKWFRAGRANCE Vibes the entire month of October for my scent of the month! Ends on 10.31 at 11:59PM PST at https://t.co/tbQezJs782 #KKWFRAGRANCE https://t.co/Sljdps5kGE,869,68,2019,62585118,937,0.0,182
544,Happy Birthday to the most loyal person I know @MakeupByMario I love you for life!!!! https://t.co/rjuVepoKbr,61326,1795,2019,62585118,63121,0.1,109
545,"If you‚Äôre interested in any @skims items that are unavailable, make sure to sign up for the waitlist on our site for the item and also for the mailing list. This morning our subscribers had the opportunity to shop the waist trainer before our publicized launch time! üòâ",3528,125,2019,62585118,3653,0.01,268
546,Wow! We sold out completely of all our waist trainers! Thank you to everyone who ordered today. Pls tag me and the @skims team when you get your items and we will repost all of our favorite pics. üíï,3153,106,2019,62585118,3259,0.01,197
547,"Shalon wears a size 2X in the Waist Trainer ($68) available NOW in sizes XXS, XL, 2X, 3X, and 4X. Shop now at https://t.co/Qsy51S3rtD and receive free shipping on domestic orders over $75. https://t.co/XEdkLbEu2S",1598,76,2019,62585118,1674,0.0,212
548,"The @skims Waist a Trainer trainer is here!!!! Designed with ultra-thin, high-tech neoprene, the @SKIMS Waist Trainer ($68) is soft to the touch and undetectable under just about everything. Available now in sizes XXS ‚Äì 4X https://t.co/Qsy51S3rtD https://t.co/JPDnIs3ONx",3134,183,2019,62585118,3317,0.01,270
549,Wow! You guys are amazing!!! We are now sold out of sizes X-Small - Medium in our @skims waist trainer but still have limited inventory of remaining sizes! https://t.co/opmhteOOdb,935,54,2019,62585118,989,0.0,179
550,We are now sold out of size XS and S in the @skims waist trainers but still have limited inventory left of our other sizes. Shop now and get free domestic shipping on orders $75+ https://t.co/opmhteOOdb,826,46,2019,62585118,872,0.0,202
551,We are now sold out of small in our @skims waist trainer but still have some limited inventory left of all of our other sizes! https://t.co/qc7FuvGMzo,1207,67,2019,62585118,1274,0.0,150
552,free domestic shipping on orders over $75. Waist trainers available now https://t.co/h087HSW2ek https://t.co/nUnoXydF31,1471,78,2019,62585118,1549,0.0,119
553,LOL @MakeupByMario for @skims https://t.co/LzUdwXaWb7,2817,92,2019,62585118,2909,0.0,53
554,My new go to‚Äôs are the @LemkeUs Indra sunglasses. #CarolinaLemkePartner üï∂ Shoo now at https://t.co/USBcysK4Gw https://t.co/KWZjJet7Y3,8414,338,2019,62585118,8752,0.01,133
555,Tomorrow at 9am PST / 12pm EST! ‚è∞ https://t.co/AfYgIPpLbR,2958,116,2019,62585118,3074,0.0,57
556,She loves the planet so much and everywhere she goes she picks up trash  ‚ôªÔ∏è https://t.co/6Ty1OZtY5y,299838,25596,2019,62585118,325434,0.52,99
557,‚ô•Ô∏è https://t.co/Rb1zIReUHM,12706,356,2019,62585118,13062,0.02,26
558,SKIMS Waist Trainer ($68). Launching MONDAY SEPTEMBER 30 at 9AM PST / 12PM EST in sizes XXS ‚Äì 4X. Sign up to be notified at https://t.co/qc7FuvGMzo Photo: #VanessaBeecroft https://t.co/ObrDuHIcAS,1723,94,2019,62585118,1817,0.0,195
559,‚ú® https://t.co/6jCD4h7jMm,41547,1177,2019,62585118,42724,0.07,25
560,My Northie last night ‚ú® https://t.co/dNI4L4q4Ry,115066,4071,2019,62585118,119137,0.19,47
561,We are now completely sold out of all @KKWFRAGRANCE candles! Thank you so much to everyone who ordered today. I can‚Äôt wait for everyone to receive their orders!!! They smell AMAZING!!! üíï,3293,135,2019,62585118,3428,0.01,186
562,We are SOLD OUT of @KKWFRAGRANCE Crystal Gardenia candle + fragrance bundles but still have a just few single candles left in stock! https://t.co/eAGj098U38,1096,87,2019,62585118,1183,0.0,156
563,Pls tell me what you think when it arrives! üíã https://t.co/C65smKxHdD,1823,61,2019,62585118,1884,0.0,69
564,So excited for you! You're going to love them both! üòò https://t.co/XrhhycOAGp,2112,78,2019,62585118,2190,0.0,77
565,Have faith... https://t.co/2HF4HiPQoq,84224,15747,2019,62585118,99971,0.16,37
566,You have to tell me what you think when they arrive! https://t.co/OLeFJ0AdTm,1013,52,2019,62585118,1065,0.0,76
567,Yes you do! LOL https://t.co/wSe26591BN,922,38,2019,62585118,960,0.0,39
568,Please tell me what you think when you burn them! https://t.co/6b2Tz2m1Wu,1708,64,2019,62585118,1772,0.0,73
569,You're going to love them!!! https://t.co/s3LSE2y9DT,796,41,2019,62585118,837,0.0,52
570,"My @kkwfragrance candle just dropped!!! This candle is inspired by one of my favorite scents, Crystal Gardenia. I love how this scent illuminates the room &amp; makes me feel so calm. Shop the candle individually or in a bundle w/the matching fragrance now at https://t.co/eAGj098U38 https://t.co/7LmDNHwuyX",2015,138,2019,62585118,2153,0.0,307
571,Thank you! I‚Äôve been working extremely hard on this matter and hope my trip to Armenia will bring some amazing news because I have big plans! https://t.co/AzenjWU9Zx,3642,308,2019,62585118,3950,0.01,165
572,"I am a strong believer that in order for change to happen, you must be willing to work with all people, even when you have differences in political opinions. @ANCA_DC",5149,415,2019,62585118,5564,0.01,166
573,I will be visiting Armenia in the next 2 weeks and hope to seek ways I can help increase trade and hopefully create jobs for Armenians which includes @skims production there in the future. @ANCA_DC,3988,494,2019,62585118,4482,0.01,197
574,"As a brand, we believe in embracing all people and as an individual I have been working towards broader goals in hopes of bringing forward the recognition of the Armenian genocide which I remain very passionate about. @ANCA_DC",1717,148,2019,62585118,1865,0.0,226
575,"We consulted with experts and searched globally for the best in class options, some which was found in Turkey. We believe strongly against discrimination of any kind; against anyone or any nation based on the past. @ANCA_DC",1381,103,2019,62585118,1484,0.0,223
576,"Thank you @anca_dc for your concerns &amp; support. When I first began dreaming of owning my own shapewear company, I knew I wanted every piece to be made the best way possible; from the finest materials; starting from design stage through to creation, testing, innovation &amp; fit. https://t.co/Xzbzncnolh",1057,102,2019,62585118,1159,0.0,307
577,Listen to the @foodgod‚Äôs podcast yet?! You might learn something about me that no one knows LOL https://t.co/1NjeuIb66c,853,68,2019,62585118,921,0.0,119
578,I‚Äôm obsessed with the @skims Fits Everyone collection of basic bras and underwear in the best shades of so many nudes and black and in the most buttery soft stretchy fabric you‚Äôve ever felt! I‚Äôve never felt anything like this fabric. All available now at https://t.co/Qsy51S3rtD https://t.co/xUzIivpmZa,3713,201,2019,62585118,3914,0.01,302
579,OMG this is so me RN!!!!! üòÇüòÇüòÇ https://t.co/QURYdCh2Cv,120456,11322,2019,62585118,131778,0.21,53
580,Mean Tweets üòÇ @jimmykimmel https://t.co/ntZVrmbrcX,1319,104,2019,62585118,1423,0.0,50
581,The SKIMS Waist Trainer - @kimkardashian‚Äôs tried and tested solution to sculpting your midsection is launching SEPTEMBER 30 at 9AM PST / 12PM EST in sizes XXS ‚Äì 4X. Sign up for emails at https://t.co/Qsy51S3rtD to be notified as soon as it drops. https://t.co/59VZYhY5FZ,2134,145,2019,62585118,2279,0.0,270
582,So excited about this!!!! @skims waist trainer. https://t.co/sq1zKOjCUX,10676,632,2019,62585118,11308,0.02,71
583,. @skims https://t.co/zwYZp6Pjyo,2161,81,2019,62585118,2242,0.0,32
584,New shoot coming soon üñ§ https://t.co/5EHaPaZIr7,80585,6133,2019,62585118,86718,0.14,47
585,Thank you for this @Forbes https://t.co/nLgkqtMSeg,2651,181,2019,62585118,2832,0.0,50
586,And good Pinterest or IG accounts I can look at? #Playhouse #Treehouse,2243,144,2019,62585118,2387,0.0,70
587,I can‚Äôt sleep and up looking for play house and tree house inspo. Anyone know who makes the best custom play houses and tree houses???,11509,284,2019,62585118,11793,0.02,134
588,I hope everyone has a good night üåô ‚ú®,18033,1103,2019,62585118,19136,0.03,36
589,The simple life...I was 18 here. Khloe and I would drive to Arizona to visit Allison &amp; Kourt. https://t.co/uM2Pid56jA,109005,5254,2019,62585118,114259,0.18,121
590,üêæ https://t.co/a9Ew4OMROM,58696,3445,2019,62585118,62141,0.1,25
591,Jesus Is King ‚ú®üôèüèº,165717,33172,2019,62585118,198889,0.32,17
592,‚ô•Ô∏èüåπ‚ô•Ô∏èüåπ https://t.co/OtzXwZWIaz,126988,10984,2019,62585118,137972,0.22,30
593,A little bts tonight https://t.co/f6YMd8uErD,26777,1551,2019,62585118,28328,0.05,44
594,Btw NDA‚ÄôS for all!!!! #KUWTK,1766,94,2019,62585118,1860,0.0,28
595,They didn‚Äôt have to prank me like that!!!! That was mean to make me cry like this!!!! #KUWTK,2522,93,2019,62585118,2615,0.0,92
596,My security might be over the top but I love it that way #KUWTK,4342,142,2019,62585118,4484,0.01,63
597,Just catching #KUWTK wowwwww I turned it on at an intense moment: this dinner was wild.,2314,89,2019,62585118,2403,0.0,87
598,This isn‚Äôt me. https://t.co/SZ1HhP3FG5,4377,339,2019,62585118,4716,0.01,38
599,I Tried SKIMS | Kim Kardashian Shapewear https://t.co/BtVvtwn4uR via @YouTube,1162,66,2019,62585118,1228,0.0,77
600,ü•∞ü•∞ü•∞ https://t.co/l6y2GYO1dV,10812,414,2019,62585118,11226,0.02,27
601,I‚Äôve worn white every time I‚Äôve been to The Emmy‚Äôs. I‚Äôm breaking tradition this time... maybe I show you my @skims and you can guess my vibe,3334,107,2019,62585118,3441,0.01,140
602,I‚Äôve been to the Emmy‚Äôs twice. But this year I am presenting! https://t.co/dUCKf0kxUC,7381,273,2019,62585118,7654,0.01,85
603,Who remembers that time I sang at The Emmy‚Äôs üòÇüòÇüòÇ https://t.co/MqA83uJXy6,16542,887,2019,62585118,17429,0.03,72
604,Throwback to that time @kourtneykardash and I went to the Emmy‚Äôs. She was so pregnant &amp; we got ready in her kitchen. I fought with @MakeupByMario over this blue eye but loved it afterwards! https://t.co/gAYyS7asCz,5097,191,2019,62585118,5288,0.01,217
605,I actually don‚Äôt even know what to say to this. This is wrong on every level. https://t.co/Qlq5OSxBSo,111650,17266,2019,62585118,128916,0.21,101
606,Why do I not even remember this??? https://t.co/NnGLOS76DY,44923,2546,2019,62585118,47469,0.08,58
607,I‚Äôm so sad I‚Äôm not there!!! https://t.co/f4gMlpaLSO,2509,129,2019,62585118,2638,0.0,51
608,‚ô•Ô∏èüíã‚ô•Ô∏èüíã https://t.co/Puav04kzir,3429,97,2019,62585118,3526,0.01,30
609,I like really strong scented candles that fill up my room with the best aroma so I know you guys are gonna love these candles https://t.co/u4FXRcdTH7,6148,287,2019,62585118,6435,0.01,149
610,üòÇüòÇüòÇü•∞ https://t.co/hu1p8eicYQ,44351,2741,2019,62585118,47092,0.08,28
611,üò• https://t.co/05eoDKo9Mf,8340,967,2019,62585118,9307,0.01,25
612,Khloe has that exact tattoo ‚ú® https://t.co/wnB67u44tL,30624,678,2019,62585118,31302,0.05,53
613,Or do you have any new names?,9298,279,2019,62585118,9577,0.02,29
614,What should we name our new Pomeranian puppies? We already have Sushi and for sure we like the name Sak√©. So should we name the other one Soba (Noodle) or Soy Sauce (Soy for short),1843,161,2019,62585118,2004,0.0,180
615,Meet our new babies! We just need names! North came up with names that go with our other Pomeranian Sushi. She wants white baby girl to be named Sak√© and the black baby boy either Soba (Noodle) or Soy Sauce. Please comment below any ideas you have!!!! https://t.co/yhSTesjtst,83877,3780,2019,62585118,87657,0.14,275
616,üñ§ https://t.co/dcTsqYf0x5,19348,1078,2019,62585118,20426,0.03,25
617,Yesssss üíãüíãüíã https://t.co/xlvglmRpFH,3905,194,2019,62585118,4099,0.01,35
618,https://t.co/zNGGsj1f0F,4810,262,2019,62585118,5072,0.01,23
619,Read about my psoriasis &amp; psoriatic arthritis journey on Poosh now https://t.co/HDfX35wPuP https://t.co/FH6sLR5pOv,10743,708,2019,62585118,11451,0.02,118
620,https://t.co/pcKuncDq5W,3639,489,2019,62585118,4128,0.01,23
621,The @foodgod podcast is here!!! https://t.co/TKITVpH9ZH https://t.co/FqDjd0ly6E,1966,108,2019,62585118,2074,0.0,79
622,üòÇ https://t.co/IGam36Ylp1,78713,7589,2019,62585118,86302,0.14,25
623,Wow I love this!!! https://t.co/KSrolZtyXq,3843,148,2019,62585118,3991,0.01,42
624,I love you too https://t.co/CrPAOwiB1B,6074,226,2019,62585118,6300,0.01,38
625,Our @skims one leg solution short is available now at https://t.co/qc7FuvGMzo. This is perfect when you have a dress or skirt with a high slit and still need the comfort and snatchness (LOL) of shapewear like me! https://t.co/MBfDoQ1pFC,1919,108,2019,62585118,2027,0.0,236
626,I know we are sold out of almost all @skims solutionwear but we have the most amazing bras and underwear available at https://t.co/qc7FuvGMzo. I wish I could describe this fabric because it‚Äôs like butter! We will also be restocking everything soon! üì∑ Vanessa Beecroft https://t.co/XkFPxpRuz7,3519,157,2019,62585118,3676,0.01,291
627,üòÇ https://t.co/ouafTUbFde,57902,3907,2019,62585118,61809,0.1,25
628,I am obsessed with our @kkwbeauty Body Foundation! https://t.co/sbyklMQhdE https://t.co/njPTXD4S7U,2951,112,2019,62585118,3063,0.0,98
629,.  @kkwbeauty BODY FOUNDATION is back in stock!!! https://t.co/PoBZ3bhjs8 https://t.co/dwaLxXGkw3,4863,252,2019,62585118,5115,0.01,97
630,"I‚Äôm so excited to announce my new @KKWFRAGRANCE candle, inspired by one of my favorite scents Crystal Gardenia. I always have so many candles around my home and having a scent that illuminates the room makes me feel so good. Launching 09.27 at 12pm pst at https://t.co/eAGj08RjbA https://t.co/k3u9UelPLM",2642,170,2019,62585118,2812,0.0,303
631,Next week is the most intense https://t.co/i0ITv709Sv,11358,704,2019,62585118,12062,0.02,53
632,Epic happy birthday song by @robinthicke &amp; @Sia #KUWTK,1044,89,2019,62585118,1133,0.0,58
633,Kourt‚Äôs party was so much fun!!!,3663,120,2019,62585118,3783,0.01,32
634,We try not to dwell https://t.co/EdNguAyDVM,1086,53,2019,62585118,1139,0.0,43
635,BIG FACTS https://t.co/6qgQPHNlFt,1602,86,2019,62585118,1688,0.0,33
636,FACTS https://t.co/5EKXS30dxW,959,57,2019,62585118,1016,0.0,29
637,Kourt got so emotional with all of the Disney gifts #KUWTK,1400,63,2019,62585118,1463,0.0,58
638,Fighting is over don‚Äôt worry üòâ https://t.co/40qYBPX8Yx,762,46,2019,62585118,808,0.0,54
639,Absolutely get mad at all over again! Our family group chat is lit rn https://t.co/KM8Wysx9fc,1611,73,2019,62585118,1684,0.0,93
640,ü§¶üèª‚Äç‚ôÄÔ∏èüò± https://t.co/iKTftqr8lU,674,40,2019,62585118,714,0.0,30
641,üòÇ https://t.co/UWozvTEAKC,534,27,2019,62585118,561,0.0,25
642,Don‚Äôt get me started!!! https://t.co/XImtrNxqOm,3941,129,2019,62585118,4070,0.01,47
643,Literally the second @kourtneykardash‚Äôs Birthday was over she was a new nice woman! LOL,1858,68,2019,62585118,1926,0.0,87
644,OMG @kourtneykardash and I were going at it!!! ü§¶üèª‚Äç‚ôÄÔ∏è,2050,62,2019,62585118,2112,0.0,52
645,I love @ForeverMalika She is really the best,1189,60,2019,62585118,1249,0.0,44
646,I‚Äôm late to the #KUWTK party soooo sorry! Ugh Insont know if I can handle this episode?!?!?! Whose watching?,1767,94,2019,62585118,1861,0.0,108
647,Brand new @flipitdisick episode airs tonight at 10/9c right after the new Keeping Up! https://t.co/N81WxZVF8i,2215,96,2019,62585118,2311,0.0,109
648,Happy Birthday @itsKELSEYtho I hope you really had the best birthday!!!! ‚ô•Ô∏è‚ô•Ô∏è‚ô•Ô∏è,4493,142,2019,62585118,4635,0.01,79
649,üî•üî•üî• https://t.co/RtvfgLcHED,147,26,2019,62585118,173,0.0,27
650,I‚Äôm so happy you‚Äôre coming home! You soooo deserve this! https://t.co/uqYU8p7fau,63022,4601,2019,62585118,67623,0.11,80
651,‚ô•Ô∏è https://t.co/b148ZaoMjF,209,20,2019,62585118,229,0.0,26
652,Embraced By the Light By Betty J Eadie https://t.co/7NT82tc91x,2735,134,2019,62585118,2869,0.0,62
653,Awww thank you ‚ô•Ô∏è https://t.co/Oj8XiBUdGY,2597,92,2019,62585118,2689,0.0,41
654,OMG this next episode I can‚Äôt handle https://t.co/1agg7CZoZp,7036,302,2019,62585118,7338,0.01,60
655,My @kkwbeauty #KKWXWINNIE collab is available to shop now at https://t.co/aIjp1MBlpZ!!! ‚ú® https://t.co/0JcVxkxcQj,2372,130,2019,62585118,2502,0.0,113
656,"My @kkwbeauty Body Collection is back!!! Shop the Body Foundation, Body Brush, Liquid Shimmers and Loose Powder Shimmers at https://t.co/aIjp1MBlpZ https://t.co/zVm888dQNW",1355,75,2019,62585118,1430,0.0,171
657,My @kkwbeauty Body Collection is being RESTOCKED today at 12pm pst at https://t.co/aIjp1MBlpZ!!! ‚ú® https://t.co/DQrIF3pwKA,1731,76,2019,62585118,1807,0.0,122
658,"To the Senators I met in the Capitol - Please support #ACA6           
@SenToniAtkins
@ShannonGroveCA 
@Senator_Hurtado
@SenSusanRubio
@NancySkinnerCA
@HenrySternCA",987,69,2019,62585118,1056,0.0,170
659,"We can‚Äôt keep telling people who work, pay taxes, &amp; are just trying to raise their families that they can‚Äôt vote because they‚Äôre on parole. People who have served their time and are trying to rebuild their lives should have the opportunity to have their voices heard in elections",27700,2761,2019,62585118,30461,0.05,283
660,"We need to treat people like human beings, like people who deserve to have a voice. Please support California‚Äôs #ACA6 to restore voting rights to people on parole.",5167,497,2019,62585118,5664,0.01,163
661,"As I continue to learn about our criminal justice system, I‚Äôm shocked to see the ways we keep punishing people for past mistakes. Like California, which still takes formerly incarcerated people‚Äôs right to vote while they‚Äôre on parole. #FreeTheVote",3632,297,2019,62585118,3929,0.01,247
662,Ran into Poppa T @titojackson5  last night! I‚Äôve known him since I was 14 years old! He has a new album out! So excited https://t.co/IKoTaleAbd,7695,389,2019,62585118,8084,0.01,143
663,This person is seriously disturbed! Who smuggles Tarantulas!?!?!?!?!? https://t.co/brsP7lmAZ8,13652,1037,2019,62585547,14689,0.02,93
664,Haha! The struggle is real! Such a serious debate of I should seriously add one or not https://t.co/W3EwF8eo5B,1849,72,2019,62585547,1921,0.0,110
665,Don‚Äôt worry we won‚Äôt be sold out for long! I plan to always have it stocked! We still have so much on the site!!! https://t.co/Qsy51Sl2Sd https://t.co/63JkjgFed4,1251,78,2019,62585547,1329,0.0,161
666,üòÇüôãüèª‚Äç‚ôÄÔ∏èü§¶üèª‚Äç‚ôÄÔ∏èü§∑üèª‚Äç‚ôÄÔ∏èüòÇ https://t.co/yjXsNyU4fJ,4291,176,2019,62585547,4467,0.01,41
667,So happy @lala and I went to support our friend @serenawilliams at her fashion show this week!!!! https://t.co/UBkxPEEcAz,18622,833,2019,62585547,19455,0.03,121
668,Who‚Äôs tuning into @FallonTonight tonight?! @winnieharlow and I are wearing our new @kkwbeauty #KKWXWINNIE collab ‚ú® https://t.co/glJ6vJE6wX,13285,588,2019,62585547,13873,0.02,138
669,"Tune into @FallonTonight where I talk @skims, @kkwbeauty and my new #KKWXWINNIE collab with @winnieharlow! 
üì∏: Andrew Lipovsky/NBC https://t.co/bCASLXxK27",5078,306,2019,62585547,5384,0.01,155
670,".@skims underwear, available NOW at¬†https://t.co/Qsy51S3rtD¬†in 9 colors to compliment every body and in sizes XXS-4X with 28 cup sizes to choose from. Designed with seamless, soft fabric that molds to your skin. Shop now and enjoy FREE SHIPPING on all domestic orders over $75. https://t.co/0nqULonTfn",3047,175,2019,62585547,3222,0.01,301
671,We will never forget. Sending light and love to everyone today ‚ú® https://t.co/RdzppIdJB4,40589,3582,2019,62585547,44171,0.07,88
672,Never forget! Sending love and light to everyone today.,17870,1885,2019,62585547,19755,0.03,55
673,Fast shipping!!! I know you will love them https://t.co/UNYLdHg8Af,2267,86,2019,62585547,2353,0.0,66
674,".@winnieharlow and I sit down with @MakeupByMario to talk about confidence, her special friendship with North and our new @kkwbeauty collab! Winnie is someone I respect and admire so much. She‚Äôs the definition of a true beauty. #KKWXWINNIE https://t.co/maS8HlU1qP",1572,102,2019,62585547,1674,0.0,263
675,"Restock alert!!! My @kkwbeauty Body Collection is coming back on Friday, 09.13 at 12pm PST at https://t.co/aIjp1MBlpZ https://t.co/Kw9FlS3aLx",1297,76,2019,62585547,1373,0.0,141
676,I cannot wait to see everyone in your @skims. Pls be sure to tag me when you receive your order and let me know what you think!!!,1977,66,2019,62585547,2043,0.0,129
677,Our teams are working overtime to get everything restocked ASAP and my goal is to get our business to a point where we can make my shapewear and essential underwear items available and accessible always.,1405,67,2019,62585547,1472,0.0,203
678,"If the @skims item you wanted is sold out, pls follow our Instagram page and visit our website to sign up for restock alerts!",1037,51,2019,62585547,1088,0.0,125
679,"For anyone that didn‚Äôt have a chance to shop yesterday, we still have some of the shapewear still in stock in colors Onyx, Umber and Oxide and many of my must have underwear and bra essentials that are perfect everyday basics.",1379,71,2019,62585547,1450,0.0,226
680,"Wow! Thank you to everyone who supported our @skims launch day yesterday, it was beyond what I could have imagined and I‚Äôm so incredibly thankful! https://t.co/g8lBqktNNA",3769,179,2019,62585547,3948,0.01,170
681,".@skims Solutionwear‚Ñ¢ in ONYX, UMBER and OXIDE colors are still available at https://t.co/Qsy51S3rtD! Hurry before your size runs out and qualify for FREE SHIPPING on orders over $75 https://t.co/XDPKJl1bTL",1790,96,2019,62585547,1886,0.0,206
682,.@skims underwear is still available in all 9 colors! Shop now before it runs out at https://t.co/Qsy51S3rtD and enjoy FREE SHIPPING on domestic orders over $75 https://t.co/D8gXhwG4ez,1623,86,2019,62585547,1709,0.0,184
683,"I‚Äôm wearing the Sculpting Bodysuit ($62 in sizes XXS-5X) in Onyx. Shop @skims Solutionwear‚Ñ¢ NOW at https://t.co/Qsy51S3rtD and enjoy FREE SHIPPING on all $75+ domestic orders
Photo: #VanessaBeecroft https://t.co/CDXPWyQuWw",2816,103,2019,62585547,2919,0.0,223
684,"If the @skims item you wanted appears as sold out, come back later today! Due to the high volume in traffic, some items were mismarked as sold out and will be available for purchase again very soon!",2852,113,2019,62585547,2965,0.0,198
685,"Shop @skims Solutionwear‚Ñ¢ NOW at https://t.co/Qsy51S3rtD.
Video: #VanessaBeecroft https://t.co/pF9X26Eh3V",2594,196,2019,62585547,2790,0.0,106
686,We want everyone to have the opportunity to purchase and have the best experience! Thank you for your understanding.,4018,133,2019,62585547,4151,0.01,116
687,Our @skims launch time has been pushed back by 1 hour and we will now go live at 10am PST.,1940,81,2019,62585547,2021,0.0,90
688,"Due to overwhelming response, the enormous traffic in the last hour has created a tech issue with @skims site for launch. Our teams are working now to resolve the issue.",2140,96,2019,62585547,2236,0.0,169
689,Less than an hour to launch! https://t.co/h087HSW2ek,2098,104,2019,62585547,2202,0.0,52
690,"I‚Äôm wearing the Sculpting Bodysuit ($62 in sizes XXS-5X) in Sand. Shop @skims in ONE HOUR at 9am PST / 12pm EST only at https://t.co/Qsy51S3rtD.
Photo: #VanessaBeecroft https://t.co/NkHmnG0WVE",2678,116,2019,62585547,2794,0.0,193
691,I‚Äôve made so many mistakes with shapewear and have had so many slip ups. Lots of my issues came from not having a wide shade range available in the past. Today we are launching @skims!!! I‚Äôm wearing the color Ochre to create my own lining in the dress! https://t.co/Qsy51S3rtD https://t.co/NLUR22cPMm,6246,384,2019,62585547,6630,0.01,300
692,But should I go even shorter? https://t.co/JbUWiS4nGU,12221,424,2019,62585547,12645,0.02,53
693,Tune into @TheTodayShow BTW Chris wants to cut my hair another inch. Should we??? https://t.co/1znHkXGSXo,7285,307,2019,62585547,7592,0.01,105
694,We launch TODAY!!! @KhloeKardashian wears the Sculpting Bodysuit ($62 in sizes XXS-5X) in Onyx. Shop SKIMS Solutionwear‚Ñ¢ NOW at https://t.co/Qsy51Sl2Sd and enjoy FREE SHIPPING on all $75+ domestic orders. https://t.co/WhRhHND9EL,4818,305,2019,62585547,5123,0.01,228
695,I‚Äôm going to be on @TheTodayShow This morning!!! Talking all things @skims TUNE IN!,1981,118,2019,62585547,2099,0.0,83
696,https://t.co/EFfrGoY7mO,1082,66,2019,62585547,1148,0.0,23
697,The @skims Solutionwear‚Ñ¢ countdown is on! Visit https://t.co/Qsy51S3rtD now to browse the full collection before it launches tomorrow at 9am PST / 12pm EST and to join the SKIMS waitlist to be notified when the collection drops! https://t.co/wcmNgqP3zz,2451,155,2019,62585547,2606,0.0,252
698,"Before and after of @skims Solutionwear‚Ñ¢. Lift, enhance, smooth, and sculpt. Visit https://t.co/Qsy51S3rtD now to browse the full collection before it launches tomorrow at 9am PST / 12pm EST https://t.co/RwXN6SbC2D",2023,96,2019,62585547,2119,0.0,214
699,"Kendall wears the Sculpting Bra ($32 in sizes XXS-5XL) and the Solution Short ($42 in sizes XXS-5XL) in Clay.
SKIMS LAUNCHES TOMORROW AT 9AM PST / 12PM EST @KendallJenner 

Join the waitlist now at https://t.co/Qsy51S3rtD to be the first to shop SKIMS when it drops. https://t.co/a2VFZsw8IV",4580,295,2019,62585547,4875,0.01,293
700,I think this was @KylieJenner‚Äôs first time live tweeting ü•∞,6869,171,2019,62585547,7040,0.01,58
701,I‚Äôm watching!!!! https://t.co/HAljhimhQo,1198,56,2019,62585547,1254,0.0,40
702,I‚Äôm can‚Äôt handle when @khloekardashian cries! It really breaks my heart!,4666,161,2019,62585547,4827,0.01,72
703,I‚Äôm working on it . I‚Äôm really getting better. I promise. https://t.co/msrNAtmFVP,1736,100,2019,62585547,1836,0.0,81
704,üïµÔ∏è‚Äç‚ôÄÔ∏è https://t.co/3EXjchyJzT,2214,80,2019,62585547,2294,0.0,29
705,I need to stay to myself sometimes lol God I‚Äôm so nosey!!!!!,8830,991,2019,62585547,9821,0.02,60
706,I couldn‚Äôt control myself I had to give that face lol,2066,138,2019,62585547,2204,0.0,53
707,Oh god this is where I start to get nosey and need to fall back https://t.co/7nWOyaX316,1874,79,2019,62585547,1953,0.0,87
708,Omg who just saw that @Kinglimaa commercial for fashion week! Love you!!!!! I remember when you walked in the room and Carine R &amp; Kanye were there in the fitting and I was just hanging out,1086,81,2019,62585547,1167,0.0,192
709,Tristan is a really great dad ‚ú®,19385,851,2019,62585547,20236,0.03,31
710,I love our family parties. All of the kids have so much fun and we all get to spend time together. I seriously love my family,19609,688,2019,62585547,20297,0.03,125
711,Awwww I was trying to hold it in and not ruin my make up lol https://t.co/fPCg7hpOo1,1064,52,2019,62585547,1116,0.0,84
712,Thank you Ky for being there the second I called you üíã https://t.co/3NsjoK4csF,1637,65,2019,62585547,1702,0.0,78
713,She never cries #KUWTK https://t.co/DCiPUIUIzr,1472,76,2019,62585547,1548,0.0,46
714,Luckily I got an answer quickly but it was a rollercoaster of emotions #KUWTK https://t.co/KahoK82pTP,762,38,2019,62585547,800,0.0,101
715,All of these babies!!!!!,1661,87,2019,62585547,1748,0.0,24
716,üò• https://t.co/vCCyzApiJm,958,44,2019,62585547,1002,0.0,25
717,My mom coming through with the wisdom ‚ú®,2456,139,2019,62585547,2595,0.0,39
718,Goals!!! https://t.co/Wn8YOBOXgf,760,43,2019,62585547,803,0.0,32
719,Thinking about the pain in my hands and what it could be is really scary and can get you in a scary head space. I was so anxious to just figure out what was wrong #KUWTK,2115,114,2019,62585547,2229,0.0,169
720,Omg @kourtneykardash‚Äôs hair!!! I was afraid for her life.  LOL #bald,2632,160,2019,62585547,2792,0.0,68
721,Scott is so funny! Seriously,3882,236,2019,62585547,4118,0.01,28
722,At least we all have each other and have each other going through the same feelings https://t.co/pq3vD4yzf2,555,41,2019,62585547,596,0.0,107
723,‚ú® https://t.co/7mvNHKlnJB,593,41,2019,62585547,634,0.0,25
724,OMG could you imagine! I really thought I was pregnant while my surrogate was pregnant!!! But had to prank my mom regardless üòÇ,19012,384,2019,62585547,19396,0.03,126
725,KUWTK STARTS NOW!!!! OMG I have chills seeing the beginning,1902,138,2019,62585547,2040,0.0,59
726,East Coast wanna watch Keeping Up With The Kardashians now!!!,1798,127,2019,62585547,1925,0.0,61
727,. @kourtneykardash wears the Sculpting Bodysuit ($62 in sizes XXS-5XL) in Onyx. Shop SKIMS Solutionwear‚Ñ¢ September 10 at 9am PST at https://t.co/Qsy51S3rtD https://t.co/hareSqHE49,2773,206,2019,62585547,2979,0.0,179
728,https://t.co/Yu0rW16rTG,20180,834,2019,62585547,21014,0.03,23
729,BTS from my @VogueArabia shoot. https://t.co/0SK82kJg9H,19761,1235,2019,62585547,20996,0.03,55
730,Just kidding!!!!! LOL #skims https://t.co/RW0xuWG7PF,31078,2096,2019,62585547,33174,0.05,52
731,KKW X WINNINE https://t.co/c0YQi4b4bN,21171,1262,2019,62585547,22433,0.04,37
732,KKW X WINNIE https://t.co/G0G5pne0xf,5312,217,2019,62585547,5529,0.01,36
733,Stunning!!!!!!! KKW X WINNIE https://t.co/10cEWiW2pL,7227,505,2019,62585547,7732,0.01,52
734,"How gorgeous are these @kkwbeauty #KKWXWINNE Images!!! Launching Friday, 09.13 at 12pm pst at https://t.co/aIjp1MBlpZ https://t.co/CmQ7uDkgXX",1703,100,2019,62585547,1803,0.0,141
735,"Everyone is starting to get the @skims press boxes &amp; I‚Äôve never had a better response from everyone loving &amp; feeling the product. I‚Äôve been cutting, fitting &amp; sewing my own versions of what I always wanted my shape wear to be. Launching Sept 10th https://t.co/Qsy51Sl2Sd https://t.co/GFhaXdUheW",3974,216,2019,62585547,4190,0.01,306
736,"Today I‚Äôm pleased to hear @SecretaryPerry is the first DOE secretary to visit the Santa Susana Field Site, alongside CA officials. I know our community looks forward to progress on this important issue. It‚Äôs time to clean this up!",2111,208,2019,62585547,2319,0.0,230
737,My @kkwbeauty Liquid Concealers are restocked!!! All 16 shades are available to shop at https://t.co/aIjp1MBlpZ https://t.co/2vzttDzwtr,1395,66,2019,62585547,1461,0.0,135
738,Sculpting Body Suit @skims https://t.co/gR5kbAGqKo,6523,244,2019,62585547,6767,0.01,50
739,"I‚Äôm wearing the @skims Sculpting Bodysuit in shade Sienna. It gives full body support with built in compression to smooth your torso and sculpt your waist. Launching Sept 10 https://t.co/qc7FuvGMzo
- Price $62
- XXS-5XL
- 9 colors https://t.co/sUC9nTNnJl",3395,164,2019,62585547,3559,0.01,257
740,"üôèüèºüëèüèº 
#JustMercy
@werepjustice
https://t.co/p8Z3MIkBoz https://t.co/ow61oNsraF",4098,476,2019,62585547,4574,0.01,81
741,This is so cute!!! https://t.co/z4B6ztVmtj,12061,554,2019,62585547,12615,0.02,42
742,Just a reminder.... lol #SKIMS https://t.co/Rnv6MCx5RC,16775,1159,2019,62585547,17934,0.03,54
743,üëèüèºüëèüèºüëèüèº https://t.co/f9XRegfukV,22648,1753,2019,62585547,24401,0.04,30
744,"KKW x WINNIE Collab! @winnieharlow is someone I admire and respect so much. She‚Äôs the definition of a true beauty. 
Our @kkwbeauty collab features a gorgeous 12-pan Eyeshadow Palette, a Highlighter Duo &amp; 3 Glosses. Launching to https://t.co/aIjp1MjKyr on Friday, 09.13 at 12pm pst https://t.co/gd9o9YhBdL",14720,959,2019,62585547,15679,0.03,309
745,üì∏‚ô•Ô∏è I did my make up myself üì∏üíã My @kkwbeauty Labor Day Sale is happening now! I‚Äôm wearing my Glam Bible Bundle and Powder Contour &amp; Highlight Palette in Medium. Shop my look at https://t.co/aIjp1MBlpZ https://t.co/tvhxTvgUpQ,7906,357,2019,62585547,8263,0.01,228
746,Contract ‚öñÔ∏è https://t.co/CTVX4qgeGE,40285,1726,2019,62585547,42011,0.07,35
747,https://t.co/LDPi1KMrNk,5569,435,2019,62585547,6004,0.01,23
748,It‚Äôs the last day to shop my @KKWFRAGRANCE #LaborDaySale! Get 30% off sitewide. Exclusions apply. Ends tonight at 11:59pm pst at https://t.co/eAGj098U38 https://t.co/pZHmm3ra9S,1494,98,2019,62585547,1592,0.0,176
749,Besties üëØ‚Äç‚ôÄÔ∏è üëØ‚Äç‚ôÄÔ∏è https://t.co/jDXBOpZeFU,107849,4904,2019,62585547,112753,0.18,41
750,Today is the last day to shop my @kkwbeauty #LaborDaySale! Get 30% off sitewide + up to 70% off select items. Exclusions apply. Ends tonight at 11:59pm pst at https://t.co/aIjp1MBlpZ ‚ú® https://t.co/1YAcPILZvr,1195,66,2019,62585547,1261,0.0,208
751,Pinky swear we‚Äôre besties for life!!! https://t.co/Hdzar2lewg,194782,9739,2019,62585547,204521,0.33,61
752,"Anette Marweld wears the Sculpting Bra ($32 in sizes XXS-5XL) and the Core Control Short Mid Thigh ($38 in sizes XXS-5XL) in Mica. #ShowYourSKIMS @skims 
Video: #VanessaBeecroft https://t.co/RW6LOiel4x",2276,110,2019,62585547,2386,0.0,202
753,Sunday Service in Watts today https://t.co/Yofl72yDEg,101050,19048,2019,62585547,120098,0.19,53
754,"Get 30% off sitewide during my @KKWFRAGRANCE #LaborDaySale! Exclusions apply. Ends tomorrow, 09.02 at 11:59pm pst at https://t.co/eAGj098U38 https://t.co/P5OoaX2fcL",1032,57,2019,62585547,1089,0.0,164
755,My @kkwbeauty #LaborDaySale is happening now! Get 30% off sitewide + up to 70% off select items. Exclusions apply. https://t.co/sbyklMQhdE https://t.co/SGWet13HmK,1149,68,2019,62585547,1217,0.0,162
756,"My @kkwfragrance #LaborDaySale is happening now! Get 30% off sitewide. Exclusions apply. Ends Monday, 09.02 at 11:59pm pst at https://t.co/eAGj098U38 https://t.co/92tpSPERKi",1737,102,2019,62585547,1839,0.0,173
757,Get 30% off sitewide + up to 70% off select items during my @kkwbeauty #LaborDaySale! https://t.co/sbyklMQhdE https://t.co/8Xutk7IPxq,1523,81,2019,62585547,1604,0.0,133
758,Yessssss! üî•üî•üî• https://t.co/FB8MtBgmnN,41787,4289,2019,62585547,46076,0.07,37
759,OMG LOOOOVE this!!! https://t.co/ab1aqoTPYK,3870,100,2019,62585547,3970,0.01,43
760,So many fragrances wow! Makes me so happy you love them üíã‚ô•Ô∏è https://t.co/DPbGZpM2FT,8500,262,2019,62585547,8762,0.01,83
761,"My @kkwbeauty #LaborDaySale starts now! Get 30% off sitewide + up to 70% off select items. No code needed. Exclusions apply. Ends Monday, 09.02 at 11:59pm pst at https://t.co/aIjp1MBlpZ üí´ https://t.co/ekVPIvdA56",1101,64,2019,62585547,1165,0.0,211
762,"My @KKWFRAGRANCE #LaborDaySale starts now! Get 30% off sitewide. No code needed. Exclusions apply. Ends Monday, 09.02 at 11:59pm pst at https://t.co/eAGj098U38 ‚ú® https://t.co/sfcZgRmhu1",1399,72,2019,62585547,1471,0.0,185
763,üåä https://t.co/B2dKT15m1j,125711,8698,2019,62585547,134409,0.21,25
764,Yessss https://t.co/Iuxux52ILj,4172,162,2019,62585547,4334,0.01,30
765,Look at the most amazing model ever @AliceMarieFree Modeling for @skims launching September 10! https://t.co/o7aO8YPJfa,3970,342,2019,62585547,4312,0.01,119
766,I‚Äôm so excited to announce that @kkwbeauty will be coming to @ultabeauty this fall!!! Stay tuned for more details.,14557,822,2019,62585547,15379,0.02,114
767,üôèüèº https://t.co/ZmGvtN7o7C,127245,25622,2019,62585547,152867,0.24,26
768,‚ú® https://t.co/FROaMF1Vmy,11332,438,2019,62585547,11770,0.02,25
769,Get it!!! üéäüéâ https://t.co/tGDOKpCiDG,8106,423,2019,62585547,8529,0.01,36
770,Shop the Gemini‚Äôs in pink at https://t.co/USBcysK4Gw #LemkePartner https://t.co/jSbkvFtZvh,14110,721,2019,62585547,14831,0.02,90
771,"VOGUE ARABIA SEPTEMBER ISSUE!!! 3 covers for @voguearabia!!! 
Working with @manfredthierrymugler again was a dream come true! Wearing all Mugler!!! These looks OMG! There‚Äôs no one like Manfred! And the interview with Kanye was so fun to do! https://t.co/PZ4iXsVahj",14912,1443,2019,62585547,16355,0.03,265
772,https://t.co/Qsy51S3rtD coming September 10!!! @skims https://t.co/tXU55lMNCa,4416,347,2019,62585547,4763,0.01,77
773,Follow @skims! Launching September 10 #ShowYourSkims https://t.co/Qsy51S3rtD https://t.co/sa57RfSExm,3328,188,2019,62585547,3516,0.01,100
774,"Available in sizes XXS - 5XL, SKIMS Solutionwear‚Ñ¢ is for every body. https://t.co/Qsy51S3rtD. #ShowYourSKIMS
Photo: #VanessaBeecroft",1748,113,2019,62585547,1861,0.0,133
775,"SKIMS Solutionwear‚Ñ¢ is coming September 10. I love the idea that the pieces will be the closest thing to someone‚Äôs skin, skimming with amazingly soft and supportive fabrics which accentuate the best parts of our bodies.",5707,261,2019,62585547,5968,0.01,219
776,"My fans and followers are a huge inspiration to me ‚Äì I‚Äôm always listening to their feedback and opinions, and am so grateful they shared their ideas for a new brand name. After much thought and consideration, I‚Äôm excited to announce the launch of SKIMS Solutionwear‚Ñ¢ https://t.co/3bV5MwblDr",30742,2413,2019,62585547,33155,0.05,290
777,"Handmaids Tale Season 3 Episode 9
It‚Äôs getting really good. Who‚Äôs with me?",9387,336,2019,62585547,9723,0.02,75
778,My little man is the sweetest ever! He‚Äôs honestly the best baby. Sleeps through the night and by far my most calm. How did I get so lucky https://t.co/5Z1IU3Dqz0,168603,5985,2019,62585547,174588,0.28,161
779,üëÄ üì∏ @BackgridUS https://t.co/PwC3zBFoqD,55226,3848,2019,62585547,59074,0.09,39
780,Kylie‚Äôs favorite @KKWFRAGRANCE scent is the Nude Lips and I love the Pink and Red! https://t.co/x0WDr8PWWW https://t.co/QLf8O6adX9,1900,105,2019,62585547,2005,0.0,130
781,Me and my Chi Chi https://t.co/sVjc48g59E,240154,17369,2019,62585547,257523,0.41,41
782,My @KKWFRAGRANCE collab with @KylieJenner is available now! Which scent are you getting? https://t.co/x0WDr8PWWW https://t.co/amBOWZhNSW,1996,117,2019,62585547,2113,0.0,136
783,In support of the victims and survivors of the Dayton mass shooting https://t.co/RFr8A4birh,5714,832,2019,62585119,6546,0.01,91
784,üìû Hi Charlie üìû *We would be a üí£ Charlie‚Äôs Angels Cast* @lala @khloekardashian #CharliesAngelsIII https://t.co/hvyusJpNDQ,25257,1252,2019,62585119,26509,0.04,120
785,Thank you! üíãüíãüíã https://t.co/9RinzxrHve,2480,81,2019,62585119,2561,0.0,38
786,https://t.co/sbyklMyGm6 has free shipping all month!!! https://t.co/OyNK1ZsNbb,825,54,2019,62585119,879,0.0,78
787,Enjoy them! üíãüíãüíã https://t.co/pnO9fhxlri,778,39,2019,62585119,817,0.0,39
788,You‚Äôre gonna love them all! Kylie couldn‚Äôt decide so had to don3 separate fragrances https://t.co/Bch2xEbshd,828,44,2019,62585119,872,0.0,108
789,You get it done early! My kinda girl https://t.co/cp8QWYmyB4,1597,44,2019,62585119,1641,0.0,60
790,It‚Äôs so juicy you‚Äôre gonna love it ü••ü••ü•• https://t.co/WaWnTAUcSh,934,40,2019,62585119,974,0.0,62
791,I can‚Äôt wait for you to try them! üíã https://t.co/aacRuIx7qP,763,44,2019,62585119,807,0.0,59
792,You‚Äôre gonna love it! üíã https://t.co/yyviH1g0Mw,641,40,2019,62585119,681,0.0,47
793,You‚Äôre gonna love them! Dying to know which scent is your fave! üíã https://t.co/y17eaPURkK,1014,47,2019,62585119,1061,0.0,89
794,Who got the KKW X KYLIE slips perfumes? Which color did you get and why?,6709,178,2019,62585119,6887,0.01,72
795,"My @KKWFRAGRANCE collab with @KylieJenner is finally here!! The Red, Nude and Pink Lips offer notes of liquid amber, peony, and coconut. I can‚Äôt wait for you guys to try all of these delicious scents. https://t.co/x0WDr8PWWW https://t.co/Jo7mTtThvx",1767,118,2019,62585119,1885,0.0,248
796,"I‚Äôm so excited for you guys to finally shop my @KKWFRAGRANCE collaboration with @KylieJenner!!! These gorgeous Red, Pink and Nude lip-shaped bottles are available for $40 each. Each scent is so amazing I can‚Äôt wait for you guys to smell them. https://t.co/x0WDr8PWWW ‚ú® https://t.co/lUcvfqfD5h",2044,130,2019,62585119,2174,0.0,292
797,"My @KKWFRAGRANCE collab with @KylieJenner just dropped!!! We had so much fun designing these bottles and the fragrances are the perfect mix of our favorite notes. Three different scents packaged in lip-shaped bottles for $40 in Red, Pink and Nude. https://t.co/x0WDr8PWWW https://t.co/uLhZaaGf6u",5958,305,2019,62585119,6263,0.01,295
798,"My @KKWFRAGRANCE collab with @KylieJenner launches in one hour!!! Three colorful lip-shaped 30mL bottles for $40 each in red, pink and nude. Available to shop today at 12pm pst at https://t.co/eAGj098U38 https://t.co/UvGtsJ4UVJ",2119,150,2019,62585119,2269,0.0,227
799,My @kkwfragrance collab with @kyliejenner launches in two hours at 12pm pst!!! I‚Äôm so excited for you guys to smell how delicious these three scents are. Launching to https://t.co/eAGj098U38 ‚ú® https://t.co/7HvMQ081AO,1851,120,2019,62585119,1971,0.0,216
800,Matte Smoke Collection üòç https://t.co/aIjp1MBlpZ https://t.co/zIF6c4WQ0L,15825,937,2019,62585119,16762,0.03,72
801,"Sometimes you need time to yourself, time with your best friends just to detox and recharge #Bahamas #SisterBestieKidsTrip @lala https://t.co/jbu6K7Rznx",30215,1420,2019,62585119,31635,0.05,152
802,Bahamas üáßüá∏ Pics Coming Up!                I thought taking a pic with three kids was hard OMG this is almost impossible! https://t.co/7WArhC9Gbc,195064,14455,2019,62585119,209519,0.33,144
803,My brave girl Chicago üêç https://t.co/V1dkyMTJV0,178194,19153,2019,62585119,197347,0.32,47
804,I was scared lol üê∑ https://t.co/gDXRx3nbG0,73282,3638,2019,62585119,76920,0.12,42
805,It was going so good.... swipe ‚û°Ô∏è üòÇ https://t.co/FvbplgpW5B,249018,19235,2019,62585119,268253,0.43,59
806,My @KKWFRAGRANCE collab with @KylieJenner features three different scents that smell so delicious! I can‚Äôt wait for you guys to get them on August 23rd at 12pm pst at https://t.co/eAGj098U38 https://t.co/sJ8LtBKXPq,2602,182,2019,62585119,2784,0.0,214
807,My @KylieJenner by @KKWFRAGRANCE PR boxes are giant candy lips and they smell soo good!! https://t.co/MUBlGHK27i,11612,470,2019,62585119,12082,0.02,112
808,Obsessed with my @KylieJenner by @KKWFRAGRANCE PR boxes made by @bttrlovehardwrk https://t.co/aQaPRGnmIG,3021,157,2019,62585119,3178,0.01,104
809,"My @kkwfragrance collab with @kyliejenner launches this Friday! 3 different scents that smell so delicious! Red Lips is an opulent white floral, Pink Lips is a solar floral coconut &amp; Nude Lips is a vanilla amber musk. Aug 23 KYLIE JENNER BY KKW FRAGRANCE https://t.co/eAGj098U38 https://t.co/P1Xim0xfY0",3254,214,2019,62585119,3468,0.01,306
810,My @kkwbeauty Matte Smoke &amp; Matte Cocoa Lip Liners are sold out!!! You can pair your favorite Nude or Classic Icon Lip Liner with the new Matte Lipsticks. Available to shop at https://t.co/aIjp1MBlpZ #kkwbeauty https://t.co/G2vSb1Fdvm,1640,80,2019,62585119,1720,0.0,238
811,My @kkwbeauty 90‚Äôs Mattes Collection is available to shop now at https://t.co/aIjp1MBlpZ and enjoy free shipping on all domestic orders $50 and up!! #kkwbeauty https://t.co/s8lwResS6v,2810,129,2019,62585119,2939,0.0,183
812,My new @kkwbeauty Matte Cocoa and Matte Smoke Eyeshadow Palettes are perfect for recreating a 90‚Äôs inspired look. The shadows are creamy and have a velvet matte finish. Available to shop at https://t.co/aIjp1MBlpZ #kkwbeauty https://t.co/l4BiUncGah,3060,157,2019,62585119,3217,0.01,248
813,"My @kkwbeauty Matte Cocoa Lip Liner in 90‚Äôs Style is sold out!! We still have Lipsticks, Lip Liners, Eyeliners and Eyeshadow Palettes that you can shop individually at https://t.co/aIjp1MBlpZ #kkwbeauty https://t.co/5sT9NhFfUk",1341,74,2019,62585119,1415,0.0,226
814,My @kkwbeauty Matte Smoke Bundle and 90‚Äôs Icon Lip Liner are SOLD OUT! We still have individual items available to shop at https://t.co/PoBZ3bhjs8 #KKWBEAUTY https://t.co/WCt9A26eNH,1493,78,2019,62585119,1571,0.0,181
815,"My new @kkwbeauty Matte Cocoa Eyeshadow Palette features shades of warm caramels, soft gingers and wheat browns. Available to shop at https://t.co/aIjp1MBlpZ https://t.co/5dzRXzA3Nu",4198,152,2019,62585119,4350,0.01,181
816,"The Mattes Collection Bundle, Cocoa Bundle, 90‚Äôs Glam Lip Liner &amp; 90‚Äôs Supermodel Lip Liner are sold out!!! We still have individual items available to shop at https://t.co/PoBZ3bhjs8 #KKWBEAUTY https://t.co/d9cZnVsUFN",1646,95,2019,62585119,1741,0.0,222
817,"My @kkwbeauty Matte Smoke Collection features the perfect smokey greys, pale beiges and dusky taupes for a 90‚Äôs inspired look. The bundle is available to shop at https://t.co/aIjp1MBlpZ #kkwbeauty https://t.co/duSWdwMmWW",3405,208,2019,62585119,3613,0.01,220
818,My @kkwbeauty 90‚Äôs Mattes Collection is available to shop now at https://t.co/aIjp1MBlpZ!!! I‚Äôm so excited to see all of the looks you guys create with this collection. https://t.co/uJQNfkVJQS,3236,127,2019,62585119,3363,0.01,192
819,"Wearing my @kkwbeauty Matte Cocoa Eyeshadow Palette, Nude, Black &amp; Brown Eyeliners, 90‚Äôs Glam Matte Lipstick and 90‚Äôs Glam Lip Liner. Available now at https://t.co/aIjp1MBlpZ and get free shipping on all domestic orders $50 and up!! https://t.co/pkvJZRjR5q",5414,326,2019,62585119,5740,0.01,260
820,My @kkwbeauty 90‚Äôs Mattes Collection is available to shop now!!! Enjoy free shipping on all domestic orders $50 and up for the entire month of August!! https://t.co/fMOV61mbXF,2887,116,2019,62585119,3003,0.0,175
821,My new @kkwbeauty Matte Cocoa Lipstick in 90‚Äôs Chic is the perfect warm reddish brown. I used to wear this exact shade all the time in the 90‚Äôs and wanted to recreate it for you guys. https://t.co/sbyklMQhdE https://t.co/1v5uvlTE3d,4763,210,2019,62585119,4973,0.01,231
822,"My @kkwbeauty 90‚Äôs inspired Matte Smoke &amp; Matte Cocoa Collection just dropped!!! The collection features 2 10-Pan Eyeshadow Palettes, 6 Lipsticks in a brand new matte formula, 6 Lip Liners and 5 Eyeliners. Shop the collection at https://t.co/aIjp1MBlpZ https://t.co/qmovOOdY7O",2715,171,2019,62585119,2886,0.0,280
823,My @kkwbeauty 90‚Äôs Mattes Collection launches in 1 hour at 12pm pst!!! The Matte Smoke &amp; Matte Cocoa Collection features two different color ranges with all matte formulas!!! Launching today only at https://t.co/aIjp1MBlpZ #kkwbeauty https://t.co/LVIbwGE59o,2067,96,2019,62585119,2163,0.0,261
824,My @kkwbeauty Matte Smoke &amp; Matte Cocoa Collection launches in two hours at 12pm pst at https://t.co/aIjp1MBlpZ!!! üñ§ I‚Äôm so excited for you guys to try this 90‚Äôs inspired collection!! https://t.co/WN8mltB3SD,2263,115,2019,62585119,2378,0.0,211
825,"My @kkwbeauty Mattes Collection launches tomorrow!!! I‚Äôm wearing the Matte Cocoa Eyeshadow Palette, Nude and Black Eyeliners, 90‚Äôs Chic Matte Lipstick and 90‚Äôs Chic Lip Liner. Launching to https://t.co/aIjp1MBlpZ on Friday, 08.16 at 12pm pst https://t.co/IaXXrDQf8e",6083,382,2019,62585119,6465,0.01,265
826,"My @kkwbeauty 90‚Äôs inspired Mattes Collection launches in two days on Friday, 08.16 at 12pm pst at https://t.co/aIjp1MBlpZ ‚ú® I can‚Äôt wait for you guys to try this collection!!!! https://t.co/7KrUp38f5M",5709,274,2019,62585119,5983,0.01,201
827,This boy right here really lives up to his name üëºüèæ https://t.co/PZdgyaJThc,154110,9334,2019,62585119,163444,0.26,74
828,Nominations for the E! @peopleschoice awards are open! You can nominate #KUWTK all this week at https://t.co/wKpb2nGtVR! https://t.co/Fxw4KHRNs8,2200,159,2019,62585119,2359,0.0,144
829,".@KylieJenner by @KKWFRAGRANCE Launches on Friday, 08.23 at 12pm pst at https://t.co/eAGj098U38 ‚ú® #kkwfxkylie https://t.co/Wm6aGIo0NJ",4296,297,2019,62585119,4593,0.01,133
830,"I‚Äôm so excited for my first ever @kkwfragrance collab w @kyliejenner! There‚Äôs 3 lip-shaped bottles in red, pink, nude for $40 each. I can‚Äôt wait for you guys to see how amazing these scents are!!! Launching to https://t.co/eAGj098U38 on Friday, 08.23 at 12pm pst üì∏ @hypewilliams https://t.co/FZM5RPCspk",7473,358,2019,62585119,7831,0.01,302
831,Keeping Up With The Kardashian‚Äôs Season 17. September 8!!!! https://t.co/dDOIVv3heT,29444,2515,2019,62585119,31959,0.05,83
832,üçú https://t.co/qnsaNYIz95,101919,4154,2019,62585119,106073,0.17,25
833,üåπ https://t.co/GGTZiSYwhN,60207,2963,2019,62585119,63170,0.1,25
834,My Northie girl is the ultimate fashionista! She comes with me to fabric stores and picks out what she likes and for our Japan trip I let her style herself. I should have let her style me too lol. She loves it. She‚Äôs having fun and I am so happy she‚Äôs so expressive. üíÖüèºüëΩüëòüëëüåäüç¨ https://t.co/xEXKsdd5ST,216139,13932,2019,62585119,230071,0.37,298
835,Make sure you guys tune in to watch a new episode of @flipitdisick tonight at 9/8c before new @RevengeBody! @ScottDisick @khloekardashian https://t.co/FS9bQ4aSS9,3091,153,2019,62585119,3244,0.01,161
836,üíÖüèº https://t.co/6yHNBy9qFf,81598,5092,2019,62585119,86690,0.14,26
837,Happy Birthday @zeinabnajm Everything you do with @TeamKanyeDaily is so appreciated!!!! Love you so much doll!,3049,147,2019,62585119,3196,0.01,110
838,Happy Birthday doll!!!!! Sorry I‚Äôm a day late!!! Wishing you all the happiness in the world https://t.co/8rTX9QPXGk,11500,288,2019,62585119,11788,0.02,115
839,Happy Birthday @kyliejenner When I think about you I think of a wise old soul who makes amazing decisions that are always true to what you really believe. You have always been so strong and confident in doing what is in your heart and I admire and respect that. I love you ‚ô•Ô∏èüíã https://t.co/0d4Ylw6w4D,77523,3458,2019,62585119,80981,0.13,300
840,Matte Smoke palette with the black and white eye liners. Ombr√© Lips with new matte formula in 90‚Äôs Supermodel. Next Friday Aug 16 Noon PST.  https://t.co/sbyklMQhdE https://t.co/ppyfNZm2yO,10281,533,2019,62585119,10814,0.02,188
841,Matte Cocoa @kkwbeauty https://t.co/Y4aYOvMQkv,24349,1137,2019,62585119,25486,0.04,46
842,üáØüáµ https://t.co/QHA5GvO4ir,167513,15667,2019,62585119,183180,0.29,26
843,OMGGGGGGGGG https://t.co/Jbbqir8Cne,5904,192,2019,62585119,6096,0.01,35
844,YES!!! https://t.co/VNx5iyxtXc,2306,122,2019,62585119,2428,0.0,30
845,On set for the Matte Cocoa Collection 8.16 https://t.co/sbyklMQhdE https://t.co/YuLMC9J9UP,35568,3061,2019,62585119,38629,0.06,90
846,Thank you Isabel! She‚Äôs the best spray tanner btw! @kkwbeauty https://t.co/9BLp6ZsDsp,10237,234,2019,62585119,10471,0.02,85
847,"Matte Smoke!
White eyeliner is one of my favorite looks with a 90‚Äôs inspo black smoke eye!
All of the lip liners for this collection are a few shades darker than the matte lipstick. I‚Äôm wearing lipliner &amp; lipstick in 90‚Äôs Runway dropping 8.16 at 12pm pst https://t.co/sbyklMQhdE https://t.co/M3OaceOBwt",16154,892,2019,62585119,17046,0.03,308
848,I used to wear this burgundy lip all the time in high school! These are the new matte lipsticks and liners for the matte cocoa collection https://t.co/58rVwHJnlr,3349,136,2019,62585119,3485,0.01,161
849,Matte Cocoa https://t.co/YWqUa8rwX7,3634,231,2019,62585119,3865,0.01,35
850,My new matte formula lipstick is soooooo good!!! https://t.co/s91cvrBhvR,2392,133,2019,62585119,2525,0.0,72
851,Matte Smoke https://t.co/o8suPGDjBs,2951,190,2019,62585119,3141,0.01,35
852,"I can‚Äôt wait for you guys to try it!!! Launching to https://t.co/aIjp1MjKyr on Friday, 08.16 at 12pm pst #kkwbeauty",1380,71,2019,62585119,1451,0.0,115
853,"The collection features 2 10-Pan Eyeshadow Palettes, 6 Lipsticks in a brand new matte formula, 6 Lip Liners, and 5 Eyeliners. Matte Smoke &amp; Matte Cocoa are two entirely different color ranges, so there are so many looks you can create with this collection. https://t.co/DlOf8CDWch",1579,113,2019,62585119,1692,0.0,284
854,I‚Äôm so excited to announce my new 90‚Äôs inspired collection of all matte formulas- The Matte Smoke &amp; Matte Cocoa Collections!!! I get a lot of my makeup inspiration from the 90‚Äôs and love how nostalgic this entire collection is. https://t.co/PoW7yHqH5b,30657,1869,2019,62585119,32526,0.05,255
855,Can you guess??? @kkwbeauty https://t.co/bSq9ktcdWR,19663,734,2019,62585119,20397,0.03,51
856,Not!!!!! https://t.co/YBViy23N2p,2199,81,2019,62585119,2280,0.0,32
857,Happy Birthday to my day 1!!!!!@MyleezaKardash LOVE YOU FOREVER!,6313,165,2019,62585119,6478,0.01,64
858,My #kkwxkylie Lip Set is 40% off for National Sister‚Äôs Day!!! Ends tonight at 11:59pm pst at https://t.co/aIjp1MBlpZ https://t.co/mvPtamYS96,3942,211,2019,62585119,4153,0.01,140
859,You thought we forgot about you??? KKW X KYLIE perfume coming August 23rd!!!! Check the @kkwfragrance page for more details üíãüíãüíã https://t.co/dpQiz4xvnP,23926,1213,2019,62585119,25139,0.04,151
860,https://t.co/0Ot4Ej6XHX. https://t.co/HwtEgZTCbF,26715,1424,2019,62585119,28139,0.04,48
861,Get free shipping all month long on all domestic orders $50+!!! https://t.co/sbyklMQhdE #kkwbeauty https://t.co/Ken41xdcGb,1609,99,2019,62585119,1708,0.0,122
862,Date night with my boo wearing the @kkwbeauty fire palette üî•üé® https://t.co/uCWDT4oomC,110522,7563,2019,62585119,118085,0.19,85
863,"Buy a Nude Cr√®me Lipstick, Get a Peach, Pink, or Classic Icon Lipstick free!!! Ends tonight at 11:59pm pst. https://t.co/sbyklMQhdE https://t.co/Nv2qJzHoVZ",2655,169,2019,62585119,2824,0.0,155
864,Mario‚Äôs üî• look! Who has gotten the Sooo Fire collection? I wanna see your looks! It‚Äôs available now on https://t.co/sbyklMQhdE https://t.co/NjaHPIjiOw,7809,301,2019,62585119,8110,0.01,150
865,We filmed a documentary I am working on that will be out on @oxygen and I hope you will learn about the justice system the way I have.,14232,1145,2019,62585119,15377,0.02,134
866,"Last week I was so moved by Dr. Marc Howard,  a Georgetown professor who teaches a course inside of a DC prison where men &amp; women can get Georgetown credits. I met so many amazing people that can‚Äôt wait to share their stories with you. https://t.co/xxmnIPFy7j",25444,2618,2019,62585119,28062,0.04,263
867,My @kkwbeauty Body Shimmer in Gold is sold out!!! #kkwbeauty https://t.co/zO5WcIrjEm,3150,123,2019,62585119,3273,0.01,84
868,Update! https://t.co/u9Y9q6nKP0,25054,881,2019,62585119,25935,0.04,31
869,My @kkwbeauty Body Foundation in Deep Dark is sold out!! #kkwbeauty https://t.co/w3bzIEPOBX,2153,82,2019,62585119,2235,0.0,91
870,My @kkwbeauty Body Shimmer Trio is sold out!!! The Body Shimmers are still available to shop individually at https://t.co/sbyklMQhdE ‚ú® https://t.co/FGb2USMTN8,1459,75,2019,62585119,1534,0.0,158
871,Shop my #kkwxmario eyeshadow palette &amp; juicy gloss for $40 at https://t.co/aIjp1MBlpZ‚ú® I love this bundle!!! https://t.co/ULpKLzV6vM,1375,89,2019,62585119,1464,0.0,136
872,My @kkwbeauty Body Foundation in Tan is sold out!!! #kkwbeauty https://t.co/uAXanY8igt,1597,71,2019,62585119,1668,0.0,86
873,My @kkwbeauty Body Foundation in Fair is sold out!!! #kkwbeauty https://t.co/KN80KpEFlm,1404,63,2019,62585119,1467,0.0,87
874,My @kkwbeauty Body Foundation is sold out in the shades Light/Medium &amp; Medium!!! #kkwbeauty https://t.co/XHI7foM1yY,1754,71,2019,62585119,1825,0.0,119
875,In the sunburn video we used the body foundation in shades Medium and Tan mixed.,2328,87,2019,62585119,2415,0.0,80
876,My @kkwbeauty Body Foundation is sold out in the shade light!!! #kkwbeauty https://t.co/nFCItfueyW,1012,56,2019,62585119,1068,0.0,98
877,My @kkwbeauty Body Brush is sold out!!! https://t.co/S7LUx7unTY,1266,58,2019,62585119,1324,0.0,63
878,https://t.co/sbyklMQhdE https://t.co/RrPiOpA7r6,6629,330,2019,62585119,6959,0.01,47
879,KKW Body Foundation to the rescue! https://t.co/sbyklMQhdE https://t.co/1NvvQV6Jsl,3022,180,2019,62585119,3202,0.01,82
880,I got Sunburned ‚òÄÔ∏èüí• last week but nothing the @kkwbeauty body foundation couldn‚Äôt cover! We restocked today! https://t.co/sbyklMQhdE https://t.co/u991smB3qQ,15376,551,2019,62585119,15927,0.03,156
881,"My @kkwbeauty Body Collection is back in stock!!!! Shop the Body Foundation, Body Shimmers and Loose Shimmer Powders at https://t.co/sbyklMQhdE ‚ú® https://t.co/OQQnq3PTtw",1816,80,2019,62585119,1896,0.0,169
882,Restock alert!!!! My @kkwbeauty Body Collection is coming back to https://t.co/sbyklMQhdE today at 9am pst ‚ú® https://t.co/jlRfhL7etp,1309,78,2019,62585119,1387,0.0,132
883,My twin ‚ú® https://t.co/8YyspimmD8,282551,17188,2019,62585119,299739,0.48,33
884,‚ô•Ô∏èüòáüôèüèº https://t.co/4335a5f6SW,11661,635,2019,62585119,12296,0.02,29
885,Thank you Dr. Howard. You are such a blessing to everyone inside and they need you! All prisons need this program and people like you https://t.co/lurSz2xKuJ,5983,453,2019,62585119,6436,0.01,157
886,Everyone needs to know about this program. It‚Äôs changing lives! Every prison needs this! https://t.co/mcBzGxWtbK,11753,1049,2019,62585119,12802,0.02,112
887,Scott is bringing you @flipitdisick August 4 at 9/8c on @eentertainment! #FlipItLikeDisick @ScottDisick https://t.co/YgqKbs2MyL,7027,485,2019,62585119,7512,0.01,127
888,Love bugs https://t.co/n5IkKurNR3,104052,4242,2019,62585119,108294,0.17,33
889,Thank you for sharing! We are restocking the body foundation soon! https://t.co/4mxyxRbqbZ,8779,253,2019,62585119,9032,0.01,90
890,Restock alert!!!! My @kkwbeauty Body Collection is coming back to https://t.co/sbyklMQhdE on Friday 07.26 at 9am pst ‚ú® https://t.co/YZDQcv1NZo,1670,96,2019,62585119,1766,0.0,142
891,My @kkwbeauty Loose Shimmer Powders are so smooth and give your skin an intense glow. My powders also help set the Body Foundation. Shop them at https://t.co/sbyklMQhdE ‚ú® https://t.co/GGQnGQ3bkq,2586,125,2019,62585119,2711,0.0,194
892,Watch Kim Kardashian‚Äôs Makeup Artist Mario Dedivanovic Breaks Down Her Makeup Looks | Allure Video | CNE https://t.co/abSkOVfhC9,1268,77,2019,62585119,1345,0.0,128
893,I‚Äôm so excited for you guys to try my new @kkwbeauty Sooo Fire Glosses!!! üî•üî•üî• Shop them at https://t.co/sbyklMQhdE https://t.co/IM0Sjh68C2,2546,140,2019,62585119,2686,0.0,138
894,My @kkwbeauty Sooo Fire Eyeshadow Palette is available to shop at https://t.co/sbyklMQhdE üî• https://t.co/nHuwOxiaU2,3547,167,2019,62585119,3714,0.01,115
895,Saint said he‚Äôs gonna pretend to sleep with his brother. He always wants a pic to capture every moment. You have no idea how sweet my boys are! https://t.co/ag56ybKd2B,282304,12412,2019,62585119,294716,0.47,167
896,My @kkwbeauty Sooo Fire Collection is available to shop now at https://t.co/aIjp1MBlpZ üî•‚ú® https://t.co/dfhfLocRzT,5329,246,2019,62585119,5575,0.01,113
897,My @kkwbeauty Sooo Fire Collection just dropped!!! üî•üî•üî• I cant wait to see all of the looks you guys create with this collection! Go to https://t.co/sbyklMQhdE before it sells out https://t.co/5ID95kgqYb,3867,232,2019,62585119,4099,0.01,202
898,Love this!!! üî• Shop my Sooo Fire Collection at 12pm pst at https://t.co/aIjp1MBlpZ #kkwbeauty https://t.co/u69gvqq3IF,2709,149,2019,62585119,2858,0.0,117
899,Sooo Fire Collection üî•üî•üî• #kkwbeauty https://t.co/KEh8Nn4y8T,3687,166,2019,62585119,3853,0.01,59
900,My @kkwbeauty Sooo Fire Collection is dropping in two hours at 12pm pst at https://t.co/aIjp1MBlpZ I‚Äôm so excited for you guys to try this collection üî•üî•üî•,1836,98,2019,62585119,1934,0.0,153
901,üî•üî•üî• https://t.co/DEUAegMynU,3954,102,2019,62585119,4056,0.01,27
902,My favorite movie üé• https://t.co/kOXy018QFS,3442,144,2019,62585119,3586,0.01,43
903,üî•üíã https://t.co/88I6RsIHxO,1492,58,2019,62585119,1550,0.0,26
904,üôãüèª‚Äç‚ôÄÔ∏è https://t.co/2nqThw971M,94748,8614,2019,62585119,103362,0.17,29
905,"Thank you @realDonaldTrump , @SecPompeo, Jared Kushner &amp; everyone involved with the efforts to Free ASAP Rocky &amp; his two friends. Your commitment to justice reform is so appreciated üôèüèºü§ûüèº https://t.co/Ym1Rzo5Z6c",49865,10218,2019,62585119,60083,0.1,218
906,This was for you sister!!! I was channeling you! https://t.co/33BPuh1GGk,44838,944,2019,62585119,45782,0.07,72
907,My @kkwbeauty Liquid Concealers are restocked!!! Shop them at https://t.co/aIjp1MBlpZ #kkwbeauty https://t.co/s9N2JYB5qJ,3734,173,2019,62585119,3907,0.01,120
908,https://t.co/NpwiYdts3O,1795,209,2019,62585119,2004,0.0,23
909,I had the pleasure of meeting Kevin Keith through a video visit &amp; was so impressed w/ the amazing programs he created in prison to help others inside better themselves! So much evidence has been uncovered proving Kevin‚Äôs innocence. I hope justice is served soon &amp; he is released. https://t.co/mFrA76QlEX,9971,619,2019,62585119,10590,0.02,311
910,"I heard about Kevin Keith‚Äôs case last year &amp; the more I learn about it, the more I believe the world needs to hear what happened to him! He was on death row &amp; came w/in days of execution before the governor of Ohio commuted his sentence to life w/o parole. https://t.co/5dGF9JDcm7",2328,222,2019,62585119,2550,0.0,288
911,Sooo Fire Glam Session üî• üî• üî•  @samvissermakeup I always play it pretty neutral but wanted to make a collection that I would have fun with and would wear when I want to look üî•üí•üî•  launching this Friday https://t.co/FsvhIerHFs https://t.co/cnR2B6B9xs,5991,334,2019,62585119,6325,0.01,247
912,Watch the full Sooo Fire Makeup Tutorial at https://t.co/rrbYqyUk4d #kkwbeauty https://t.co/MAkVDKLbkV,13500,535,2019,62585119,14035,0.02,102
913,My @kkwbeauty Body Foundation in Deep Dark is sold out!!!,4702,130,2019,62585119,4832,0.01,57
914,Who got the Gemini‚Äôs from @carolinalemkeberlin ? Go to https://t.co/USBcysK4Gw before they‚Äôre sold out! #LemkePartner https://t.co/SKZfx9frGt,4733,215,2019,62585119,4948,0.01,141
915,My @kkwbeauty Body Foundation in Tan is sold out!!!,6055,163,2019,62585119,6218,0.01,51
916,Boeing * https://t.co/uNQgE1XYHh,5846,255,2019,62585119,6101,0.01,32
917,https://t.co/3t11HgQbOK,3219,404,2019,62585119,3623,0.01,23
918,I met families who‚Äôs babies have died from the rare cancer they have from living so close to this toxic site. It‚Äôs heart breaking and they should have cleaned this up decades ago! Boing and NASA tested rockets at this site &amp; agreed to clean it up by 2017 but haven‚Äôt! It‚Äôs time!!!,49716,3449,2019,62585119,53165,0.08,284
919,Today I went to an event for the 60th anniversary of the Santa Susana Field Lab Melt Down. It still hasn‚Äôt been cleaned up after 60 years! 60 kids all have rare cancers linked to this toxic site! It‚Äôs time to clean this up! This site  is 10 miles from my home!,11796,806,2019,62585119,12602,0.02,260
920,The @kkwbeauty Body Foundation in Dark is sold out!!!,3006,72,2019,62585119,3078,0.0,53
921,Haha. Kristen and I always say this ‚ú® https://t.co/hO7gkbS2Jn,74553,3122,2019,62585119,77675,0.12,61
922,Wearing the pencil eyeliner in RUST from the @kkwbeauty Sooo Fire üî• Collection dropping July 19th. I love this pencil when I want a softer look but still need my winged liner. https://t.co/hvKDIqqTXs,7066,258,2019,62585119,7324,0.01,199
923,Last night I wore the Sooo Fire Collection üî• https://t.co/5vXRm6HMpW,7356,249,2019,62585119,7605,0.01,68
924,üôèüèº https://t.co/i7DaePpNbl,3245,131,2019,62585119,3376,0.01,26
925,I meannnnn my baby Psalm is so sweet!!! https://t.co/RdoyL4wqlq,377578,17564,2019,62585119,395142,0.63,63
926,Drop 2 of my @LemkeUs sunglasses are available to shop now at https://t.co/Ti66jrUvoA #LemkePartner https://t.co/d1mAYwHrin,1789,127,2019,62585119,1916,0.0,123
927,My @LemkeUs Drop 2 of sunglasses are available to shop now at https://t.co/Ti66jrUvoA #LemkePartner https://t.co/aQtoO3i6yL,2107,132,2019,62585119,2239,0.0,123
928,The @kkwbeauty Body Foundation in Medium is sold out!!!,1972,80,2019,62585119,2052,0.0,55
929,The Liquid Shimmer Trio and Liquid Shimmer in Bronze are sold out!!!,2373,91,2019,62585119,2464,0.0,68
930,My @kkwbeauty press boxes are lit!!!! üî•üî•üî• #SoooFire https://t.co/yey2ukejRF,22737,1545,2019,62585119,24282,0.04,75
931,The Liquid Shimmer in Pearl is sold out!!! The Shimmer Powder in Pearl is still available at https://t.co/aIjp1MBlpZ,1252,64,2019,62585119,1316,0.0,116
932,Dropping the cutest @carolinalemkeberlin oval sunglasses tomorrow called Sand at https://t.co/USBcysK4Gw #LemkePartner https://t.co/NdN69t0nzv,6029,393,2019,62585119,6422,0.01,142
933,He inspires me every single day and I‚Äôm so happy that he is getting the recognition and credit that he deserves. @Forbes https://t.co/Jp7KV9gR52,32915,2616,2019,62585119,35531,0.06,144
934,I watch how hard he works as he puts his soul into every idea &amp; product that he creates. It‚Äôs of no surprise to anyone who works w Kanye that he has been able to turn millions of $ in debt into a billion dollar empire in only 4 years - 100% on his own terms while owning it 100% https://t.co/XQnoSUuVA2,142050,15359,2019,62585119,157409,0.25,306
935,Kanye on @Forbes!!!  I love this cover and article. Kanye has worked so hard to build Yeezy and always stays true to his vision. He is my inspiration ‚ú® https://t.co/yoBVXiQerv,26066,3465,2019,62585119,29531,0.05,175
936,So happy you got it! https://t.co/ov6kpnjMhz,1697,58,2019,62585119,1755,0.0,44
937,"The @kkwbeauty Body Foundations in Fair, Light, and Light/Medium are sold out!!!!",1738,62,2019,62585119,1800,0.0,81
938,The brush sold out!!!,3507,98,2019,62585119,3605,0.01,21
939,My @kkwbeauty Body Collection is back!!! Shop the collection at https://t.co/aIjp1MBlpZ #kkwbeauty https://t.co/0f3fXJvuDs,3217,130,2019,62585119,3347,0.01,122
940,"My @kkwbeauty Body Collection is restocking in 10 minutes at 9am pst!!! Shop my Body Foundation, Liquid Shimmers, Powders Shimmers &amp; Brush at https://t.co/aIjp1MBlpZ ‚ú® #kkwbeauty https://t.co/bjYAkmePEP",1902,87,2019,62585119,1989,0.0,206
941,Thank you for sending this! ‚ú®üíï https://t.co/aPSIQwoRIG,12731,315,2019,62585119,13046,0.02,54
942,üôãüèª‚Äç‚ôÄÔ∏è nice to meet you! And thank you! https://t.co/x7XtViMTRJ,3833,121,2019,62585119,3954,0.01,62
943,I love this! https://t.co/bTpQ7uqLM7,4339,110,2019,62585119,4449,0.01,36
944,"üî• The @kkwbeauty Sooo Fire Collection includes a 10-pan metallic eyeshadow palette, 3 eyeliners &amp; 3 glosses w a brand new formula. I wanted to create something that was fun, and completely different than what we have done before. I‚Äôm so excited to see all of the looks you create https://t.co/ch1u4ZMXEO",3793,239,2019,62585119,4032,0.01,307
945,"So excited to announce my new @kkwbeauty Sooo Fire Collection!!!üî• Coming to https://t.co/aIjp1MBlpZ on Friday, 07.19 at 12pm pst #kkwbeauty https://t.co/SDzu4ul2gM",6961,442,2019,62585119,7403,0.01,163
946,"We haven‚Äôt renamed it, but do you guys like the name Solutionwear?    Any other names your liking?       ***Kim Kardashian renames her figure fixing brand Solutionwear
*** https://t.co/YOJ620q8yE",12139,497,2019,62585119,12636,0.02,196
947,"My @kkwbeauty Body Foundation, Liquid Shimmers, Powder Shimmers &amp; brush are back!!!! The Body Collection is being restocked on Tuesday, 07.09 9:00 am PST at https://t.co/aIjp1MBlpZ #kkwbeauty ‚ú® https://t.co/3v7nesjy4S",1506,84,2019,62585119,1590,0.0,221
948,Have you ever seen cheeks like this! OMG I want to eat them!!!!! https://t.co/BqUJr5AJOm,165224,8844,2019,62585119,174068,0.28,88
949,Solutionwear https://t.co/bBsPi8AIXZ,34160,1671,2019,62585119,35831,0.06,36
950,https://t.co/0Z6wkV7Bji https://t.co/W7JtJ3Ab0k,9079,481,2019,62585119,9560,0.02,47
951,"WALL STREET JOURNAL MAGAZINE @wsjmag
Photographer: Daniel Jackson
stylist: @georgecortina
writer: @BinkleyOnStyle 
Hair: @ChrisAppleton1 
Make Up: @maryphillips

Read All about my new Shapewear Brand. https://t.co/0Z6wkV7Bji https://t.co/QDHEWteksE",3781,258,2019,62585119,4039,0.01,255
952,Excited for Revenge Body tonight!!!!! https://t.co/GIoWvFT8Ar,10561,444,2019,62585119,11005,0.02,61
953,‚ú® @kkwbeauty 4th of July Sale is over tonight! https://t.co/PoBZ3bhjs8 https://t.co/N4HhJ4LKqj,4621,209,2019,62585119,4830,0.01,94
954,Today is the last day to shop my @kkwbeauty 4th of July Sale!! ‚ú® Ends tonight at 11:59pm pst at https://t.co/aIjp1MBlpZ #kkwbeauty https://t.co/kOu46aBfVP,1928,72,2019,62585119,2000,0.0,154
955,Missing Costa Rica. https://t.co/Hve0xGxxP0,51982,2370,2019,62585119,54352,0.09,43
956,üßñüèΩ‚Äç‚ôÄÔ∏è https://t.co/Y04d2fo8wV,155627,9642,2019,62585119,165269,0.26,29
957,"RESTOCK ALERT!!!! My @kkwbeauty Body Foundation, Liquid Shimmers,  Powder Shimmers &amp; brush are back!!!! The Body Collection is being restocked on Tuesday, 07.09 at https://t.co/aIjp1MBlpZ #kkwbeauty ‚ú® https://t.co/luZVcFBIKF",4003,152,2019,62585119,4155,0.01,228
958,Shop my @kkwbeauty 4th of July Sale today at https://t.co/aIjp1MBlpZ‚ú® https://t.co/NwMJRJatBd,1915,87,2019,62585119,2002,0.0,93
959,Not True https://t.co/rgZMgPc1wm,71976,4860,2019,62585119,76836,0.12,32
960,Shop the @kkwbeauty 4th of July Sale!!! ‚ú® Get a free gift of your choice with all $50+ orders! Ends 07.07 at 11:59pm pst only at https://t.co/aIjp1MBlpZ #kkwbeauty https://t.co/Kq8XlLT7v8,2133,109,2019,62585119,2242,0.0,187
961,The @kkwbeauty Liquid Concealers and Concealer Kits are restocked!!! Shop them at https://t.co/aIjp1MBlpZ #kkwbeauty https://t.co/0lkHQKAmDd,2930,129,2019,62585119,3059,0.0,140
962,"Me and my Nana! My dads mom, Helen Kardashian was the absolute best! She was such a force! Miss you Nana. https://t.co/BlUvtk15T1",43121,818,2019,62585119,43939,0.07,129
963,üì∏ by North West https://t.co/Lw5bwE7ey7,140026,7229,2019,62585119,147255,0.24,39
964,"#TALESonBET Season Premiere kicking off tomorrow, new song ‚ÄòBrothers‚Äô by Kanye West ft. Charlie Wilson TOMORROW @BET 9/8c",4932,462,2019,62585119,5394,0.01,121
965,üíï EVERYTHING üíï https://t.co/eE2V2O8NXD,233924,20524,2019,62585119,254448,0.41,38
966,"My brands and products are built with inclusivity and diversity at their core and after careful thought and consideration, I will be launching my Solutionwear brand under a new name. I will be in touch soon. Thank you for your understanding and support always.",92713,20350,2019,62585119,113063,0.18,260
967,"I am always listening, learning and growing - I so appreciate the passion and varied perspectives that people bring to me. When I announced the name of my shapewear line, I did so with the best intentions in mind.",21029,4917,2019,62585119,25946,0.04,213
968,Being an entrepreneur and my own boss has been one of the most rewarding challenges I‚Äôve been blessed with in my life. What‚Äôs made it possible for me after all of these years has been the direct line of communication with my fans and the public. https://t.co/IB5cto7Mlj,27746,1484,2019,62585119,29230,0.05,269
969,It made me cry when I saw Malika‚Äôs interview. https://t.co/44vu5Pk1Tz,13237,502,2019,62585119,13739,0.02,69
970,üòÇüòÇüòÇ https://t.co/ckOiB7XLyx,3833,126,2019,62585119,3959,0.01,27
971,Who‚Äôs tuning into tonight‚Äôs season finale of KUWTK?!,11161,366,2019,62585119,11527,0.02,52
972,Isn‚Äôt @Sia the sweetest human being alive!!! https://t.co/59LNvU5wP5,4120,245,2019,62585119,4365,0.01,68
973,üíã https://t.co/IukE1WHwNX,1260,39,2019,62585119,1299,0.0,25
974,‚ô•Ô∏è https://t.co/vm8TKeQOFs,1469,62,2019,62585119,1531,0.0,26
975,Season 17 is right around the corner! https://t.co/blkyQJRmOZ,7714,407,2019,62585119,8121,0.01,61
976,Yessss!!! https://t.co/ytBfyWSHFt,5727,164,2019,62585119,5891,0.01,33
977,‚ô•Ô∏è https://t.co/zmV3nDiQWc,2507,155,2019,62585119,2662,0.0,26
978,Last Night üìüüî´ü¶†      üì∏ @SplashNews https://t.co/LesXmtoiPV,66639,5111,2019,62585119,71750,0.11,57
979,‚ô•Ô∏è https://t.co/5uiKpJEkLK,4151,145,2019,62585119,4296,0.01,26
980,Wow thank you @cnn for this and Chloe for writing this. https://t.co/PmzlsOy8J7,5299,341,2019,62585119,5640,0.01,79
981,Our Solutionwear Sculpting Body Suit Coming Soon https://t.co/YfH0yKp9AM,5878,215,2019,62585119,6093,0.01,72
982,Ferrell Scott is serving LIFE w/o parole for marijuana. This is so not right! I just listened to Ferrell tell his story https://t.co/9vxVgLoitR. Everyone should listen to the stories that are part of #ThirdStrikeCampaign. This should empower us all to do our part to drive change.,3530,473,2019,62585119,4003,0.01,280
983,Wow this makes me so happy. üôèüèº God Bless your mom. https://t.co/b8oIBHiX8X,193870,8767,2019,62585119,202637,0.32,74
984,HBD @khloekardashian Ive never met anyone like u. Inside &amp;out your one of a kind &amp;flawless in my eyes. I‚Äôm so grateful to have a sister like u. I‚Äôm so happy we are so close &amp; that our souls decided to take this trip down to earth around the same time! So lucky 2 have u in my life https://t.co/UpOa9AUqZs,72675,2850,2019,62585119,75525,0.12,316
985,New @carolinalemkeberlin Drop 2 Sunglasses Coming Soon #LemkePartner https://t.co/zh4VgEMC8p,26762,1044,2019,62585119,27806,0.04,92
986,The @kkwbeauty Liquid Concealers and Concealer Kits are back in stock!!! Shop them now at https://t.co/aIjp1MBlpZ #kkwbeauty https://t.co/kfP7pjvbwj,3769,152,2019,62585119,3921,0.01,148
987,The Sculpting Short and Sculpting Bra in Umber. Coming Soon. #KimonoBody https://t.co/fLhxs99QOX,3840,184,2019,62585119,4024,0.01,96
988,The Sculpting Mid Waist Brief and Sculpting Bra in Mica. Coming Soon. #KimonoBody https://t.co/yRm3ntkaX4,2392,99,2019,62585119,2491,0.0,105
989,"This is a new approach to shapewear: Offering real solutions in 9 shades and sizes XXS-4XL, @kimonobody celebrates and enhances the shape and curves of women. Each piece is designed with soft yet supportive fabrics for everyone to feel their most confident. #KimonoBody https://t.co/Cr81BqiLT4",6745,405,2019,62585119,7150,0.01,293
990,I‚Äôm sending you the biggest package ever!!! Your gonna love!!! https://t.co/gaDXmnhw22,27086,501,2019,62585119,27587,0.04,86
991,Fun Kimono Fact- Kanye drew the Kimono logo,12206,450,2019,62585119,12656,0.02,43
992,Introducing Kimono Solutionwear‚Ñ¢ for every body. Coming Soon in sizes XXS - 4XL in 9 shades.  @kimonobody #KimonoBody,4913,417,2019,62585119,5330,0.01,117
993,"This is the solution short. 
I developed this style for all of those times I wanted to wear a dress or skirt with a slit and still needed the support.  @kimonobody https://t.co/0GO7ZP1A9Y",11889,857,2019,62585119,12746,0.02,188
994,"I would always cut up my shapewear to make my own styles, and there have also been so many times I couldn‚Äôt find a shapeware color that blended with my skin tone so we needed a solution for all of this.  #KimonoBody",5844,298,2019,62585119,6142,0.01,215
995,"Finally I can share with you guys this project that I have been developing for the last year.
I‚Äôve been passionate about this for 15 years. 
       
Kimono is my take on shapewear and solutions for women that actually work.

Photos by Vanessa Beecroft https://t.co/YAACrRltX3",84925,8160,2019,62585119,93085,0.15,280
996,‚ù§Ô∏è https://t.co/ZEAHE0Wdz9,7174,349,2019,62585119,7523,0.01,26
997,It's been 5 years since we launched Kim Kardashian: Hollywood and I'm so proud of everything we've done in the game. Thanks for playing and creating such fun memories with me! https://t.co/pqMpS9kMXU,15902,594,2019,62585119,16496,0.03,199
998,THIS CAKE!!!!!! https://t.co/Mp4hkzaTVw,72535,2323,2019,62585119,74858,0.12,39
999,Happy Birthday @narcicismo !!!! I hope your loving your best life and having the best birthday! You share the same birth with my fave project KK HOLLYWOOD üì∏üòâ‚ú®,4382,142,2019,62585119,4524,0.01,158
1000,üóû EXTRA EXTRA üóû https://t.co/YV72nPq3Rq,70707,3884,2019,62585119,74591,0.12,39
1001,Tonight on #KeepingUp #KUWTK https://t.co/CVzQ0GjvKh,9934,530,2019,62585119,10464,0.02,52
1002,Now watching Relatively Nat &amp; Liv! I love seeing their fam!,3514,124,2019,62585119,3638,0.01,63
1003,Haha! Truuuuuuuue https://t.co/bJdFoewQUT,2653,78,2019,62585119,2731,0.0,41
1004,OMG @khloekardashian ‚Äòs pop up birthday on E! How cute!!!!  I can‚Äôt wait to see this!,5924,167,2019,62585119,6091,0.01,85
1005,She was banging on the door forever and we had to focus https://t.co/YQLtqTWCy3,5740,244,2019,62585119,5984,0.01,79
1006,"As uncomfortable as reliving this all over again is, we have been so open with everything in our lives from giving birth, marriages, divorces, the good times and the bad and unfortunately this is the truth of what we went through and I wish it could have aired sooner.",60124,2009,2019,62585119,62133,0.1,268
1007,I am always in interviews when drama breaks out.,26660,934,2019,62585119,27594,0.04,48
1008,My moms sweatsuit lol! She‚Äôs a G! Literally üòú,9011,222,2019,62585119,9233,0.01,45
1009,Hi https://t.co/aJOw0EqpKI,2777,69,2019,62585119,2846,0.0,26
1010,Ugh I couldn‚Äôt imagine all of these migraines Khloe‚Äôs gets. üò∞,9797,269,2019,62585119,10066,0.02,61
1011,Who noticed Kylie always sings?! She has the cutest voice,49992,1168,2019,62585119,51160,0.08,57
1012,New KUWTK episode starts in 10 mins!!! Tune in! I‚Äôm gonna be live tweeting,4548,198,2019,62585119,4746,0.01,74
1013,I LOVE this!!! https://t.co/0qet3jacCa,4193,134,2019,62585119,4327,0.01,38
1014,The @kkwbeauty Loose Shimmer Powder for Face &amp; Body in Gold is so gorgeous ‚ú® I love layering the powders over the Body Makeup and alone for a natural everyday glow. Available at https://t.co/aIjp1MBlpZ #kkwbeauty https://t.co/daAzj4Y83W,4578,178,2019,62585119,4756,0.01,240
1015,Happy Sunday ‚ú® üì∏ @BackgridUS https://t.co/QK4USjuM9c,49909,2192,2019,62585119,52101,0.08,52
1016,What?!?!?! Wow!!! üî•üî•üî•üì∏üí∏üëëüíé https://t.co/I1AdNUJBdG,75844,3960,2019,62585119,79804,0.13,49
1017,Toy Story 4 time,36590,1549,2019,62585119,38139,0.06,16
1018,My new @kkwbeauty Loose Shimmer Powders for Face &amp; Body are so silky and blingy!! ‚ú® I love using them on top of the Body Shimmer when I want a more intense glow. I‚Äôm using the shade Pearl in this video. Available now at https://t.co/aIjp1MBlpZ #kkwbeauty https://t.co/K3PSZuS5fy,3616,156,2019,62585119,3772,0.01,282
1019,üíãüôèüèºüíé https://t.co/hwJUT074se,9030,342,2019,62585119,9372,0.01,28
1020,So for the past month every time I eat sugar I sneeze. Is that weird?! It happens every time I even take one bite. Does this mean anything? I have been eating super clean vegan lately with only natural sugars but when I try regular sugar I sneeze.,30871,1298,2019,62585119,32169,0.05,247
1021,I still can‚Äôt believe my first born baby is 6. https://t.co/cCCRtQOzRT,326803,13186,2019,62585119,339989,0.54,70
1022,My bad 4 VOGUE JAPAN covers!!! https://t.co/1IomUKCV5x,17674,730,2019,62585119,18404,0.03,54
1023,My boy is so fly in his Prada shirt and Gucci flip flops. He picked out his own outfit https://t.co/v1irJXvIoj,359024,26399,2019,62585119,385423,0.62,110
1024,"My new @kkwbeauty Body Collection is available now!! The collection includes Body Makeup, Body Shimmer, Loose Shimmer Powder for Face &amp; Body and a Body Brush. I‚Äôve been working on these formulas for over a year now &amp; I‚Äôm so excited for you guys to finally try them!!!#kkwbeauty https://t.co/EJUKfyHiiP",2441,141,2019,62585119,2582,0.0,309
1025,My new @kkwbeauty Loose Shimmer Powders for Face &amp; Body are launching in 30 minutes!!! These powders are so silky &amp; blingy and give you a gorgeous glow. Launching at 12pm pst at https://t.co/aIjp1MBlpZ #kkwbeauty https://t.co/f4ggKQ1q2l,1045,79,2019,62585119,1124,0.0,244
1026,"I‚Äôve learned to live with and not be insecure of my psoriasis, but for days when I want to cover it up I use my @kkwbeauty Body Makeup. In this after photo I also used my Body Shimmer in Pearl and Loose Shimmer Powder in Pearl. Launching today at 12pm pst #kkwbeauty https://t.co/GjwuBb06zm",3565,186,2019,62585119,3751,0.01,290
1027,Are you guys excited for my Body Collection drop today at 12pm pst?! @kkwbeauty,3755,158,2019,62585119,3913,0.01,79
1028,"My new @kkwbeauty Body Shimmers launch in TWO hours!!! The shimmers come in pearl, gold and bronze shades. Shop them at 12pm pst at https://t.co/aIjp1MBlpZ #kkwbeauty https://t.co/POkANFQnJI",2128,108,2019,62585119,2236,0.0,190
1029,‚ú® https://t.co/GYz7EPMh0g,1979,55,2019,62585119,2034,0.0,25
1030,My new @kkwbeauty Body Collection launches TOMORROW at 12pm pst at https://t.co/aIjp1MBlpZ #kkwbeauty ‚ú® https://t.co/KpqDWgyS1d,12560,1007,2019,62585119,13567,0.02,127
1031,VOGUE JAPAN https://t.co/eNwGxqjoK8,54593,3433,2019,62585119,58026,0.09,35
1032,VOGUE JAPAN https://t.co/7sNQX7bRLg,14793,1122,2019,62585119,15915,0.03,35
1033,VOGUE JAPAN https://t.co/plqxcZioyB,38673,2591,2019,62585119,41264,0.07,35
1034,"3 JAPANESE VOGUE COVERS!!!!
This was an absolute dream come true for me! Styled by the legendary @anna_dello_russo and shot by @luigiandiango Make Up @makeupbymario Hair @chrisappleton1                  @voguejapan https://t.co/PmTR4iLTPm",9578,818,2019,62585119,10396,0.02,239
1035,God bless you Kelly! I hope you like it! https://t.co/9lIBWPS50w,18873,450,2019,62585119,19323,0.03,64
1036,FML https://t.co/gbyHIvcKVD,293368,47147,2019,62585119,340515,0.54,27
1037,We used my new @kkwbeauty Body Makeup in the shade Light. https://t.co/X5jLNvzN7Q,3960,144,2019,62585119,4104,0.01,81
1038,"My body foundation really evens out and corrects your skin tone and conceals veins and bruises. My formula is super creamy, hydrating &amp; long lasting! I can‚Äôt wait for you guys to try the entire Body Collection launching on Friday at 12pm pst at https://t.co/aIjp1MBlpZ #kkwbeauty https://t.co/DFQl1mWoD0",2759,147,2019,62585119,2906,0.0,307
1039,If you let it dry before putting your clothes on it transfers way less &amp; if you set it with a translucent powder it hardly transfers at all. It was important to keep the skin looking flawless yet natural. We didn‚Äôt have translucent powder but tried pressed powder which worked too https://t.co/0ycesB7Yx9,4197,154,2019,62585119,4351,0.01,308
1040,Let‚Äôs talk about the transfer. I‚Äôve been using body makeup for over a decade &amp; in my experience you either get coverage that doesn‚Äôt transfer but it‚Äôs super dry and looks fake or it‚Äôs the opposite and really moisturizing but completely transfers. My new body makeup is in between. https://t.co/3Da9Bw1MQJ,12357,622,2019,62585119,12979,0.02,308
1041,My grandma MJ asked me about my @kkwbeauty Body Makeup and wanted me to come over to help cover her veins. North &amp; I went straight to her house &amp; showed her exactly how to use it &amp; I love how happy she is with the results! How amazing is this before and after on MJ?! https://t.co/X7JcxBCmlm,21690,579,2019,62585119,22269,0.04,303
1042,"My new @kkwbeauty Loose Shimmer Powders for Face &amp; Body are available in pearl, bronze and gold shades. I love using them on top of the Body Shimmer when I want a more intense glow. Launching this Friday, 06.21 at 12pm pst at https://t.co/aIjp1MBlpZ #kkwbeauty https://t.co/keRypuK8P4",2541,117,2019,62585119,2658,0.0,288
1043,The Best of Nudes and Pinks Lipstick Sets are restocked!!! Shop them today at https://t.co/PoBZ3bhjs8 #KKWBEAUTY https://t.co/9P8p7jDzJo,2008,106,2019,62585119,2114,0.0,136
1044,We‚Äôre back in the gym heavy! I would say every 6 months I take two weeks off from lifting. Sometimes you just need a break to recharge and chill but then I miss it so much and feel so good to be back at it üèãüèΩ‚Äç‚ôÄÔ∏è https://t.co/sr1MuQgaMB,26440,830,2019,62585119,27270,0.04,235
1045,I‚Äôm obsessed with my new @kkwbeauty Loose Shimmer Powder for Face &amp; Body in Gold ‚ú® I love how silky and blingy these powders are!! They also help set the liquid body makeup and shimmer if you are layering all 3 products together. Launching this Friday at 12pm pst #kkwbeauty https://t.co/jOsGUAx5DL,2779,133,2019,62585119,2912,0.0,302
1046,In this video I‚Äôm using my new @kkwbeauty Loose Shimmer Powder For Face &amp; Body in Pearl. I love using the powders on top of the Body Shimmer when I want a more intense glow. Launching this Friday at 12pm pst at https://t.co/aIjp1MBlpZ #kkwbeauty https://t.co/wtIPUP9UTw,1564,95,2019,62585119,1659,0.0,273
1047,My new @kkwbeauty Loose Shimmer Powder in Pearl is a gorgeous ice pink champagne shade. You can use the shimmer alone or layer it with the Body Makeup for an extra glow. The powder also helps set the liquid body makeup and shimmer if you are layering all 3 products together. https://t.co/hno1C0zXtm,3634,140,2019,62585119,3774,0.01,299
1048,My new Loose Shimmer Powders for Face &amp; Body are so silky and blingy!! ‚ú® I love using them on top of the Body Shimmer when I want a more intense glow. The powder also helps set the liquid body makeup and shimmer if you are layering all 3 products together. https://t.co/IwAkaOaqef,13017,466,2019,62585119,13483,0.02,284
1049,I can‚Äôt wait for you to see #ComingSoon https://t.co/I44IjLS0T8,73938,4026,2019,62585119,77964,0.12,63
1050,#UncleYe https://t.co/FW0yus0lqB,71019,2750,2019,62585119,73769,0.12,32
1051,In this video I‚Äôm using my @kkwbeauty Body Shimmer in Pearl. You can use the shimmer alone or with the Body Makeup for an extra glow. My formula gives you a gorgeous radiant look &amp; is so moisturizing. I can‚Äôt wait for you guys to try it! Launching on Friday at 12pm pst #kkwbeauty https://t.co/1s4mqj3Udm,3020,135,2019,62585119,3155,0.01,308
1052,My new @kkwbeauty Body Shimmer in Bronze. You can use the shimmer alone or layer it with the Body Makeup for an extra glow. My formula gives you a gorgeous radiant look and is so moisturizing. I can‚Äôt wait for you guys to try it! Launching this Friday at 12pm pst #kkwbeauty‚ú® https://t.co/biYXhU8tJJ,4819,257,2019,62585119,5076,0.01,299
1053,My new @kkwbeauty Body Shimmer in Gold. You can use the shimmer alone or layer it with the Body Makeup for an extra glow. My formula gives you a gorgeous radiant look and is so moisturizing. I can‚Äôt wait for you guys to try it! Launching this Friday at 12pm pst #kkwbeauty‚ú® https://t.co/sGiXYlbH2P,9153,361,2019,62585119,9514,0.02,297
1054,My new @kkwbeauty Body Shimmer in Bronze. You can use the shimmer alone or layer it with the Body Makeup for an extra glow. My formula gives you a gorgeous radiant look and is so moisturizing. I can‚Äôt wait for you guys to try it! Launching this Friday at 12pm pst #kkwbeauty‚ú® https://t.co/6m62ciBR9k,3362,168,2019,62585119,3530,0.01,299
1055,How gorgeous is my new @kkwbeauty Body Shimmer in Pearl. You can use the shimmer alone or layer it with the Body Makeup for an extra glow. My formula gives you a gorgeous radiant look and is so moisturizing. I can‚Äôt wait for you guys to try it! Launching this Friday at 12pm pst‚ú® https://t.co/kXOioEYUFR,3043,158,2019,62585119,3201,0.01,303
1056,My boys üñ§üñ§ https://t.co/eIIWhO5C54,145819,7263,2019,62585119,153082,0.24,34
1057,Miss you so much! You would be so proud of The Robert G Kardashian Esophageal Center at @ucla. I have seen how so far in such a short period of time that we have helped so many and i am grateful to all of the amazing staff and doctors! https://t.co/ypTSm9GxDh,52705,1708,2019,62585119,54413,0.09,259
1058,The cutest!!! https://t.co/t6kCYpOETs,58884,2218,2019,62585119,61102,0.1,37
1059,Happy Birthday my sweet girl! The last 6 years have been the best of my life raising you and seeing you grow up. Mommy loves you forever and beyond! https://t.co/865Ul1R6Ah,202485,10705,2019,62585119,213190,0.34,172
1060,. @kkwbeauty Body Collection Press Box https://t.co/0cm1H6kvKc,10479,473,2019,62585118,10952,0.02,62
1061,"I‚Äôve learned to live with and not be insecure of my psoriasis, but for days when I want to just cover it up I use this Body Makeup. My formula is so creamy and buildable and has a smooth satin finish. It builds easily for a more full coverage if needed. #kkwbeauty https://t.co/Po42UzRFbx",38744,2363,2019,62585118,41107,0.07,288
1062,This video is the Body Makeup. This is what I use most often. I don‚Äôt always like my legs to have shimmer on them. I use this when I want to enhance my skin tone or cover my psoriasis. I bruise easily and have veins and this has been my secret for over a decade #kkwbeauty https://t.co/uEdscX33nu,46262,2449,2019,62585118,48711,0.08,296
1063,"I‚Äôm so excited for you guys to try my new @kkwbeauty Body Collection. It consists of 3 different products (body make up, a liquid body shimmer and a loose shimmer powder). I use them all separately and sometimes all together depending on the look I am going for.",3610,131,2019,62585118,3741,0.01,262
1064,Thank you @IvankaTrump for helping me to start this amazing journey of fighting for people who truly deserve a second chance! https://t.co/wdltrPtrFo,44212,5678,2019,62585118,49890,0.08,149
1065,Thank you so much Governor @PhilBryantMS https://t.co/xsrqkYLNpY,9575,890,2019,62585118,10465,0.02,64
1066,"Proud to partner on this initiative with @Lyft, a company with a history of taking bold action to do what‚Äôs right for our community. Thank you for providing ride share credits to formally incarcerated people when they come home.",11545,1043,2019,62585118,12588,0.02,228
1067,"Today, I‚Äôm honored to be a part of the announcement that the administration and the private sector are stepping up to create opportunities for these men and women to succeed once home.",24589,2553,2019,62585118,27142,0.04,184
1068,"While I have been able to offer support to some of the individuals I have met, the obstacles to success are an everyday struggle for thousands and more needs to be done.",7586,523,2019,62585118,8109,0.01,169
1069,"Since the passage of the First Step Act in December, I‚Äôve been speaking with people coming home from prison and learning about the challenges they are facing.",5984,519,2019,62585118,6503,0.01,158
1070,Second Chance Hiring &amp; Re-entry event at the White House today https://t.co/kEUgqITmIE,29366,3135,2019,62585118,32501,0.05,90
1071,"My new @kkwbeauty Skin Perfecting Body Shimmer in Gold ‚ú® Launching on Friday, 06.21.19 at 12PM PST at https://t.co/aIjp1MBlpZ #kkwbeauty https://t.co/WKsXrADcdu",7624,429,2019,62585118,8053,0.01,160
1072,I hope everyone has a good day üñ§,67357,7946,2019,62585118,75303,0.12,32
1073,. @kkwbeauty Lip Liner Nude 1.5 with Lipstick Nude 1.5. My fave new combo https://t.co/aIjp1MjKyr https://t.co/WJjAMspX0F,21353,1262,2019,62585118,22615,0.04,121
1074,‚òÄÔ∏è https://t.co/aHjP7MA8s6,139412,8278,2019,62585118,147690,0.24,26
1075,You will love it! And add the shimmer on top and it‚Äôs magic ‚ú® https://t.co/40ee06ajHo,1936,76,2019,62585118,2012,0.0,85
1076,You will LOVE this then!!!! https://t.co/PWYpk7kLg4,2137,71,2019,62585118,2208,0.0,51
1077,It‚Äôs really amazing for that! https://t.co/Tnd6NZxT7i,1514,62,2019,62585118,1576,0.0,53
1078,Do you guys use Body Make Up? I‚Äôve used it for years to cover my psoriasis! The brand I used to use only had 2 shades and got discontinued so I am so excited for everyone to try this and my formula is üî•üî•üî•,12907,406,2019,62585118,13313,0.02,204
1079,I‚Äôve been working on these formulas for over a year now and I‚Äôm so happy with how creamy and blendable they all are. You can layer the formulas together or use them individually to achieve how much coverage and shimmer you want. I can‚Äôt wait for you guys to try this collection!!,11408,330,2019,62585118,11738,0.02,279
1080,"So excited to announce that my @kkwbeauty Body Collection is coming! Including a Skin Perfecting Body Foundation, Skin Perfecting Body Shimmer, Loose Shimmer Powder for Face &amp; Body and a Body Brush. Shop them on 06.21.19 at 12PM PST only at https://t.co/aIjp1MBlpZ #kkwbeauty https://t.co/iHY6e6jG3s",3760,246,2019,62585118,4006,0.01,303
1081,Psalm Ye https://t.co/DNou1CNzvU,377332,23701,2019,62585118,401033,0.64,32
1082,Nope lol https://t.co/kw4HHWhgiL,3644,101,2019,62585118,3745,0.01,32
1083,I always wondered why it didn‚Äôt show up in autocorrect. https://t.co/APsOoeYjl7,6440,202,2019,62585118,6642,0.01,79
1084,üêπü§Ø https://t.co/YREBohs1qs,3686,116,2019,62585118,3802,0.01,26
1085,OMG Mike! I love this pic https://t.co/ROZhHQzOn3,12511,446,2019,62585118,12957,0.02,49
1086,üéàüéàüéà https://t.co/ptYL7h2r9d,15531,976,2019,62585118,16507,0.03,27
1087,TODAY ONLY! Buy any 2 Glosses for $28 at https://t.co/PoBZ3bhjs8 Ends TONIGHT at 11:59PM PST #KKWBEAUTY https://t.co/l6EpRv2WVf,2419,119,2019,62585118,2538,0.0,127
1088,"Happy Birthday. To my amazing husband, who never ceases to amaze me. Thank you for who you are, and all that you do. I love you! https://t.co/nubHy0QtJQ",261074,18503,2019,62585118,279577,0.45,152
1089,#SacredSpectacle @SlausonRec  ‚ú®‚ú®‚ú® https://t.co/SZs7mzJoVY,1664,113,2019,62585118,1777,0.0,57
1090,My ultimate body perfecting secret is launching to @kkwbeauty on 06.21.19 ‚ú® Can you guys guess what it is? https://t.co/4recF1yQN7,30779,1196,2019,62585118,31975,0.05,130
1091,"My brother @robkardashian has been working hard with some friends on his new line of clothing, available now at https://t.co/eMOynQPFCR https://t.co/IxIA9NjlNx",4432,263,2019,62585118,4695,0.01,159
1092,üëüüëüüëü https://t.co/0XHBpWOCxn,4461,196,2019,62585118,4657,0.01,27
1093,"This is so sad!                      Horrifying video shows prison guard turn off body cam and beat inmate
 https://t.co/18rpXFhy89",4508,591,2019,62585118,5099,0.01,132
1094,"This is actually crazy!!!                  Man dies and body is returned to family with no heart, brain or throat
 https://t.co/ztucEU5f38",8436,1170,2019,62585118,9606,0.02,139
1095,"ü§üüèº Shoppers camp overnight to get their hands on Kanye West sneakers
 https://t.co/tBqUBEq3BA",6236,395,2019,62585118,6631,0.01,94
1096,Throwback Thursday to this fitting https://t.co/qXz344nuqp,48528,1738,2019,62585118,50266,0.08,58
1097,Best Snuggles üì∑ @kendalljenner https://t.co/1cNw3RXL0d,114088,9485,2019,62585118,123573,0.2,54
1098,My @LemkeUs sunglasses are restocked and available to shop today at https://t.co/USBcysK4Gw!! https://t.co/KMXagk7lLi,1973,107,2019,62585118,2080,0.0,117
1099,Who is ready for Handmaids Tale tonight? üôãüèª‚Äç‚ôÄÔ∏è,30022,2416,2019,62585118,32438,0.05,46
1100,A True Chicago Stormi ‚õà https://t.co/nPMJZMs9CL,223164,20169,2019,62585118,243333,0.39,47
1101,Oh hi!!!! https://t.co/4xMXIB3dyb,4664,134,2019,62585118,4798,0.01,33
1102,üëëüëëüëë https://t.co/YcP7jfE2n0,10587,456,2019,62585118,11043,0.02,27
1103,Sorry I wasn‚Äôt live tweeting. I have homework tonight. #IntentionalTorts https://t.co/CWpRDxSsYJ,37868,1620,2019,62585118,39488,0.06,96
1104,North is loving it! ‚ú® https://t.co/TASzFIdi1V,66173,5348,2019,62585118,71521,0.11,45
1105,‚ú® https://t.co/xKA2YpIm7y,9460,650,2019,62585118,10110,0.02,25
1106,üëë https://t.co/cd3MQBi9zY,5366,566,2019,62585118,5932,0.01,25
1107,I forgot to post last weeks Sunday Service . This was Saints first time singing in the choir so North made sure he knew the words. https://t.co/nA3IqRNtTY,31281,2603,2019,62585118,33884,0.05,154
1108,Today at Sunday Service https://t.co/D3s3OZjNVs,4995,564,2019,62585118,5559,0.01,47
1109,Today at Sunday Service https://t.co/JJxyxDkeVQ,4366,391,2019,62585118,4757,0.01,47
1110,üòç https://t.co/pjHgN2p8NC,10009,553,2019,62585118,10562,0.02,25
1111,The best dad ever! üíï https://t.co/Em2o0zUm3d,65682,1357,2019,62585118,67039,0.11,44
1112,Beautiful!!!! https://t.co/1DygsxFkkR,11308,202,2019,62585118,11510,0.02,37
1113,üò¢ https://t.co/KyUyfvtt0p,55348,6078,2019,62585118,61426,0.1,25
1114,https://t.co/panqMLArym,9176,790,2019,62585118,9966,0.02,23
1115,I am hopeful that Kevin will be exonerated since DNA testing has now been ordered on Kevin‚Äôs case and I remain grateful to Governor Newsom for ending capital punishment in California. https://t.co/NmLbh0bNYD,33090,2357,2019,62585118,35447,0.06,207
1116,I had an emotional meeting with Kevin Cooper yesterday at San Quentin‚Äôs death row. I found him to be thoughtful and honest and I believe he is innocent of the crimes for which he was convicted. https://t.co/FveajjjA5y,38089,2857,2019,62585118,40946,0.07,217
1117,"You know how I feel about this!!!!!!!
üíïüíïüíïüî•üî•üî• CONGRATS!!!!!! https://t.co/4Tzd5Sg1hI",5000,181,2019,62585118,5181,0.01,84
1118,OMG all of my dreams are coming true!!!! I am so proud of @lala https://t.co/lO8j9jkDEE,3259,132,2019,62585118,3391,0.01,87
1119,https://t.co/yTzBtpDuXp,5247,504,2019,62585118,5751,0.01,23
1120,"I love seeing Kanye open up to David Letterman during their episode taping for My Next Guest, and now you can see the great conversation on @Netflix. All episodes are streaming today. #MyNextGuest https://t.co/URdSup1YtX",12159,736,2019,62585118,12895,0.02,220
1121,üëãüèº https://t.co/aAmD8bSqcG,63240,3543,2019,62585118,66783,0.11,26
1122,üëèüèº https://t.co/HIY05vTeYP,8207,659,2019,62585118,8866,0.01,26
1123,Yessss I‚Äôm ready!!!! https://t.co/S507egN3dE,42557,4777,2019,62585118,47334,0.08,44
1124,Forever Highlighter is SOLD OUT!!! Love Lipstick &amp; Soulmate Gloss are available to shop individually at https://t.co/PoBZ3bhjs8 #KKWBEAUTY https://t.co/qYvnqwf3F0,2037,97,2019,62585118,2134,0.0,166
1125,"Date Night Glam
Wearing @kkwbeauty Nude lipliner 2, Lipstick Love with Lipgloss Soulmate and powder contour singles in shade 5 and 6
https://t.co/sbyklMQhdE  üì∑ BackGrid https://t.co/kGOSHlryoR",7096,257,2019,62585118,7353,0.01,194
1126,North https://t.co/P1BZZx1rLA,59151,2252,2019,62585118,61403,0.1,29
1127,Chicago https://t.co/RFrwRvJDCs,64524,2434,2019,62585118,66958,0.11,31
1128,üíã https://t.co/yyyIIvY7Ak,14146,670,2019,62585118,14816,0.02,25
1129,Who has seen ‚Å¶@ParisHilton‚Å© new music video!!! üôãüèª‚Äç‚ôÄÔ∏èüî•üî•üî• https://t.co/A2i9yN2iId,43514,3978,2019,62585118,47492,0.08,79
1130,Shooting @kkwbeauty Mrs. West Collection was so much fun. Everything is almost sold out. Just a few more highlighters and lip stick &amp; gloss https://t.co/URoukt2hYc https://t.co/ysRbd3ekyI,11083,535,2019,62585118,11618,0.02,191
1131,It‚Äôs sold out now! All we have left from this collection is a few lip sticks and lip glosses! https://t.co/DYMyh8uU2V,3431,91,2019,62585118,3522,0.01,117
1132,Omg my mom looking at Scott and saying ‚Äúhow about you used to be weird‚Äù üòÇ,20001,706,2019,62585118,20707,0.03,73
1133,üôãüèª‚Äç‚ôÄÔ∏è https://t.co/UgPh1yEcpJ,1549,71,2019,62585118,1620,0.0,29
1134,Yessss https://t.co/Y2hRV737Vq,1541,58,2019,62585118,1599,0.0,30
1135,Oh just wait https://t.co/LvQVvLZgTb,4909,122,2019,62585118,5031,0.01,36
1136,Twins https://t.co/uSwauGKTRy,6523,209,2019,62585118,6732,0.01,29
1137,Rule #1 Don‚Äôt buy other people pets üòÇüòÇüòÇ,30634,1284,2019,62585118,31918,0.05,39
1138,üòÇ https://t.co/qRpkAfH7QQ,2813,84,2019,62585118,2897,0.0,25
1139,This North and Khloe is not cool. I can‚Äôt believe Khloe let North talk her into getting a hamster üêπ,36856,865,2019,62585118,37721,0.06,99
1140,KUWTK starts NOW! Tune into E!,3344,156,2019,62585118,3500,0.01,30
1141,In that message to Scott I forgot to say Happy Birthday ü§¶üèª‚Äç‚ôÄÔ∏èüéÇüéà,53245,1040,2019,62585118,54285,0.09,63
1142,"Found these gems from 2008. Scott I‚Äôve known you for almost 15 years, we‚Äôve all been through so much together and have the best memories! You are like my brother. I‚Äôve seen you grow up and become the most amazing father and friend. So happy you are in our lives. I love you https://t.co/N4znyUJHc9",106956,3126,2019,62585118,110082,0.18,297
1143,"‚ú® Memorial Day Weekend Sale! ‚ú® 25% off SITE WIDE at https://t.co/eAGj098U38 Ends TOMORROW, 05.27 at 11:59PM PST, while supplies last #kkwfragrance https://t.co/kfl1sCyGJY",2051,96,2019,62585118,2147,0.0,170
1144,Get up to 40% off during my Memorial Day Weekend Sale at https://t.co/aIjp1MBlpZ!! #kkwbeauty https://t.co/qmqc8jcIe4,2269,107,2019,62585118,2376,0.0,117
1145,Date Night in Vegas w @celinedion My heart will go on https://t.co/VCjwHikDBs,66471,2786,2019,62585118,69257,0.11,77
1146,"Shop the #KKWFRAGRANCE Memorial Day Weekend Sale! 25% off site wide at https://t.co/tbQezJs782‚ú® Ends Monday, 05.27 at 11:59PM PST https://t.co/VFuWYgQ2xF",1693,87,2019,62585118,1780,0.0,153
1147,My new @kkwbeauty Forever Highlighter is a shimmering champagne gold shade that blends flawlessly and melts into the skin. Shop it today at https://t.co/aIjp1MBlpZ ‚ú® #kkwbeauty https://t.co/dHvHnjq7na,2227,99,2019,62585118,2326,0.0,200
1148,‚ú® https://t.co/M5UmJ8ld8h,9689,269,2019,62585118,9958,0.02,25
1149,This is beautiful üôèüèºüêª https://t.co/aW9HBQB0dH,15828,1101,2019,62585118,16929,0.03,45
1150,Limited quantities left of the @kkwbeauty Mrs. West Eyeshadow Palette!! Tap to shop before it sells out!!! #KKWBEAUTY https://t.co/OTd3jaJwSH,2412,90,2019,62585118,2502,0.0,141
1151,I am so happy you guys all got the Mrs. West Collection. I know most of it sold out in the first 7 minutes but there‚Äôs a few items left. Unfortunately this is a limited edition collection and we won‚Äôt be restocking,12717,337,2019,62585118,13054,0.02,214
1152,"Shop the #KKWFRAGRANCE Memorial Day Weekend Sale! 25% off site wide ‚ú® Ends Monday, 05.27 at 11:59PM PST https://t.co/pw0dmHXDB2",1880,82,2019,62585118,1962,0.0,127
1153,üíï https://t.co/92ahM3C1Gi,134533,6217,2019,62585118,140750,0.22,25
1154,‚ú® https://t.co/xSFwxiIAcx,29212,1831,2019,62585118,31043,0.05,25
1155,KIMYE 4 EVA https://t.co/VEmdWeIWZ6,50153,4223,2019,62585118,54376,0.09,35
1156,"Shop the #KKWBEAUTY Memorial Day Weekend Sale! Get up to 40% off select items while supplies last. Ends on Monday, 05.27 at 11:59PM PST https://t.co/fNYTEhCakZ",1273,71,2019,62585118,1344,0.0,159
1157,My new @kkwbeauty Soulmate Gloss is a blushing nude with light gold pearl. Shop it today for $18 at https://t.co/PoBZ3bhjs8 #KKWBEAUTY https://t.co/UJDPyPcF8E,2021,93,2019,62585118,2114,0.0,158
1158,Love Lipstick is a flattering peachy pink nude shade. Shop it before it sells out for $18 at https://t.co/PoBZ3bhjs8 #KKWBEAUTY https://t.co/SqUrIyZqwr,1404,69,2019,62585118,1473,0.0,151
1159,"We are SOLD OUT of the Mrs. West Lip Bundle!!!! The Mrs. West Eyeshadow Palette, Highlighter, Blush, Lipstick and Gloss are still available to shop individually at https://t.co/PoBZ3bhjs8 #KKWBEAUTY https://t.co/BceppDyXAb",1530,85,2019,62585118,1615,0.0,222
1160,Love Lip Liner is SOLD OUT!!! The Mrs. West Lip Bundle is still available to shop at https://t.co/PoBZ3bhjs8 #KKWBEAUTY https://t.co/8Mtmp1TPwk,1243,65,2019,62585118,1308,0.0,143
1161,ü•∞ https://t.co/geVgxiY9EJ,7421,272,2019,62585118,7693,0.01,25
1162,ü•∞ https://t.co/j4OosML8Fs,28493,2881,2019,62585118,31374,0.05,25
1163,We are SOLD OUT of the Mrs. West Collection!!!! You can still shop all products individually at https://t.co/PoBZ3bhjs8 #KKWBEAUTY,1919,109,2019,62585118,2028,0.0,130
1164,The Mrs. West Collection by @kkwbeauty is available to shop now at https://t.co/PoBZ3bhjs8 https://t.co/UZp8mB0Hb5,1618,91,2019,62585118,1709,0.0,114
1165,The Mrs. West Collection is available to shop now!!! I‚Äôm so excited to see all of the beautiful glam looks you guys create with this collection. Shop it now at https://t.co/PoBZ3bhjs8 #KKWBEAUTY https://t.co/R63GK7t9jX,1736,106,2019,62585118,1842,0.0,218
1166,The Mrs. West Collection launches in ONE hour at 12PM PST at https://t.co/PoBZ3bhjs8 Are you guys excited??? https://t.co/mYLWcNrx1x,1412,98,2019,62585118,1510,0.0,132
1167,"Kanye opens up to David Letterman like you‚Äôve never seen him on My Next Guest, streaming on @Netflix May 31. https://t.co/44HG9skLXV",25549,2821,2019,62585118,28370,0.05,132
1168,"My @kkwbeauty Mrs. West Collection launches TODAY at 12PM PST! The collection features a 6-pan eyeshadow palette, a peachy pink nude lipstick, a warm nude lip liner, a blushing nude gloss, a champagne gold highlighter &amp; a mid-tone pink blush all for $100. https://t.co/PoBZ3bhjs8 https://t.co/moHSzMKk0E",2405,116,2019,62585118,2521,0.0,307
1169,My @kkwbeauty Mrs. West Collection launches TODAY on my 5 year wedding anniversary. Available to shop at 12PM PST at https://t.co/PoBZ3bhjs8 #KKWBEAUTY https://t.co/DtHYAs1gDX,2035,116,2019,62585118,2151,0.0,175
1170,‚ú® https://t.co/sRmgMm6DLB,32889,2587,2019,62585118,35476,0.06,25
1171,‚ú® https://t.co/uOcXOjam8p,71233,4917,2019,62585118,76150,0.12,25
1172,5 years ago I married my best friend ‚ú® https://t.co/wt4N5Ow8qH,392223,32812,2019,62585118,425035,0.68,62
1173,The most beautiful @givenchy wedding gown designed by Riccardo Tisci https://t.co/aGz97NkIqq,40799,2104,2019,62585118,42903,0.07,92
1174,More üì∑ @nabildo https://t.co/G1fNXwrw0L,9586,411,2019,62585118,9997,0.02,39
1175,Bts on our wedding day 5 years ago üì∑ @nabildo https://t.co/8kFCUrJ8Am,23717,1040,2019,62585118,24757,0.04,69
1176,Still to come on this season of Keeping Up with the Kardashians https://t.co/Zd54s8sq1D,64191,5906,2019,62585118,70097,0.11,87
1177,I know it‚Äôs good when Kylie posts it lol https://t.co/pxMZh53v4c,46531,1148,2019,62585118,47679,0.08,64
1178,"The @kkwbeauty Mrs. West Collection launches TOMORROW on Friday, 05.24 at 12PM PST at https://t.co/PoBZ3bhjs8 #KKWBEAUTY
Video by Elias Tahan https://t.co/36dP20APRb",3493,162,2019,62585118,3655,0.01,166
1179,This was my wedding day almost 5 years ago in Italy. We flew in from Paris and our glam was rushed as we were trying to make it on time! So many amazing memories. Can‚Äôt wait to share more pics soon https://t.co/VT646gMa5J,124743,5368,2019,62585118,130111,0.21,221
1180,"My new @kkwbeauty Mrs. West Collection launches in TWO days on Friday, 05.24 at 12PM PST! Learn more at https://t.co/PoBZ3bhjs8 #KKWBEAUTY https://t.co/YqiA5hxCUM",3624,142,2019,62585118,3766,0.01,162
1181,"My new @kkwbeauty Mrs. West Collection features a 6-pan eyeshadow palette, a pink nude lipstick, a warm nude lip liner, a blushing nude gloss, a champagne gold highlighter and a mid-tone pink blush all for $100. Launching in TWO days on Friday, 05.24 at 12PM PST https://t.co/xuugyX2Y1Q",4250,232,2019,62585118,4482,0.01,286
1182,Happy Birthday Queen @NaomiCampbell https://t.co/BCi18syStX,30666,1858,2019,62585118,32524,0.05,59
1183,Don't miss @Carolianlemkeberlin Memorial Day Sale. ¬†All sunglasses are 2 for $99 on¬†https://t.co/Ti66jrUvoA Today through Memorial Day. #MemorialDaySale #LemkePartner https://t.co/gJWdV4bAIr,3706,182,2019,62585118,3888,0.01,190
1184,Mrs. West Collection is dropping this Friday  on my actual anniversary https://t.co/aIjp1MBlpZ. I have sent this collection to all of my friends and I have never gotten a response like this from everyone loving the colors so much! Makes me so happy! I know you all will love it ‚ú® https://t.co/cgvb3C9fVk,22721,1018,2019,62585118,23739,0.04,303
1185,Just finished reading @AliceMarieFree ‚Äòs book! I wrote the forward for her amazing life story. Thank you Alice for sharing so much of yourself with us. Everyone go out and get her book! You will love it! https://t.co/VhVAGGvymz https://t.co/vNtc4pEiaw,11462,637,2019,62585118,12099,0.02,251
1186,‚ú®üôèüèº @nasdaily1 https://t.co/hVDyejHi8W,14277,2579,2019,62585118,16856,0.03,38
1187,üß∏üíéüôèüèº https://t.co/zxkIvGRcIJ,246466,17977,2019,62585118,264443,0.42,28
1188,My sister is so pretty ‚ú®üíï https://t.co/erNDDLyGfj,181896,7972,2019,62585118,189868,0.3,49
1189,Thank you @JackBox for the quick response and handling the situation!,19585,512,2019,62585118,20097,0.03,69
1190,I would like to add that this is not about me or a wrong order. Nobody recognized me and it‚Äôs something that I observed that affected other customers at this particular location that was concerning.,31593,1036,2019,62585118,32629,0.05,198
1191,"Hey, Jack In The Box I have a serious complaint but I won‚Äôt fully put you on blast, check your corporate email inbox or send me a DM with direct person for my team to contact. Pronto!",94677,7553,2019,62585118,102230,0.16,183
1192,Armenian Queen @cher https://t.co/Yq4GAVkaV4,16471,840,2019,62585118,17311,0.03,44
1193,Happy Birthday to my Armenian sister @cher https://t.co/1JUTKbxGB9,48330,2629,2019,62585118,50959,0.08,66
1194,‚úùÔ∏è https://t.co/fvJZkEMobU,13346,1646,2019,62585118,14992,0.02,26
1195,üôèüèº https://t.co/U6NEaoUTyc,11457,1211,2019,62585118,12668,0.02,26
1196,https://t.co/FPpQtBVitv,37059,5974,2019,62585118,43033,0.07,23
1197,https://t.co/qDHbqMQtHf,7624,642,2019,62585118,8266,0.01,23
1198,https://t.co/EiZHcZiNU1,5159,616,2019,62585118,5775,0.01,23
1199,There wasn‚Äôt a dry eye in this room today  @Sia https://t.co/S653cN2epd,131501,29352,2019,62585118,160853,0.26,71
1200,https://t.co/ItMZsFy0HE,9032,1135,2019,62585118,10167,0.02,23
1201,The choir surprised @Sia with one of her songs. https://t.co/Aev2NQDSLN,17613,2325,2019,62585118,19938,0.03,71
1202,"There‚Äôs so many videos from today‚Äôs Sunday service I want to share with you guys. The rain forced us inside but it was magical. No mics, no band, no speakers but it was perfect ‚ú®",11202,343,2019,62585118,11545,0.02,178
1203,üíô https://t.co/P0WyvwcMin,3845,144,2019,62585118,3989,0.01,25
1204,Happy Sunday - there‚Äôs no KUWTK tonight üò¢ https://t.co/AqqzjxYEmf,51895,1532,2019,62585118,53427,0.09,65
1205,Psalm West https://t.co/F0elQd1cJq,260257,24993,2019,62585118,285250,0.46,34
1206,"The Mrs. West Collection by @kkwbeauty features an eyeshadow palette, lipstick, lip liner, gloss, highlighter, and blush all for $100. Launching on my 5 year wedding anniversary on Friday, 05.24 at 12PM PST only at https://t.co/PoBZ3bhjs8 #KKWBEAUTY https://t.co/gEV5s54VJe",3473,157,2019,62585118,3630,0.01,273
1207,Watching 5 Feet Apart for the third time with @KendallJenner üò¢ I cry every time,33025,1089,2019,62585118,34114,0.05,79
1208,"My new @kkwbeauty Mrs. West Collection is made up of an array of universal neutral shades that you can create the most gorgeous looks with. Launching on Friday, 05.24 at 12PM PST at https://t.co/PoBZ3bhjs8 #KKWBEAUTY https://t.co/58jxBkVR6g",3599,160,2019,62585118,3759,0.01,240
1209,"My brand new Mrs. West Collection is inspired by the look @makeupbymario created for me on my wedding day. Launching on my actual 5 year wedding anniversary Friday, 05.24 at 12PM PST online at https://t.co/PoBZ3bhjs8 #KKWBEAUTY https://t.co/QbB5Rbsqu2",14401,645,2019,62585118,15046,0.02,251
1210,5 years and 4 kids ‚ú® life couldn‚Äôt be better! https://t.co/UJC035X69t,463192,33415,2019,62585118,496607,0.79,69
1211,"My new @kkwbeauty Mrs. West Collection is made up of versatile &amp; pigmented shades that you can create the most beautiful glam looks for all occasions. Launching on https://t.co/PoBZ3bhjs8 on my 5 year wedding anniversary on Friday, 05.24 at 12PM PST https://t.co/bVhamMOO4Q",16299,713,2019,62585118,17012,0.03,277
1212,Awww thank you https://t.co/nmrDum1ScI,6104,162,2019,62585118,6266,0.01,38
1213,I am so ready for this! Having a 90210 area code growing up while the show was on literally was everything!!!!!! I cannot wait!!!!!! https://t.co/BniIs9mlDs,25316,1522,2019,62585118,26838,0.04,156
1214,On set of my new Mrs. West Collection dropping May 24. https://t.co/LIbud7eNWt,52009,2070,2019,62585118,54079,0.09,78
1215,"What we do on maternity leave....
 Directed and Choreographed by North ü§† @lilnasx https://t.co/DsM6GGTbrc",413642,63892,2019,62585118,477534,0.76,106
1216,Indra Gold $90 TOMORROW AT 9AM PST/12PM EST @LemkeUs https://t.co/4d7Fn4vKUP,1857,91,2019,62585118,1948,0.0,76
1217,Tempest Clear Silver $90 TOMORROW AT 9AM PST/12PM EST @LemkeUs https://t.co/digcKSd2LE,1488,76,2019,62585118,1564,0.0,86
1218,Nirvana Black Purple $90 TOMORROW AT 9AM PST/12PM EST @LemkeUs https://t.co/JhZIM0RYMw,1710,79,2019,62585118,1789,0.0,86
1219,"Restock tomorrow, 05.15 at 9AM PST/12PM EST!! @LemkeUs https://t.co/91pWO9tchn",5722,245,2019,62585118,5967,0.01,78
1220,I love finding pics from my wedding day in Italy and sharing them,69443,1427,2019,62585118,70870,0.11,65
1221,"My new @kkwbeauty Mrs. West Collection is inspired by my actual look created by @makeupbymario on my wedding day. I love the idea that the memories from one of the happiest days of my life are celebrated in this collection. Friday, 05.24 at 12PM PST https://t.co/PoBZ3bhjs8 https://t.co/6XUjnSzMj4",8362,327,2019,62585118,8689,0.01,297
1222,"So excited to announce my brand new #KKWBEAUTY Mrs. West Collection. This collection is inspired by the look @makeupbymario created on my actual wedding day. Launching on https://t.co/PoBZ3bhjs8 on my 5 year wedding anniversary, 05.24 at 12PM PST https://t.co/oZURCQ3sXf",15159,846,2019,62585118,16005,0.03,270
1223,So fun shooting this video with @parishilton for her new song #BestFriendsAss üçëüíé https://t.co/NHPKmxxZJD,53110,2732,2019,62585118,55842,0.09,104
1224,https://t.co/9RIpDlrB4o https://t.co/GcYBvLZsH8,6695,353,2019,62585118,7048,0.01,47
1225,I love seeing @robkardashian on the show ‚ú®‚ú®‚ú® #KUWTK,12643,394,2019,62585118,13037,0.02,51
1226,‚ù§Ô∏è https://t.co/l9qUdOm4wD,4003,134,2019,62585118,4137,0.01,26
1227,‚ù§Ô∏è https://t.co/izIfMdCgAx,1780,69,2019,62585118,1849,0.0,26
1228,‚ù§Ô∏è https://t.co/cn1XpCAel9,1884,74,2019,62585118,1958,0.0,26
1229,üíôüìù‚öñÔ∏è https://t.co/iXTCoOyN3k,3312,151,2019,62585118,3463,0.01,28
1230,Never too late! ‚öñÔ∏è https://t.co/Q2GkUooega,12880,565,2019,62585118,13445,0.02,42
1231,‚ù§Ô∏è‚ù§Ô∏è‚ù§Ô∏è https://t.co/37ONdktyqw,1751,62,2019,62585118,1813,0.0,30
1232,‚ú®‚öñÔ∏èüìöüìù https://t.co/QpCSOjbLa7,2172,89,2019,62585118,2261,0.0,29
1233,"The #FirstStepAct was just the beginning. There's much more to come, and I'm so excited to be a part of it. @cut_50 @jessymichele @EdyHaney @VanJones68",2166,147,2019,62585118,2313,0.0,151
1234,"To the best mom in the entire world, Happy Mother‚Äôs Day! Thank you for the being the best inspiration for all of your kids and showing us to work hard and love harder! I love you so much!!! https://t.co/BvS7Ly0Mpl",119565,4370,2019,62585118,123935,0.2,213
1235,Sunday Service livestream on Beautiful Mother‚Äôs Day. Service will begin shortly. https://t.co/RFr8A3TH2H,6097,592,2019,62585118,6689,0.01,104
1236,üíéüíéüíéüíé https://t.co/vk6Gi58BaO,39583,2190,2019,62585118,41773,0.07,28
1237,I‚Äôm still not over this look! Camp Crystal Girl  üíéAfter Party üíé https://t.co/sP3ot4jjTG,42312,1948,2019,62585118,44260,0.07,87
1238,üíô https://t.co/2E2HbRRmlW,76146,2827,2019,62585118,78973,0.13,25
1239,üß∏ https://t.co/Yub2YBS55O,24170,764,2019,62585118,24934,0.04,25
1240,We celebrated our baby boy about a week ago and now he‚Äôs here! He‚Äôs so perfect!  Here are some pics of my CBD baby shower. I was freaking out for nothing because he is the most calm and chill of all of my babies so far and everyone loves him so much üß∏ https://t.co/bYH1E2WXHY,94232,4444,2019,62585118,98676,0.16,275
1241,Shop the entire range of Nude Cr√®me Lipsticks &amp; Lip Liners today at https://t.co/PoBZ3bhjs8 #KKWBEAUTY https://t.co/4FLY1bqSVK,2519,115,2019,62585118,2634,0.0,130
1242,Shop my Nude Essentials Lip Bundle for $38!! The set includes the Nude 2.5 Cr√®me Lipstick and Nude 1.5 &amp; 2 Lip Liners. Available at https://t.co/PoBZ3bhjs8 #KKWBEAUTY https://t.co/ffc4P57Zyv,1617,86,2019,62585118,1703,0.0,194
1243,ü§†üëΩüßúüèΩ‚Äç‚ôÄÔ∏è https://t.co/m46To4ULab https://t.co/quU3g6xfvT,345825,32216,2019,62585118,378041,0.6,55
1244,"7 months in the making and fittings in Montreal, Paris and LA. Corset breathing lessons from none other than Mr. Pearl. It was worth it all!!! And this was the start of a magical inspiring connection. Stay tuned for more ‚ú®",23605,586,2019,62585118,24191,0.04,222
1245,"The day that I found out the Met Gala theme was ‚Äúcamp‚Äù, that same day we called @ManfredTMugler üëëthe King of Camp! We met up in Miami right after the holidays last year and saw the sketches! I learned so much about couture from this genius man, it was beyond couture, it was art! https://t.co/3B8nA4DXSc",13410,441,2019,62585118,13851,0.02,303
1246,Shop my Met lipstick and Liner now at https://t.co/aIjp1MBlpZ https://t.co/A881UeEUhV,16713,694,2019,62585118,17407,0.03,85
1247,Shop all of my new Nude Cr√®me Lipsticks &amp; Lip Liners NOW!! I can‚Äôt wait to see all of the looks you guys create with these new shades. Available at https://t.co/PoBZ3bhjs8 #KKWBEAUTY https://t.co/4XVuAV5J50,3070,134,2019,62585118,3204,0.01,210
1248,ONE hour until my 3 new Nude Cr√®me Lipsticks &amp; 4 new Nude Lip Liners launch!!! Are you guys excited?? #KKWBEAUTY https://t.co/DjXgkRplD6,3447,135,2019,62585118,3582,0.01,140
1249,My 3 new gorgeous Nude Cr√®me Lipstick shades are available to shop TODAY at 12PM PST!! Only at https://t.co/PoBZ3bhjs8 #KKWBEAUTY https://t.co/0bTJZIbNCo,2429,98,2019,62585118,2527,0.0,153
1250,My 4 new Nude Lip Liners launch TODAY at 12PM PST!! Shop them online at https://t.co/PoBZ3bhjs8 #KKWBEAUTY https://t.co/fdvD3cQQQW,3206,152,2019,62585118,3358,0.01,130
1251,He‚Äôs also Chicago‚Äôs twin lol I‚Äôm sure he will change a lot but now he looks just like her ‚ú®,220007,9377,2019,62585118,229384,0.37,91
1252,He‚Äôs here and he‚Äôs perfect!,717384,47517,2019,62585118,764901,1.22,27
1253,Shop our full Nude Cr√®me Lipstick &amp; Lip Liner Collection TOMORROW at 12PM PST only at https://t.co/PoBZ3bhjs8 #KKWBEAUTY https://t.co/QhjMhu23xv,2422,139,2019,62585118,2561,0.0,148
1254,We added 3 NEW shades to our universal range of Nude Cr√®me Lipsticks!! Available to shop TOMORROW at 12PM PST at https://t.co/PoBZ3bhjs8 #KKWBEAUTY https://t.co/xGZDN4j8yp,1922,112,2019,62585118,2034,0.0,171
1255,3 New Nude Cr√®me Lipsticks!!! Launching TOMORROW at 12PM PST at https://t.co/PoBZ3bhjs8 #KKWBEAUTY https://t.co/aoVCHDQsaB,1483,91,2019,62585118,1574,0.0,122
1256,All of my Nude Lip Liner Shades #KKWBEAUTY https://t.co/oIKANSL8zo,2475,125,2019,62585118,2600,0.0,66
1257,4 New Nude Lip Liners!!! Launching TOMORROW at 12PM PST at https://t.co/PoBZ3bhjs8 #KKWBEAUTY https://t.co/7GZHI2oSnm,1436,88,2019,62585118,1524,0.0,117
1258,Still obsessing over my Met Gala glam!! shop my look https://t.co/aIjp1MBlpZ‚ú®   Major shout out to @makeupbymario &amp; @chrisappleton1 for the magic! https://t.co/AJmBHyhGVa,39515,2643,2019,62585118,42158,0.07,174
1259,"Year 7- 2019 Manfred Thierry Mugler For the house of Mugler. Mr. Mugler  hasn‚Äôt designed in 20 years &amp; made me the most magical dripping wet dress &amp; printed latex dress w crystals! I have to pinch myself, I am attending the Met Gala while on the cover of Vogue!!! God is good! üôèüèº https://t.co/BFKMfHRcHa",145980,12910,2019,62585118,158890,0.25,311
1260,"Camp Crystal Girl!!! üíéüíéüíé Moir√© printed latex with the crystal drip üíßAnother new creation üõ∏@ManfredTMugler 
Manfred Thierry Mugler for Kim Kardashian West / MET BALL 2019 with Mugler Fashion House. Revisited archive pieces for Mugler Fashion House @Mugler https://t.co/AL8u8Chdkd",39186,4607,2019,62585118,43793,0.07,279
1261,"Mugler Dripüíß 
Straight out of the ocean 
@ManfredTMugler .
His first design in 20 years

Manfred Thierry Mugler for Kim Kardashian West / MET BALL 2019 with Mugler Fashion House. @Mugler https://t.co/ZhE5t26YBj",114631,14844,2019,62585118,129475,0.21,215
1262,This Camp theme deserves two looks üòâ,35110,866,2019,62585118,35976,0.06,36
1263,https://t.co/o4L4EsIcQt,22270,894,2019,62585118,23164,0.04,23
1264,Mood üí¶üí¶üí¶ https://t.co/444eMATAno,13465,526,2019,62585118,13991,0.02,32
1265,"Year 6- 2018 Versace. This was the first time Donatella recreated one of Gianni‚Äôs cross dresses that were in the exhibit. This dress fit like a glove! I knew exactly what I wanted and was my most confident this year! 90‚Äôs, chainmail, simple and sexy. https://t.co/bl196sF7Ji",61490,4488,2019,62585118,65978,0.11,274
1266,Year 5-2017 Vivienne Westwood.  This was my first year going solo. I was so nervous to go by myself I almost threw up on the way &amp; I had to pee every second.. I was FaceTiming my sisters to meet up at the top of the stairs. Vivienne made me this beautiful dress from her archive. https://t.co/X1yA0RW4g7,48019,2638,2019,62585118,50657,0.08,307
1267,Year 4- 2016 Olivier Rousteing for Balmain. I was back to insecure this year because I hadn‚Äôt lost all of my baby weight. Big mistake to bleach the brows but Kanye looked so good this year with those blue eyes! It was super controversial that he wore denim. https://t.co/Ry8FaBEvvn,23665,1663,2019,62585118,25328,0.04,281
1268,Year 3-2015 Peter Dundas for Roberto Cavalli. This is his first dress designing for Cavalli. I was 2 months Pregnant with Saint &amp; desperately trying to hide it. I felt so confident this year! I had more of an opinion and collaborated so well. I really felt so good this night. https://t.co/PyMyQnzMqd,27382,1981,2019,62585118,29363,0.05,304
1269,"Year 2- 2014 Alber Elbaz for Lanvin. I was invited on my own this year! We just had our Vogue cover &amp; Alber gave me the dress I wore on the cover so Anna suggested I wear Lanvin. Not sure why we picked blue lol. Following our cover, this is a dream. https://t.co/ZvC2ADyhcf",27244,1795,2019,62585118,29039,0.05,277
1270,Year 1- 2013 Riccardo Tisci for Givenchy. I was Kanye‚Äôs plus one &amp; so nervous! I didn‚Äôt know anyone &amp;  I‚Äôm sure no one wanted me there lol.  I did my own lipstick &amp; the color is so off. I went home &amp; cried after of insecurity but this is one of my fave looks now. https://t.co/M1so9DVEn4,55067,3146,2019,62585118,58213,0.09,303
1271,"Wait just saw news our baby boy came but that‚Äôs not true! It‚Äôs Met Monday, I‚Äôm in NYC. I would be at the hospital lol",92687,2630,2019,62585118,95317,0.15,117
1272,Morning Texts ‚ú® https://t.co/9elTakkTee,459185,42577,2019,62585118,501762,0.8,39
1273,You know she‚Äôs shy when she talks in her baby voice lol https://t.co/Rt0SeE4Fzs,5910,179,2019,62585118,6089,0.01,79
1274,It‚Äôs so cute!!!!Mase is the best! https://t.co/1fq0DTsWJ8,4258,116,2019,62585118,4374,0.01,57
1275,Thank you ü§ó https://t.co/gLzUVlWSTy,1684,69,2019,62585118,1753,0.0,35
1276,The cutest!!!! https://t.co/ldDftNbYf6,2330,81,2019,62585118,2411,0.0,38
1277,BFF‚ÄôS FOREVER https://t.co/SWRi10C9CY,1139,54,2019,62585118,1193,0.0,37
1278,Thanks! https://t.co/FQZVZJ4U0d,1759,69,2019,62585118,1828,0.0,31
1279,Sorry so late to the live chat! What did I miss???,11618,286,2019,62585118,11904,0.02,50
1280,True‚Äôs Birthday party https://t.co/8W7Vvqvi6a,129130,6656,2019,62585118,135786,0.22,45
1281,Throwback to Kourtney‚Äôs Birthday wearing @Versace üì∑ @SplashNews https://t.co/CI5lY2Xpx0,39804,2710,2019,62585118,42514,0.07,87
1282,My babies are my life!!!! ‚ú®üçº https://t.co/X8CJ1ojnZC,241821,10843,2019,62585118,252664,0.4,52
1283,We did it again! Had the best call w/this lovely family &amp; my attorney @msbkb who just won release for their loved one Jeffrey in Miami - he served 22 years of life sentence for low level drug case. He served too much time but it gives me so much joy to fund this life saving work. https://t.co/pbYicKmFpJ,49046,5257,2019,62585118,54303,0.09,308
1284,5.6.19 MET AFTER PARTY      SERENAxKIMxLALAxTRAVISxTREVOR https://t.co/hvHvGMjcvD,7898,498,2019,62585118,8396,0.01,81
1285,New Nude Cr√®me Lip Liners for $12!!! We are adding FOUR new gorgeous nude shades to our must have Nude Lip Liner collection. Launching on 05.10 at 12PM PST at https://t.co/PoBZ3bhjs8 #KKWBEAUTY https://t.co/mQPOmREV4Y,2882,144,2019,62585118,3026,0.0,217
1286,NEW LAUNCH ANNOUNCEMENT!!! 3 brand new Nude Cr√®me Lipsticks for $18 + 4 new Nude Cr√®me Lip Liners for $12. Launching on 05.10 at 12PM PST at https://t.co/PoBZ3byUQI #KKWBEAUTY https://t.co/AOC5orntqJ,2168,136,2019,62585118,2304,0.0,199
1287,I didn‚Äôt think my daughters luv for my clothes &amp; jewelry would happen so soon. I‚Äôll literally be working &amp; come home to find North dressed up in all of my things. I made her these kid size @carolinalemkeberlin sunglasses because I really wouldn‚Äôt share mine!  Lol I üíì my Northie https://t.co/lfpNnq6Q3C,234369,12833,2019,62585118,247202,0.39,310
1288,What are u looking at lol https://t.co/SqxpsTK6Am,80639,6092,2019,62585118,86731,0.14,49
1289,So cool! ‚ú®üíï https://t.co/c4LsWbXWwG,3620,127,2019,62585118,3747,0.01,35
1290,Missing Bali! üåøüêò and the amazing elephant sanctuary https://t.co/UETNDv2Gaf,143355,8349,2019,62585118,151704,0.24,75
1291,Pink Power Ranger Kimberly üíì https://t.co/RrZzlhODjC,86262,5630,2019,62585118,91892,0.15,52
1292,‚ú®ü§ûüèº https://t.co/QaHOMMzWof,3584,113,2019,62585118,3697,0.01,27
1293,üòÇü§© https://t.co/C2Dzvmb6cu,65144,4335,2019,62585118,69479,0.11,26
1294,I wanted to throw up ü§¢ https://t.co/NSjuLeS5Nw,1776,59,2019,62585118,1835,0.0,46
1295,Yep!!!! https://t.co/lEn2tTTvyt,1066,47,2019,62585118,1113,0.0,31
1296,üßúüèº‚Äç‚ôÄÔ∏èüôãüèª‚Äç‚ôÄÔ∏è https://t.co/X2Gk6OQHg8,6904,245,2019,62585118,7149,0.01,34
1297,It has a calm energy from the moment you step off the plane https://t.co/xCjaWYK3eK,1555,66,2019,62585118,1621,0.0,83
1298,Absolutely very soon ‚ú®üá¶üá≤ https://t.co/HxVOc73P5f,1717,132,2019,62585118,1849,0.0,48
1299,All of them! https://t.co/UCBiXwBfjJ,839,36,2019,62585118,875,0.0,36
1300,Happy Birthday!!!!! https://t.co/I5ygZkY1Sl,2082,73,2019,62585118,2155,0.0,43
1301,Same sis https://t.co/pDj4DJBfak,1855,81,2019,62585118,1936,0.0,32
1302,Literally didn‚Äôt understand me https://t.co/koZfXQcZoJ,1815,58,2019,62585118,1873,0.0,54
1303,Identical https://t.co/7I2lcnE7w5,1159,44,2019,62585118,1203,0.0,33
1304,Sorry I‚Äôm here!!! https://t.co/aJo2XG6AU8,1221,52,2019,62585118,1273,0.0,41
1305,He‚Äôs the best!!! https://t.co/wCE4w7iUWa,1326,57,2019,62585118,1383,0.0,40
1306,Keeping Up With The Kardashians airs in 45 mins East Coast! Let‚Äôs live tweet!!!!,13667,700,2019,62585118,14367,0.02,80
1307,Tonight on the second part of our family trip to Bali #KUWTK 9/8c on E! https://t.co/925iP9SjMv,6225,351,2019,62585118,6576,0.01,95
1308,This is so sad https://t.co/mVaniAFnyt,140378,42127,2019,62585118,182505,0.29,38
1309,üåüüåé‚ö°Ô∏è https://t.co/ezcUaqKloD,10847,421,2019,62585118,11268,0.02,28
1310,Answering 73 questions for Vogue https://t.co/yDlThj4Flb,2636,178,2019,62585118,2814,0.0,56
1311,‚ú®‚ú®‚ú®üëèüèºüëèüèºüëèüèº https://t.co/UU6iExHsYX,110026,11352,2019,62585118,121378,0.19,33
1312,I tried following people again and now looks like at 0 again,30252,965,2019,62585118,31217,0.05,60
1313,No way! We‚Äôre working on figuring out what happened but I will start following people back if I can remember everyone https://t.co/3IrVDHzmxV,4235,149,2019,62585118,4384,0.01,141
1314,üòÇüòÇüòÇ no it‚Äôs a mistake. I have to remember everyone I followed now and add everyone. I have no idea what happened https://t.co/SQ2FW8QZxK,4824,154,2019,62585118,4978,0.01,136
1315,OMG what???? What‚Äôs going on???? https://t.co/ms0u4ExTcG,10343,397,2019,62585118,10740,0.02,56
1316,Style twins! https://t.co/Jd0geL7xeZ,10440,265,2019,62585118,10705,0.02,36
1317,We made a promise we would never forget the Armenian genocide üá¶üá≤ https://t.co/Q9DWvPpn09,28119,2744,2019,62585118,30863,0.05,88
1318,Sooooo Miss North dressed herself and thought she was ready for the day until I explained she couldn‚Äôt wear my boots. üòÇüíï https://t.co/Cla9uhnuuC,548297,53243,2019,62585118,601540,0.96,144
1319,Mason filmed the first video lol,8753,219,2019,62585118,8972,0.01,32
1320,üï∑üò± https://t.co/ymDvmHrLDn,223684,46148,2019,62585118,269832,0.43,26
1321,üï∑ https://t.co/ca8ND7tMam,6407,364,2019,62585118,6771,0.01,25
1322,Yes! ‚ú® the medium in Bali ‚ú® https://t.co/IwAYSQyJCx,3979,128,2019,62585118,4107,0.01,51
1323,üò± https://t.co/9Uk93kHQJX,27479,1265,2019,62585118,28744,0.05,25
1324,"Sunday Service starts at 9am, live from #Coachella https://t.co/9f3MZkQM2f https://t.co/LutzNNpAvw",14888,1337,2019,62585118,16225,0.03,98
1325,"You can watch Kanye‚Äôs Sunday Service live from #Coachella today! Starts in 15 mins, 9am PST https://t.co/A5eb0b6z9s #HappyEaster #SundayService",5897,768,2019,62585118,6665,0.01,143
1326,"Buy a Cr√®me Lipstick, Get a Cr√®me Lip Liner FREE!! Shop now at https://t.co/PoBZ3bhjs8 Ends Tomorrow, 04.21 at 11:59PM PST #KKWBEAUTY https://t.co/5Pv9olJU4E",2313,155,2019,62585118,2468,0.0,157
1327,"Buy a Cr√®me Lipstick, Get a Cr√®me Lip Liner FREE!! Shop now at https://t.co/PoBZ3bhjs8 #KKWBEAUTY https://t.co/KfqBIfhqwc",2170,118,2019,62585118,2288,0.0,121
1328,New UCLA center focusing on disorders of the esophagus to be named for Robert G. Kardashian | UCLA https://t.co/dU2VqDCBSl,3280,216,2019,62585118,3496,0.01,122
1329,Who got their @carolinalemkeberlin sunglasses! I love seeing everyone wear them! I am wearing Sahara in this pic. Go to https://t.co/USBcysK4Gw now to get yours! #Lemke_Partner https://t.co/rlCPkrLcHY,6751,344,2019,62585118,7095,0.01,200
1330,I forgot to upload Sunday Service Videos this week. So here‚Äôs one that I love. I just don‚Äôt know what‚Äôs gonna happen at Coachella https://t.co/ebY8gJdkgQ,70709,6931,2019,62585118,77640,0.12,153
1331,"Sunday Service on Easter Sunday at 9AM at the mountain in Camping.  Shuttles, parking lots &amp; doors open 6AM. More info - https://t.co/iLCIoou4Fz https://t.co/aK9fXLCIkc",3896,342,2019,62585118,4238,0.01,172
1332,HBD @kourtneykardash Can‚Äôt believe the life we have lived! It‚Äôs such a dream to go through it all w having a sister like u by our side! You‚Äôre such an amazing mom &amp;friend! Can‚Äôt wait to celebrate u tonite! I love you beyond what you could imagine https://t.co/6lSDlvrvXZ,48318,2248,2019,62585118,50566,0.08,274
1333,https://t.co/KfhLtU9ChA,11650,415,2019,62585118,12065,0.02,23
1334,Sink tutorial on my ig stories üòÇ,18067,631,2019,62585118,18698,0.03,32
1335,Aced my test btw ‚öñÔ∏è‚úèÔ∏èüìö,528301,33494,2019,62585118,561795,0.9,22
1336,A huge thank you to @esrailian for making this happen ! We have been planning this for a year now and I am so proud. #RobertGKardashianCenter  #EsophagealHealth,3750,194,2019,62585118,3944,0.01,160
1337,So proud to announce the Robert G Kardashian center for esophageal health being launched at UCLA. My wish is that other families can have more information and we can also focus on health and prevention ‚ú® https://t.co/lHvXONHdao,27282,1719,2019,62585118,29001,0.05,227
1338,‚ú® https://t.co/Hs9RBwPKoA,25779,1047,2019,62585118,26826,0.04,25
1339,Swatches of the #FlashingLights Loose Powder pigments ‚ú® Shop them for 30% off until TONIGHT at 8PM PST at https://t.co/PoBZ3bhjs8 #KKWBEAUTY https://t.co/v7h5ABBQA8,5659,320,2019,62585118,5979,0.01,164
1340,Shop the #FlashingLights Flash Promo!!! Get 30% off the Flashing Lights Loose &amp; Pressed Powders! Ends TONIGHT at 8PM PST at https://t.co/PoBZ3bhjs8 https://t.co/Leedg7dZKg,2362,148,2019,62585118,2510,0.0,175
1341,‚öñÔ∏è https://t.co/L72TCR9NEL,278151,36556,2019,62585118,314707,0.5,26
1342,‚ô•Ô∏è https://t.co/DLNm6HJhgh,15366,650,2019,62585118,16016,0.03,26
1343,OMG this is insane!!!! https://t.co/9NOKliyQkl,52066,2150,2019,62585118,54216,0.09,46
1344,FREE SHIPPING on all domestic orders over $50!!! Shop now at https://t.co/PoBZ3bhjs8 ‚ú® Ends TODAY at 12PM PST https://t.co/1f33dmdD3Z,2712,128,2019,62585118,2840,0.0,133
1345,"Two weeks ago, the 165th innocent person was released from death row in the U.S. Thank you @CAGovernor @GavinNewsom for ensuring we never execute an innocent person in CA. #deathpenalty",8991,543,2019,62585118,9534,0.02,185
1346,https://t.co/a30ASrQhvp,14475,618,2019,62585118,15093,0.02,23
1347,Had to come back to Bali before our episode of KUWTK in Bali https://t.co/b6yvg4qBwK,51184,2050,2019,62585118,53234,0.09,84
1348,https://t.co/w1vBYcEzU8,4470,1009,2019,62585118,5479,0.01,23
1349,https://t.co/9WXcqBeW0K,71076,21333,2019,62585118,92409,0.15,23
1350,FREE SHIPPING on all orders over $50!!! Shop now at https://t.co/PoBZ3bhjs8 ‚ú® Ends tomorrow at 12PM PST https://t.co/U9tBXypSAK,2693,154,2019,62585118,2847,0.0,127
1351,Happy 1st Birthday!!! You are so special. I couldn‚Äôt have dreamed of a better best friend for you than your cousin Chi ‚ú® Seeing how close you are is exactly how mom &amp; I are and so we know how much fun you guys are going to have!  I will always be here for you my sweet baby True https://t.co/jht6ojuaGC,195914,7805,2019,62585118,203719,0.33,306
1352,#73Questions with @voguemagazine https://t.co/0IH8YnGBtQ,29425,2443,2019,62585118,31868,0.05,56
1353,"Tonne Goodman and Mikael Jansson were an absolute dream. I‚Äôm so incredibly grateful to writer @JonnyVanMeter for illustrating a glimpse into my life in a way that hasn‚Äôt ever been done-from juggling family, my businesses &amp; pursuing a law degree with such care and seriousness https://t.co/1UbNSpNbi5",11478,836,2019,62585118,12314,0.02,303
1354,"Photographer: Mikael Jansson @mikaeljansson
Stylist: Tonne Goodman @tonnegood 
Makeup: Hannah Murray @hannah_murray1
Hair headpieces: Shay Ashual @shayashual
Cover Look: Chanel top @chanelofficial; Irene Neuwirth necklace @ireneneuwirth.
Vogue Team @sergiokletnoy &amp; @jilldemling https://t.co/KGiLtqZAGj",5992,492,2019,62585118,6484,0.01,311
1355,Special thank you to my husband Kanye for speaking into existence that one day I would grace the cover of Vogue when everyone told me to be ‚Äúmore realistic.‚Äù #dreamsdocometrue #speakitintoexistence #voguemagazine https://t.co/63TfbUXWfN,123352,11934,2019,62585118,135286,0.22,236
1356,"I remember as a little girl flipping through my mom‚Äôs subscription each month and dreaming of one day gracing the cover of this iconic magazine. Thank you to the incredible Anna Wintour for your support as always, it means the world to me. https://t.co/HNE0sSYUho",52104,3034,2019,62585118,55138,0.09,263
1357,"I‚Äôve dreamed of this moment for so long, many said it would never come. Words cannot begin to express how much of an honor it is to have my first solo US cover of @VogueMagazine. https://t.co/gwiXrdQY3k",69102,5304,2019,62585118,74406,0.12,202
1358,Everyone should see this. Van showed me the first episode and I was in tears. It‚Äôs really impactful https://t.co/mhSzPyjwbj,4302,255,2019,62585118,4557,0.01,123
1359,Had to move up front and center üòÇ‚≠êÔ∏è https://t.co/VWBZuWEq2d,36607,2331,2019,62585118,38938,0.06,59
1360,North ‚≠êÔ∏è https://t.co/cJvsBslcz7,110458,7612,2019,62585118,118070,0.19,32
1361,I was going to post this earlier but couldn‚Äôt figure out how to flip the video. A little glimpse of Sunday Service üéº https://t.co/4M7ISYZAkX,9322,851,2019,62585118,10173,0.02,140
1362,Ok just leaving my shoot. It turned out sooo good! I can‚Äôt wait to show you guys what this was for,6997,221,2019,62585118,7218,0.01,98
1363,Aww well I remember shooting a season of l those 30 min episodes took us 8 weeks tops! Now these hour long episodes take 10 months each season https://t.co/skZTMSZsYB,3744,161,2019,62585118,3905,0.01,166
1364,üíãüíãüíã https://t.co/oCWe4cRnvC,1179,60,2019,62585118,1239,0.0,27
1365,It doesn‚Äôt benefit you to not be calm. But let me tell you when one of my kids get injured or anything and I‚Äôm screaming and freaking everyone out https://t.co/ML73fxsALo,2925,167,2019,62585118,3092,0.0,170
1366,That‚Äôs my main talent: calmness üíØ https://t.co/FdGEqJ8UKd,2375,145,2019,62585118,2520,0.0,57
1367,MJ is doing amazing now! üôèüèº,12353,1079,2019,62585118,13432,0.02,27
1368,Sorry I had to take over! https://t.co/jLsju6zHA5,2096,85,2019,62585118,2181,0.0,49
1369,I‚Äôm on set so can‚Äôt watch but let‚Äôs tweet. What‚Äôs going on now ??? #KUWTK,2816,109,2019,62585118,2925,0.0,73
1370,‚ú® https://t.co/WXfG45wN2o,13532,675,2019,62585118,14207,0.02,25
1371,TONIGHT ON E! https://t.co/RFuEymx5WX,9096,586,2019,62585118,9682,0.02,37
1372,Sunday Service Views ‚ú® https://t.co/bSK2827UIC,21738,631,2019,62585118,22369,0.04,46
1373,"Buy one Cr√®me Contour Stick, Get one Cr√®me Highlight Stick FREE! ‚ú® Ends tomorrow, 04.07 at 11:59PM PST, while supplies last #KKWBEAUTY https://t.co/MNGBdbFGbg",5469,266,2019,62585118,5735,0.01,158
1374,"Buy one Cr√®me Contour Stick, Get one Cr√®me Highlight Stick FREE! ‚ú® Ends 04.07 at 11:59PM PST, while supplies last #KKWBEAUTY https://t.co/dyj7pgFkwR",3439,158,2019,62585118,3597,0.01,148
1375,What a cutie!!!!! üíï https://t.co/IvfnDEyokK,23665,750,2019,62585118,24415,0.04,43
1376,Sunday Service Vibe üì∑ @elirusselllinnetz https://t.co/tIoAu2CI0r,62518,3561,2019,62585118,66079,0.11,64
1377,üíã https://t.co/U6bRodiCPm,168658,8614,2019,62585118,177272,0.28,25
1378,Drop 1 All of the @carolinalemkeberlin sunglasses are available now at https://t.co/USBcysK4Gw - I‚Äôm wearing Sahara in this pic in gold! #Lemke_Partner https://t.co/yP6ovhmd5U,5417,315,2019,62585118,5732,0.01,175
1379,Roberto Cavalli https://t.co/DrHEDNX3eN,4830,159,2019,62585118,4989,0.01,39
1380,Tune in to watch us on @JimmyKimmelLive tonight at 11:35|10:35c on #ABC @JimmyKimmel #KimmelinVegas‚Å† https://t.co/roBniL8Yu8,3666,178,2019,62585118,3844,0.01,124
1381,https://t.co/xi96iBplZe TOMORROW https://t.co/czLzBqfdTg,10798,655,2019,62585118,11453,0.02,56
1382,Dropping 4-2 https://t.co/USBcysK4Gw #Lemke_Partner üï∂ https://t.co/Qam4NERPwV,8617,447,2019,62585118,9064,0.01,77
1383,So excited I just got my @LemkeUs press box!!!! #Lemke_Partner https://t.co/WUXhIh0K9P,6951,357,2019,62585118,7308,0.01,86
1384,üòÇ https://t.co/0yqHnrPF7k,1619,61,2019,62585118,1680,0.0,25
1385,Yep! LOL https://t.co/FXO734ZgpN,4543,169,2019,62585118,4712,0.01,32
1386,LOL https://t.co/MpvTGqMnUZ,2068,79,2019,62585118,2147,0.0,27
1387,WHAT DO YOU THINK OF OUR DOUBLE INTERVIEWS?,29797,649,2019,62585118,30446,0.05,43
1388,I'M HERE!!!! SORRY SORRY READY TO LIVE TWEET WITH YOU GUYS!,12869,434,2019,62585118,13303,0.02,59
1389,Our Sweet 16! Can‚Äôt believe Keeping Up With the Kardashians is premiering our 16th season tonight! Be sure to tune into E! https://t.co/zIemwEetJs,49193,3677,2019,62585118,52870,0.08,146
1390,My baby girl North had her dream of life come true! She got to spend the day with @itsjojosiwa. üéÄüíïüéÄ #speechless #bff #Only5Once  https://t.co/jrQpW2bCqJ https://t.co/xUUYOBMEOI,57954,2608,2019,62585118,60562,0.1,176
1391,OTIS- SUNDAY SERVICE https://t.co/G6VFv8f3Ec,39287,8520,2019,62585118,47807,0.08,44
1392,COACHELLA 2019 SUNDY SERVICE EASTER SUNDAY https://t.co/YxY86gguft,106518,12368,2019,62585118,118886,0.19,66
1393,Morning ‚ú® https://t.co/CR4ksfSowC,379866,26559,2019,62585118,406425,0.65,33
1394,Khloe is psychic üîÆ https://t.co/A4CedFsoXr,26684,1592,2019,62585118,28276,0.05,42
1395,I loved high school https://t.co/dh0bhcrk0b,13332,395,2019,62585118,13727,0.02,43
1396,I always wore the 3 stripes and a baby tee https://t.co/XpQN79taRt,9772,314,2019,62585118,10086,0.02,66
1397,My 13th surprise bday party 1993 https://t.co/w79GIebZSG,7985,265,2019,62585118,8250,0.01,56
1398,1995 https://t.co/RsJowkEIZt,28840,1172,2019,62585118,30012,0.05,28
1399,1992 https://t.co/1RCiBwGuTJ,21280,941,2019,62585118,22221,0.04,28
1400,Always loved this pic when me and Kourt and our friend Court were extras on my parents Stair Climber Plus infomercials https://t.co/2wIAjdJBUX,6247,195,2019,62585118,6442,0.01,142
1401,Can‚Äôt sleep going through old pics. Posted some on my ig stories,9728,287,2019,62585118,10015,0.02,64
1402,Restock alert!!! Limited quantities of the #KKWBEAUTY Classic Blossom Bundle are available to shop at https://t.co/PoBZ3bhjs8 üå∏ https://t.co/7vU5fdeh3o,9208,463,2019,62585118,9671,0.02,151
1403,LOVE @kkwbeauty Classic Blossom Blushes!!! Shop these dreamy shades at https://t.co/PoBZ3bhjs8 https://t.co/30dMVtduG7,1881,104,2019,62585118,1985,0.0,118
1404,My favorite creamy @kkwbeauty lipsticks!!! Shop the Pink Cr√®me Lipstick Set at https://t.co/PoBZ3bhjs8 https://t.co/cyiuy1l5GV,1731,108,2019,62585118,1839,0.0,126
1405,Shop the entire #KKWBEAUTY Classic Blossom Collection at https://t.co/PoBZ3bhjs8 https://t.co/n5skt9Xbz3,1601,109,2019,62585118,1710,0.0,104
1406,Throwback to shooting the Classic Blossom Collection available now at https://t.co/aIjp1MBlpZ https://t.co/8XOhWWvZ21,8060,418,2019,62585118,8478,0.01,117
1407,SEASON 16 #KUWTK MARCH 31 https://t.co/9BJafPbK8H,96720,17471,2019,62585118,114191,0.18,49
1408,‚ô•Ô∏è https://t.co/Mb8YW29uhH,9783,249,2019,62585118,10032,0.02,26
1409,The #KKWXMARIO Cr√®me Lipstick in Classic K is restocked for a limited time only!!! Shop now at https://t.co/PoBZ3bhjs8 https://t.co/YhhckkIfFb,3243,166,2019,62585118,3409,0.01,142
1410,Naomi Forever üíõüí´ @Versace https://t.co/b7R60NH8GF,56438,3912,2019,62585118,60350,0.1,49
1411,Watching Mama Medium. Who has seen it? I love her!,13516,355,2019,62585118,13871,0.02,50
1412,Our YEEZY stand https://t.co/fXHAnAuFli,44772,3348,2019,62585118,48120,0.08,39
1413,All proceeds made via the stands will be donated to the National Alliance on Mental Illness (NAMI https://t.co/74GhHLKuAL) the nation‚Äôs largest grassroots mental health organization dedicated to building better lives for the millions of Americans affected by mental illness.,4351,414,2019,62585118,4765,0.01,274
1414,"Stand Locations: Indianapolis, IN; Missouri, TX; Waterloo, IA; Minneapolis, MN; Alton, IL; West Chester, OH; Belle Fourche, SD; Cedar Rapids, IA.",4791,511,2019,62585118,5302,0.01,145
1415,"In the continued spirit of bringing people &amp; families together, the brand has selected unexpected locations for the stands to connect w communities throughout the country.",4818,259,2019,62585118,5077,0.01,175
1416,Today Kanye and Adidas partnered with families across America to create homemade pop-up YEEZY Lemonade Stands stocked with limited pairs of the unreleased YEEZY Boost 700 V2 ‚ÄúGeode‚Äù.,23399,1574,2019,62585118,24973,0.04,182
1417,https://t.co/USBcysK4Gw 4.2.19 https://t.co/k1CYqiUfD9,6987,514,2019,62585118,7501,0.01,54
1418,Oh just wait I am going to be giving away all of Kourtney‚Äòs unwanted PR boxes... I will announce a giveaway soon https://t.co/3UymTGZYFt,15948,682,2019,62585118,16630,0.03,136
1419,"Shop the #GlamBible for 20% off at https://t.co/PoBZ3bhjs8 until tomorrow, 03.23 at 12PM PST and get FREE SHIPPING on domestic orders over $50!!! https://t.co/5mlpQQKArL",1684,103,2019,62585118,1787,0.0,169
1420,"Get FREE SHIPPING on all #KKWBEAUTY domestic orders over $50 until tomorrow, 03.23 at 12PM PST at https://t.co/PoBZ3bhjs8 https://t.co/ntCmp2GSEf",1822,91,2019,62585118,1913,0.0,145
1421,Happy National #FragranceDay!! Get 30% off site wide at https://t.co/tbQezJs782! Ends tomorrow at 9AM PST @KKWFRAGRANCE @FragranceFDTN,2807,151,2019,62585118,2958,0.0,134
1422,Me &amp; my papa Arthur Kardashian. ‚ú® My mom would crimp my hair all the time! I still have the same crimper machine and used it just recently ‚ú® https://t.co/VpgqBSgrhH,38011,1142,2019,62585118,39153,0.06,168
1423,Tempest Sunglasses dropping April 2 https://t.co/USBcysK4Gw #OnSight https://t.co/UPtuhhpHH0,8244,499,2019,62585118,8743,0.01,92
1424,BTS @LemkeUs https://t.co/fYNU4AERKx,11000,766,2019,62585118,11766,0.02,36
1425,So gorgeous!!! @winnieharlow wearing #KKWBEAUTY Classic Red Cr√®me Lipstick for @REMIXmagazine https://t.co/gvIN1nVDiI,10542,472,2019,62585118,11014,0.02,117
1426,Who makes the best kids pajamas? I am on the hunt for new pj‚Äôs for all of my kids!,37429,1138,2019,62585118,38567,0.06,82
1427,Her favorite part of the week is dancing during Sunday Service https://t.co/yhiDhBqBY5,271491,25957,2019,62585118,297448,0.48,86
1428,Power https://t.co/7X9rXwkdOW,304609,40736,2019,62585118,345345,0.55,29
1429,Lift Yourself https://t.co/VLFclhXpRO,108600,16317,2019,62585118,124917,0.2,37
1430,Morning prayer by DMX #SundayService https://t.co/AGpMgUyF9U,30579,6411,2019,62585118,36990,0.06,60
1431,Happy Birthday to my one and only brother Robbie! I was looking through old pictures and all of the amazing memories came up. My best memories though are you as a dad and seeing what an amazing person you have become. I love you beyond üçÄüçÄüçÄ https://t.co/OXg7Zii7te,63329,1747,2019,62585118,65076,0.1,263
1432,‚ô•Ô∏è https://t.co/xEmfYwYfQ8,147292,6450,2019,62585118,153742,0.25,26
1433,North just FaceTimed @itsjojosiwa and her life is made!!!!!! üéÄüéÄüéÄ That was the cutest thing ever seeing North soooo excited! Especially when she saw her dog bowbow üéÄüéÄüéÄ,31640,807,2019,62585118,32447,0.05,166
1434,OMG üíïüíïüíïüíï best ever!!! https://t.co/5NLXuFJli5,7372,246,2019,62585118,7618,0.01,45
1435,"Just 24 hours after the Christchurch shooting New Zealand bans semiautomatic guns! üëèüèº
America take note! Why can‚Äôt our 
elected officials put public safety over gun manufacturers‚Äô profits?!?! https://t.co/nsufYNygoO",196069,31170,2019,62585118,227239,0.36,217
1436,"Matthew Charles‚Äôs lease application was rejected again bc of his criminal record (even w me paying his rent in advance). If there are any landlords w a 2 bedroom in Nashville willing to give Mr Charles a 2nd chance, contact mocapt615@gmail.com Serious inquiries only, thank you üôèüèº",46526,5539,2019,62585118,52065,0.08,280
1437,üëèüèºüëèüèºüëèüèº https://t.co/sa5MU8y8X7,8077,425,2019,62585118,8502,0.01,30
1438,üôèüèºüôèüèºüôèüèºüëèüèºüëèüèºüëèüèº https://t.co/HN2R7mTaWp,3712,239,2019,62585118,3951,0.01,36
1439,And we should not be okay with the risk that an innocent person could be executed. I hope we can turn toward better solutions that focus more on healing victims of trauma and prioritizing fairness and justice.,22688,1833,2019,62585118,24521,0.04,209
1440,I have met with and am very supportive of Governor Newsom and his decision to help bring an end to the California Death Penalty. Racial bias and unfairness run deep throughout the justice system but especially when it comes to the death penalty.,16372,1145,2019,62585118,17517,0.03,245
1441,"For the last year, I have immersed myself in learning about the criminal justice system. I visited prisons, met with formerly incarcerated people, and helped with cases of individual injustice - including two death penalty cases.",33375,1490,2019,62585118,34865,0.06,229
1442,Coming soon. Follow my vision with #carolinalemkeberlin https://t.co/USBcysK4Gw üì∑ @mertalas #macpiggott https://t.co/HkkYGjqMq5,9641,606,2019,62585118,10247,0.02,127
1443,Best Video ‚ú® Saint is my twin personality though. https://t.co/30qSUIrUO3,21371,984,2019,62585118,22355,0.04,73
1444,üòçüòçüòçüî•üî•üî• https://t.co/DUamvFskkQ,39873,1339,2019,62585118,41212,0.07,30
1445,Sunday Service üåô  ‚≠êÔ∏è üöÄ https://t.co/b6wFWjALHC,141692,29213,2019,62585118,170905,0.27,46
1446,The king of hide and seek üòÇ https://t.co/nOUgXL7g9J,123432,5754,2019,62585118,129186,0.21,51
1447,Mr. Mugler sketched my hair and make up look for the night ‚ú® https://t.co/0TlL05zgHB,19479,642,2019,62585118,20121,0.03,84
1448,Night at the Museum! Wearing @manfredthierrymugler @muglerofficial Couture dress from ‚Äúles M√©duses‚Äù collection FW 1999-2000 #Couturissime #MuglerArchives Make Up @makeupbymario Hair @cesar4styles https://t.co/qLYuddOwgW,8892,481,2019,62585118,9373,0.01,219
1449,Ends tomorrow at 11:59pm PST at https://t.co/PoBZ3bhjs8!! https://t.co/6a4Fl2OOUQ,2608,136,2019,62585118,2744,0.0,81
1450,I can‚Äôt wait to hear what they talk about lol https://t.co/GdlafBOn1N,266091,14937,2019,62585118,281028,0.45,69
1451,üñ§üñ§üñ§ https://t.co/ReM7VNQHKp,9004,316,2019,62585118,9320,0.01,27
1452,https://t.co/PoBZ3bhjs8 https://t.co/z0SJcG88YU,2748,142,2019,62585118,2890,0.0,47
1453,https://t.co/l64NLX3pyN,13436,821,2019,62585118,14257,0.02,23
1454,2 for $24 Cr√®me Lipsticks starts now at https://t.co/PoBZ3bhjs8!!! https://t.co/tf68kcwAU0,2254,134,2019,62585118,2388,0.0,90
1455,I hope you have a magical day ‚ú® https://t.co/g2oyWbkj7d,65184,2924,2019,62585118,68108,0.11,55
1456,üíã üá´üá∑ https://t.co/iSDzlFPBYv,132642,11203,2019,62585118,143845,0.23,28
1457,An a whatta? https://t.co/Rs4dMevHOI,142819,14972,2019,62585118,157791,0.25,36
1458,I miss my babies! I took North with me to Montreal last week ‚úàÔ∏èüëó https://t.co/avqxh8NJDt,110075,5855,2019,62585118,115930,0.19,88
1459,üî• https://t.co/TPhU6Jb732,45370,2419,2019,62585118,47789,0.08,25
1460,Uncle Charlie!!!! @CharlieWilson #SundayServiceOnATuesday #Portland #Adidas https://t.co/g2kJw6Ua18,5796,546,2019,62585118,6342,0.01,99
1461,üêÜ https://t.co/ydSoodk7Xv,54655,4591,2019,62585118,59246,0.09,25
1462,You don‚Äôt understand...this is an Alaia https://t.co/jLBxHI5NeX,90762,10415,2019,62585118,101177,0.16,63
1463,We were the coolest https://t.co/L0JDN2jgUF,38353,1543,2019,62585118,39896,0.06,43
1464,üëèüèºüëèüèºüëèüèº‚ô•Ô∏è‚ô•Ô∏è‚ô•Ô∏è https://t.co/N3WDqinfHx,42857,2412,2019,62585118,45269,0.07,36
1465,https://t.co/MB2WyWK5ol,182214,32966,2019,62585118,215180,0.34,23
1466,Sunday Service @THEREALSWV https://t.co/eMaK9pW46a,22960,3921,2019,62585118,26881,0.04,50
1467,Sunday Service- Back To Life - Soul II Soul https://t.co/L9jb1z2ft0,37717,6221,2019,62585118,43938,0.07,67
1468,Squad https://t.co/RE1EDA1rAH,319822,27713,2019,62585118,347535,0.56,29
1469,https://t.co/YclB1g7Ib0,100831,4153,2019,62585118,104984,0.17,23
1470,I made it my mission to fund cases of people who are so deserving &amp; no words can describe witnessing someone set to die in prison get their life back. I‚Äôm honored to support @buriedaliveproj &amp; their life saving work!,13189,711,2019,62585118,13900,0.02,224
1471,I‚Äôm so happy &amp; proud &amp; excited! I just had the best call with my attorney @msbkb &amp; her client Eric. We just let him know he will be getting out of prison after serving 16 years of his life sentence due to the First Step Act.,30042,1712,2019,62585118,31754,0.05,236
1472,Wow!!! https://t.co/JMDEEmJkuX,27556,1310,2019,62585546,28866,0.05,30
1473,Classic Red lipstick and liner is back in stock https://t.co/aIjp1MBlpZ Body II in stock now https://t.co/eAGj098U38 https://t.co/Q8Lbfqg4W9,3283,139,2019,62585546,3422,0.01,140
1474,"The @CaliforniaDTSC @Energy @NASA promised to cleanup contaminated Santa Susana Field Lab by 2017, but the job hasn‚Äôt even begun! Time to #ReformDTSC &amp; for Feds to #KeepSSFLPromises @GavinNewsom @JaredBlumfeld @secretaryperry @realdonaldtrump this one we can all agree on!",3000,244,2019,62585546,3244,0.01,276
1475,Dreams come true!!!! You guys have no idea what today meant to me. I binge watched every single episode last year and this was surreal https://t.co/0YXmGQdmYT,20077,587,2019,62585546,20664,0.03,158
1476,I love this!!! https://t.co/2fOAFyxWZF,26772,893,2019,62585546,27665,0.04,38
1477,MUGLER https://t.co/R3wMqqIp2b,138253,10978,2019,62585546,149231,0.24,30
1478,LOOK 2 #Mugler https://t.co/imyCMiRgLN,46710,2667,2019,62585546,49377,0.08,38
1479,https://t.co/Tv9IGsiCef,115906,10046,2019,62585546,125952,0.2,23
1480,In Montreal for the Thierry Mugler Exhibition. Look 1 https://t.co/FCHxRUJ2F4,64717,4616,2019,62585546,69333,0.11,77
1481,FINAL DAY TO SHOP!!!! The #KKWBEAUTY Pop-Up closes TONIGHT at 6:30PM @southcoastplaza https://t.co/HV8RhLA4fW,11563,489,2019,62585546,12052,0.02,109
1482,..... @fleissmeister https://t.co/zftf83KYWu,138318,9268,2019,62585546,147586,0.24,44
1483,Oh really????? Wait a minute.... https://t.co/fe5xhzvMLR,47072,2322,2019,62585546,49394,0.08,56
1484,Fake fucking news big time!!!! https://t.co/sbI7JbSPpC,164802,9921,2019,62585546,174723,0.28,54
1485,It‚Äôs the final weekend to shop the @kkwbeauty Pop-Up at @southcoastplaza!!! Doors close tomorrow at 6:30PM! #KKWBEAUTY,3907,150,2019,62585546,4057,0.01,118
1486,Wait what does my mom always say? #proudmama ? That‚Äôs me today and on set of this shoot!,31338,935,2019,62585546,32273,0.05,88
1487,All she wanted was nachos on shoot day and we made that happen! Thank you @wwd for capturing these amazing memories for her üíï‚ú®,12914,364,2019,62585546,13278,0.02,126
1488,I‚Äôm seriously so proud of my Northie! She picked her looks and eyeliner color and is so involved and loves fashion &amp; beauty so much so she has the best time at her @wwd shoot! Kanye &amp; I always say she‚Äôs Kristen Crawley‚Äôs style twin üíï,40711,1289,2019,62585546,42000,0.07,241
1489,"My most stylish and beautiful baby girl North shot her 1st cover for @wwd !!!! She loves fashion &amp; beauty and has so much fun doing this!   Hair- @chrisappleton1, Eyeliner- @maryphillips, Styling- @kimkardashian üôãüèª‚Äç‚ôÄÔ∏è üì∑ @jucophoto https://t.co/YU5xh6SNHa",144142,16575,2019,62585546,160717,0.26,258
1490,Happy Birthday dad!!!!! This was my Sweet 16 and this is the moment my dad surprised me with my first car! I wish you were here so bad so we could have so many more memories! We are all missing you and celebrating you today! https://t.co/uzj9VS3FDn,211586,7338,2019,62585546,218924,0.35,248
1491,Would you prefer she lose the üí∞ too? A single mom has to work too boo! This was a professional commitment planned far in advance and you better believe she is not waiting on anyone to pay her bills or provide for her daughter. PERDIODT!!! https://t.co/FU3VorGzqx,753845,109946,2019,62585546,863791,1.38,262
1492,Carolina Lemke * Coming Soon* https://t.co/0UmoRntbQ5,47435,2176,2019,62585546,49611,0.08,53
1493,"So, as always, don‚Äôt believe everything you read and see online. I don‚Äôt have any relationships with these sites. I‚Äôm not leaking my looks to anyone, and I don‚Äôt support what these companies are doing.",17878,1290,2019,62585546,19168,0.03,201
1494,"I often plan for weeks, sometimes months, and even a year in advance, and I‚Äôm grateful for every fashion moment those designers and their dresses have helped me create.",12175,605,2019,62585546,12780,0.02,168
1495,My relationships with designers are very important to me. It's taken me over a decade to build them and I have a huge amount of respect for the amount of work that they put into bringing their ideas to life.,14283,821,2019,62585546,15104,0.02,207
1496,This is a way to get people to sign up for their mailing list and make people believe there is some kind of relationship between me and this fashion site. There is not.,8306,556,2019,62585546,8862,0.01,168
1497,"Only two days ago, I was privileged enough to wear a one-of-a-kind vintage Mugler dress and in less than 24 hours it was knocked off and thrown up on a site - but it's not for sale. You have to sign up for a waitlist because the dress hasn‚Äôt even been made to sell yet.",19729,1361,2019,62585546,21090,0.03,269
1498,"I‚Äôve watched these companies profit off my husband‚Äôs work for years and now that it‚Äôs also affecting designers who have been so generous to give me access to their beautiful works, I can no longer sit silent.",26931,1572,2019,62585546,28503,0.05,208
1499,"It‚Äôs devastating to see these fashion companies rip off designs that have taken the blood, sweat and tears of true designers who have put their all into their own original ideas.",57602,5114,2019,62585546,62716,0.1,178
1500,We lost a true legend! You were such an inspiration to the world! You shot my first fashion shoot &amp; I was so nervous to work w such an icon! The world is so much chicer because u existed! I‚Äôm beyond honored to have had the opportunity to work w u. U are so loved &amp; will be missed https://t.co/0BSXoLDNN7,36517,3185,2019,62585546,39702,0.06,311
1501,My whole heart ‚ô•Ô∏è https://t.co/70LKCvGltF,134879,6312,2019,62585546,141191,0.23,41
1502,Morning ‚ú® @kkwbeauty https://t.co/BU2hlPOVos,61223,2758,2019,62585546,63981,0.1,44
1503,‚ù§Ô∏è https://t.co/vbKhF6juhB,18382,815,2019,62585546,19197,0.03,26
1504,#Mugler https://t.co/vj65wr20d7,106081,9448,2019,62585546,115529,0.18,31
1505,You know that mood when you‚Äôre really feeling your look üôãüèª‚Äç‚ôÄÔ∏è,24127,2451,2019,62585546,26578,0.04,61
1506,Hollywood Beauty Awards with my date @ChrisAppleton1  Pics coming soon üëÄ,2570,102,2019,62585546,2672,0.0,72
1507,My girls üíï https://t.co/InT6axGCNE,376168,23311,2019,62585546,399479,0.64,34
1508,This is not true. Kanye is not involved and did not produce this song. https://t.co/Y2PcdK9uV9,7685,517,2019,62585546,8202,0.01,94
1509,I love this Ben. I just text it to Kanye üíï https://t.co/6SvV25K5rP,28551,1558,2019,62585546,30109,0.05,66
1510,‚ú® https://t.co/gy99EhGJj6,143501,8246,2019,62585546,151747,0.24,25
1511,‚ù§Ô∏è‚ù§Ô∏è‚ù§Ô∏è https://t.co/yBkfkPSscp,8317,258,2019,62585546,8575,0.01,30
1512,üíãüíãüíã https://t.co/EmOYA11Igh,4822,137,2019,62585546,4959,0.01,27
1513,üêç https://t.co/WkClWdJp0K,64408,2824,2019,62585546,67232,0.11,25
1514,Best husband award goes to mine üôãüèª‚Äç‚ôÄÔ∏è!!!! Most thoughtful gifts ever!!!! https://t.co/X3g1iwXeJE,126650,11482,2019,62585546,138132,0.22,96
1515,somewhere over the rainbow üåà https://t.co/setzbsuGgI,101661,12014,2019,62585546,113675,0.18,52
1516,NO BIG DEAL KENNY G IN MY LIVING ROOM!!! Happy Valentines Day üíãüíãüíã https://t.co/A1GD0UlEwu,557410,81014,2019,62585546,638424,1.02,89
1517,Happy Valentines Day babe!!! I love you so much! ü•∞ https://t.co/pv6UQPtJdb,142257,9844,2019,62585546,152101,0.24,74
1518,"I said you will see when I have kids, they will have the same nose as me. https://t.co/b6O327HMyq",30220,1793,2019,62585546,32013,0.05,97
1519,OMG @MakeupByMario should we never make jokes again during our Masterclass üòÇüòÇüòÇ https://t.co/kY9IeF5aoz,8997,355,2019,62585546,9352,0.01,102
1520,Used Flashing Lights Big Bank üè¶ &amp; Nude Lipstick1 with Nude LipLiner 1 https://t.co/aIjp1MBlpZ https://t.co/wmfYlGe9zi,11310,461,2019,62585546,11771,0.02,121
1521,Ohhhhh I know who this is üò± https://t.co/PLxLO842Hu,12601,503,2019,62585546,13104,0.02,51
1522,Part 3 Jesus Walks üòÇ North‚Äôs dancing https://t.co/dUjJhvI6LH,31700,3281,2019,62585546,34981,0.06,60
1523,Part 2 Jesus Walks https://t.co/hkmD8H7lYU,13994,2795,2019,62585546,16789,0.03,42
1524,Jesus Walks today at Sunday Service #CollegeDropOut15 https://t.co/pd0j01UQZc,27944,7345,2019,62585546,35289,0.06,77
1525,Thank you everyone who came out to the Masterclass with @MakeupByMario and Anastasia,6437,188,2019,62585546,6625,0.01,84
1526,So sad I missed Stormi‚Äôs bday party üò¢ It got postponed due to the rain and today I had my Masterclass,76997,2027,2019,62585546,79024,0.13,101
1527,My all time favorite lipstick my Nude 1 with Nude 1 lipliner. This nude lipstick comes in my best of nudes set as well! https://t.co/sbyklMQhdE https://t.co/tMl924PkzB,13094,731,2019,62585546,13825,0.02,167
1528,üíúüíñ https://t.co/ivnKHAUka5,11710,350,2019,62585546,12060,0.02,26
1529,I am humbled and honored to have contributed the introduction to Alice Marie Johnson‚Äôs upcoming book AFTER LIFE. Please pre-order the book today to show Alice the love and support she deserves. I love you Alice!!! https://t.co/HGbV4tExv8 https://t.co/JOlKOgCtNr,10897,956,2019,62585546,11853,0.02,261
1530,üòÇüòÇüòÇ https://t.co/pnxVAXbrUS,3005,245,2019,62585546,3250,0.01,27
1531,"Going through old fitting pics &amp; found this gold look that Kanye made for me for my Miami trip last summer (I went w the neon vibes instead) P.S. fast fashion brands, can you please wait until I wear this in real life before you knock it off?  üòÇ https://t.co/MZiGLmC0yI",87136,5569,2019,62585546,92705,0.15,273
1532,üòÇüòÇüòÇ https://t.co/EfND5UzUoD,7793,427,2019,62585546,8220,0.01,27
1533,Wore Baddie perfume all day today and felt the vibe!!!,7069,268,2019,62585546,7337,0.01,54
1534,And Yeezy Velvet Ankle Bootie shoes. $190 at https://t.co/MN89OWudON https://t.co/Vvt5WkYg8J,11156,786,2019,62585546,11942,0.02,92
1535,Glam - @MakeupByMario @ChrisAppleton1 https://t.co/XnSgRRWCaA,27719,3249,2019,62585546,30968,0.05,61
1536,Wearing Thierry Mugler https://t.co/zkMoRKHxJa,65680,6486,2019,62585546,72166,0.12,46
1537,üì∑ Erik Pendzich/Shutterstock https://t.co/JcWza9DG7A,16057,1118,2019,62585546,17175,0.03,52
1538,OMG you have to watch @jimmyfallon tonight! You have no idea what he put me through!!!!,9189,305,2019,62585546,9494,0.02,87
1539,Surprise restock just in time for Valentines Day!!! Shop #KKWFRAGRANCE Peach now at https://t.co/tbQezJs782. Limited quantities available! https://t.co/L1BXFt8Fh2,1397,102,2019,62585546,1499,0.0,162
1540,Hi https://t.co/aJL9gM8Gco,53956,3309,2019,62585546,57265,0.09,26
1541,‚ù§Ô∏èüíÑüíã https://t.co/ZA4Xba9IHP,1688,98,2019,62585546,1786,0.0,28
1542,üì∑ @SplashNews https://t.co/k445XZduJJ,17334,1231,2019,62585546,18565,0.03,37
1543,Day 1‚Äôs https://t.co/iqTiuYAA1H,55902,2627,2019,62585546,58529,0.09,31
1544,Thank you Donatella &amp; @Versace for lending me this stunning vintage gown for tonight ‚ú®,6323,228,2019,62585546,6551,0.01,90
1545,So happy to honor Mert and Marcus tonight!!!! https://t.co/UuPcpKuiag,9803,461,2019,62585546,10264,0.02,69
1546,"Btw since the paparazzi agencies won‚Äôt allow the fans to repost, all of my pics are taken by my own photog and you guys can always repost whatever you want ‚ù§Ô∏è If I ever post from an agency I will tag them and I have permission. So those please don‚Äôt repost!",42670,1564,2019,62585546,44234,0.07,257
1547,üíã https://t.co/Epg7KCDyHS,6937,581,2019,62585546,7518,0.01,25
1548,Amfar https://t.co/aWX98C670N,25421,1517,2019,62585546,26938,0.04,29
1549,She was actually sleeping like this for a good 30 minutes https://t.co/YfL5KIMSTP,189029,11129,2019,62585546,200158,0.32,81
1550,‚ù§Ô∏è‚ù§Ô∏è‚ù§Ô∏è https://t.co/7RSAlqP6eu,4013,160,2019,62585546,4173,0.01,30
1551,He‚Äôs not performing at any fashion show this season. Just a rumor https://t.co/QcnO1ObEnC,4284,229,2019,62585546,4513,0.01,89
1552,üôãüèª‚Äç‚ôÄÔ∏è https://t.co/yYr7igbWD5,5602,236,2019,62585546,5838,0.01,29
1553,So proud!!! @AliceMarieFree at the SOTU!!!! https://t.co/Sjf9qFOMU6,11027,883,2019,62585546,11910,0.02,67
1554,Classic Red bundle is SOLD OUT AGAIN!!! Shop our other available bundles NOW at https://t.co/PoBZ3bhjs8!,1661,89,2019,62585546,1750,0.0,104
1555,Red 1 Lip Liner is sold out!!!! Shop the other brand new Red Cr√®me Liners now at https://t.co/PoBZ3bhjs8,1279,74,2019,62585546,1353,0.0,104
1556,"Buy any #KKWBEAUTY Best of Red, Nude or Pink Lipstick Set and get a FREE Lip Liner of your choice. Available online now at https://t.co/PoBZ3bhjs8 and at the @southcoastplaza Pop-Up. Ends 02.06 at 11:59PM PST, while supplies last. https://t.co/RnDVQsrwnw",1077,88,2019,62585546,1165,0.0,254
1557,Red Cr√®me Liners available NOW at https://t.co/PoBZ3bhjs8 https://t.co/ABXbHyFDKG,1198,94,2019,62585546,1292,0.0,81
1558,Best of Pinks Lipstick Set available NOW at https://t.co/PoBZ3bhjs8 https://t.co/IRo5dotkvW,2304,124,2019,62585546,2428,0.0,91
1559,Best of Nudes Lipstick Set available NOW at https://t.co/PoBZ3bhjs8 https://t.co/yfEm6tEm9g,1320,85,2019,62585546,1405,0.0,91
1560,Best of Reds Lipstick Set available NOW at https://t.co/PoBZ3bhjs8 https://t.co/uf5KCVkpHG,1559,123,2019,62585546,1682,0.0,90
1561,1 hour until launch time. Obsessed w my new reds!!!! https://t.co/sbyklMQhdE https://t.co/zfpJuh05wW,4724,247,2019,62585546,4971,0.01,100
1562,Brand New Red Cr√®me Lip Liners. TODAY AT 12PM PST https://t.co/PoBZ3bhjs8 https://t.co/8tVaxf6JYG,1099,67,2019,62585546,1166,0.0,97
1563,‚ÄúBest of Nudes‚Äù Lipstick Set. TODAY AT 12PM PST https://t.co/PoBZ3bhjs8 https://t.co/zYHL88LpRN,1648,106,2019,62585546,1754,0.0,95
1564,‚ÄúBest of Pinks‚Äù Lipstick Set. TODAY AT 12PM PST https://t.co/PoBZ3bhjs8 https://t.co/LxxnuoQFen,1726,118,2019,62585546,1844,0.0,95
1565,‚ÄúBest of Reds‚Äù Lipstick Set. TODAY AT 12PM PST https://t.co/PoBZ3bhjs8 https://t.co/XT81tzGW0z,1450,119,2019,62585546,1569,0.0,94
1566,BRAND NEW @kkwbeauty Red Cr√®me Lipsticks + Liners and Best of Lipstick Sets available TODAY AT 12PM PST at https://t.co/PoBZ3bhjs8 https://t.co/StYKtfnsFW,1162,73,2019,62585546,1235,0.0,154
1567,üëèüèº  I see Alice Johnson &amp; Matthew Charles on the guest list ‚ù§Ô∏èüëèüèº https://t.co/kENJrXXksW,2405,257,2019,62585546,2662,0.0,92
1568,Wearing the new @kkwbeauty Hot Sauce Red Lip &amp; Red Lipliner 2 launching today along with the best of sets for Valentines Day!!!! https://t.co/PoBZ3bhjs8 https://t.co/2o8sffAzsu,5195,341,2019,62585546,5536,0.01,180
1569,‚ù§Ô∏è‚ù§Ô∏è‚ù§Ô∏è https://t.co/wDH1joGiO4,3451,146,2019,62585546,3597,0.01,30
1570,It‚Äôs psoriasis all over my face. üò¢ https://t.co/E94lI7mfDG,18199,682,2019,62585546,18881,0.03,58
1571,"KKW HEARTS WIFEY features notes of citrus, florals, caramel &amp; musks. Available now at https://t.co/tbQezJs782!! https://t.co/1wLGlvp8ek",1900,115,2019,62585546,2015,0.0,139
1572,"KKW HEARTS BADDIE features notes of rose, iris, geranium, musks &amp; amber. Shop now at https://t.co/tbQezJs782 https://t.co/FicBxuZxZT",1760,103,2019,62585546,1863,0.0,136
1573,LOL @ North‚Äôs bow üéÄüéÄüéÄüéÄüéÄ She is obsessed with @itsjojosiwa,11375,462,2019,62585546,11837,0.02,57
1574,"My videos of Sunday Service due it no justice of the vibe we feel in that room, but this little video shows How much North loves our Sunday mornings ‚ú®üíñ https://t.co/bhVN2x97JK",45523,5358,2019,62585546,50881,0.08,175
1575,The perfect gifts for Vday!! Shop KKW HEARTS online at https://t.co/tbQezJs782 and at the #KKWBEAUTY Pop-Up in @southcoastplaza https://t.co/tiyzpHgmLH,1758,107,2019,62585546,1865,0.0,151
1576,My 2nd Super Bowl Commercial!!!! https://t.co/HSQ95GpsK0,19624,1546,2019,62585546,21170,0.03,56
1577,My 1st Super Bowl Commercial!!!! https://t.co/uodpLCM7Of,49627,3646,2019,62585546,53273,0.09,56
1578,SAME https://t.co/8unb78l1Hq,214847,21652,2019,62585546,236499,0.38,28
1579,"The Best of Reds, Nudes &amp; Pinks Lipstick Sets are available TODAY at the #KKWBEAUTY Pop-Up in @southcoastplaza and online at https://t.co/PoBZ3bhjs8 on 02.05 at 12PM PST!!!! https://t.co/AJ2LJNcuJ6",2082,121,2019,62585546,2203,0.0,201
1580,All 6 KKW HEARTS perfumes available NOW on https://t.co/tbQezJs782 https://t.co/5qKFLsjk4g,2689,148,2019,62585546,2837,0.0,90
1581,Classic Red Lip Liners and Lipstick is all sold out!!!! We will be launching the best of reds which will include the Classic Red lipstick Feb 5 at https://t.co/aIjp1MBlpZ https://t.co/PrDN2utfKS,2015,109,2019,62585546,2124,0.0,194
1582,‚ÄúBEST OF REDS‚Äù lipstick set available TOMORROW at the @kkwbeauty Pop-Up!!!! https://t.co/4bf2qvTH09,2170,114,2019,62585546,2284,0.0,99
1583,"Shop Classic Red in the ‚ÄúBest of Reds‚Äù Lipstick Set tomorrow, 02.03 exclusively at the @kkwbeauty Pop-Up in @southcoastplaza and online on 02.05 at 12PM PST at https://t.co/PoBZ3bhjs8 üíÑ",1328,56,2019,62585546,1384,0.0,185
1584,We are SOLD OUT of the Classic Red Lipstick &amp; Red 1 Liner both online and at the @kkwbeauty Pop-Up!!!!!,3347,127,2019,62585546,3474,0.01,107
1585,Happy Birthday to the sweetest baby girl Stormi! We love you so much!!! üíï https://t.co/FRv62bEqua,231315,15228,2019,62585546,246543,0.39,97
1586,"KKW HEARTS BAE opens with notes of mandarin, jasmine and gardenia blossom with whipped vanilla &amp; velvet sandalwood to finish. Available NOW at https://t.co/tbQezJs782 #KKWHEARTS https://t.co/tfxGGCjoL0",3952,240,2019,62585546,4192,0.01,205
1587,"KKW HEARTS RIDE OR DIE features sweet top notes of black berry, juicy purple plum &amp; jasmine nectar üíú https://t.co/tbQezJs782 https://t.co/dUHIXUQqZU",4197,283,2019,62585546,4480,0.01,152
1588,The Classic Lip looks so good on you!!! üíã https://t.co/B4PsqYVOLb,6357,132,2019,62585546,6489,0.01,65
1589,"KKW HEARTS BFF has base notes of vanilla marshmallow and cedar wood while opening with wild berries, pink rose petals &amp; pear blossom. Shop now at https://t.co/tbQezJs782 https://t.co/9VtzMTAgvf",2483,176,2019,62585546,2659,0.0,197
1590,"KKW HEARTS BADDIE features top notes of rose, iris &amp; geranium and finishes with woods, musks &amp; golden amber. Available NOW at https://t.co/tbQezJs782 https://t.co/9cdnTHA0V6",2730,218,2019,62585546,2948,0.0,181
1591,A little behind the scenes at my KKW HEARTS shoot üíõ https://t.co/fCCVhfJxUS,8810,844,2019,62585546,9654,0.02,75
1592,"KKW HEARTS Bae, BFF &amp; Ride or Die available now at https://t.co/tbQezJs782 https://t.co/piL1VOMxfG",1411,104,2019,62585546,1515,0.0,102
1593,"KKW HEARTS Set of 3 featuring Wifey, Baddie &amp; Baby Girl available now at https://t.co/tbQezJs782 https://t.co/crUlnhCYty",1290,99,2019,62585546,1389,0.0,124
1594,KKW HEARTS Set of 6 available at https://t.co/tbQezJs782 https://t.co/GlOYStL8RW,1488,120,2019,62585546,1608,0.0,80
1595,We ordered 3 times the fragarances for this Valentines drop since we probably won‚Äôt be restocking it ever again and it‚Äôs selling out so fast! Thank you guys so much!!!!!!!  You will LOVE it!!!,5733,215,2019,62585546,5948,0.01,192
1596,üß°üíöüíú https://t.co/8IHi0t8VqV,1173,71,2019,62585546,1244,0.0,27
1597,You will love it üß° https://t.co/FhD5OowKtM,1112,65,2019,62585546,1177,0.0,42
1598,BADDIE https://t.co/tbQezJs782 https://t.co/KA2NXpT0Y0,7755,883,2019,62585546,8638,0.01,54
1599,Baby girl is her absolute favorite!!! https://t.co/IR9yh10UQ2,1995,86,2019,62585546,2081,0.0,61
1600,I love Baddie right now and Ride or Die! https://t.co/FRrvZG43Li,1083,57,2019,62585546,1140,0.0,64
1601,They all have different vibes so it depends on my mood! Loving Baddie right now https://t.co/jbPSxzT2Ws,1104,63,2019,62585546,1167,0.0,103
1602,Try wifey! https://t.co/ekjmjX4c5W,1073,60,2019,62585546,1133,0.0,34
1603,Love baddie!!!! https://t.co/mk0jsVlR76,933,51,2019,62585546,984,0.0,39
1604,üíõüß°üíöüíôüíúüíñ https://t.co/5zxtf6Yd53,1164,63,2019,62585546,1227,0.0,30
1605,üíúüíôüíöüíõüß°üíñ https://t.co/QbnSL2Bi8s,1039,57,2019,62585546,1096,0.0,30
1606,Which KKW HEARTS scent are you getting? Baddie? Baby Girl? Wifey? Ride or Die? BFF? Bae?,10012,317,2019,62585546,10329,0.02,88
1607,All 6 KKW HEARTS perfumes available NOW on https://t.co/tbQezJs782 https://t.co/Uj074knbGN,1227,111,2019,62585546,1338,0.0,90
1608,Launching KKW HEARTS in 10 minutes!!! I love launch days!!! https://t.co/x0WDr8PWWW,1173,90,2019,62585546,1263,0.0,83
1609,Today‚Äôs the day! The KKW HEARTS launch at noon https://t.co/tbQezJs782 https://t.co/H0jdpGEoHf,3293,228,2019,62585546,3521,0.01,94
1610,Happy Birthday @KidCudi https://t.co/rPkAvTgDLE,93077,8783,2019,62585546,101860,0.16,47
1611,KKW Hearts available now at the #KKWFRAGRANCE &amp; #KKWBEAUTY Pop-Up in @southcoastplaza!!! #KKWHEARTS https://t.co/ifGS7lhNxU,2641,153,2019,62585546,2794,0.0,127
1612,"All of the new and past KKW HEARTS perfumes are available today at the @kkwbeauty pop up shop in South Coast Plaza or online at https://t.co/eAGj098U38 tomorrow, 01.31!!! They are a limited drop! https://t.co/Us5RpN0izi",2418,152,2019,62585546,2570,0.0,219
1613,Get a Cr√®me Contour Stick of your choice + Glam Bible Highlighter + Concealer Brush II all for $42!! Available online at https://t.co/PoBZ3bhjs8 &amp; in store at the #KKWBEAUTY Pop-Up in @southcoastplaza. Ends 01.31 at 11:59PM PST https://t.co/raqGj3eGU8,2289,138,2019,62585119,2427,0.0,255
1614,adidas YEEZY Sneaker Sales Reportedly Grew 600% in Q4 2018 https://t.co/K8MHw1GSri,6227,649,2019,62585119,6876,0.01,82
1615,Had a great day at the California Capital today discussing criminal justice reform https://t.co/DvOBZSUSx2,13026,687,2019,62585119,13713,0.02,106
1616,"The perfect gifts for Valentines Day!
New Red Cr√®me Lipsticks in Hot Sauce, Candy Apple &amp; Cherry Pop AND our #KKWBEAUTY Best of Reds, Nudes &amp; Pinks Lip Sets in lucite boxes launch exclusively to the Pop-Up on 02.03 &amp; 02.05 at https://t.co/PoBZ3bhjs8 https://t.co/H0YE8LhtPR",11225,743,2019,62585119,11968,0.02,286
1617,"KKW Hearts Baby Girl -Bright citruses &amp; succulent fruits introduce a heart of plush, playful florals. Launching 01.30 exclusively at the #KKWBEAUTY Pop-Up at @southcoastplaza &amp; 01.31 online at https://t.co/tbQezJs782 #KKWHEARTS https://t.co/x1WTPTqNeX",4229,245,2019,62585119,4474,0.01,259
1618,My @kkwbeauty pop up shop!!! https://t.co/w69pf9ijND,7860,314,2019,62585119,8174,0.01,52
1619,‚ù§Ô∏è https://t.co/jh9smG0ddZ,6647,321,2019,62585119,6968,0.01,26
1620,You guys know I have been following the #KevinCooper case and tonight @CBSNews‚Äô @48Hours is having a 2-hour program from 9-11 pm eastern pacific time about his fight for justice. Check it out! It's an important story! https://t.co/MmfDEgeI5J,2327,208,2019,62585119,2535,0.0,241
1621,Best of Nude &amp; Pink Lip Sets!!! Available for $65 in the lucite box &amp; individually for $18 launching 02.03 at the #KKWBEAUTY Pop-Up and 02.05 at https://t.co/PoBZ3bhjs8 https://t.co/WjaXZlrBvJ,2336,200,2019,62585119,2536,0.0,200
1622,Wait there‚Äôs more!!!,6521,366,2019,62585119,6887,0.01,20
1623,Available in our brand new Best of Reds Lip Set for $65 &amp; individually for $18 launching 02.03 at the #KKWBEAUTY Pop-Up and 02.05 at https://t.co/PoBZ3bhjs8 https://t.co/bZpqhj3Vgq,1749,155,2019,62585119,1904,0.0,184
1624,3 BRAND NEW #KKWBEAUTY Red Cr√®me Lipsticks + Lip Liners https://t.co/64YI2XpuJP,2838,171,2019,62585119,3009,0.0,79
1625,ALSO COMING JUST IN TIME FOR VALENTINES DAY....,3734,167,2019,62585119,3901,0.01,47
1626,"#KKWHEARTS BABY GIRL

A sultry, yet flirtatious floral citrus fragrance that glimmers with a magnetic charm. Launching 01.30 at the #KKWFRAGRANCE &amp; #KKWBEAUTY Pop-Up and 01.31 at https://t.co/tbQezJs782 https://t.co/l917x75Iw5",2536,229,2019,62585119,2765,0.0,232
1627,"#KKWHEARTS BADDIE 

A dynamic, ultra-addictive and captivating floral fragrance that leaves an unforgettable impression. Launching 01.30 at the #KKWFRAGRANCE &amp; #KKWBEAUTY Pop-Up and 01.31 at https://t.co/tbQezJs782 https://t.co/j6QXz1cHNO",2625,210,2019,62585119,2835,0.0,244
1628,"#KKWHEARTS WIFEY

A delicious, floral gourmand fragrance that exudes a feminine, soft tenderness and a modern glow. Launching 01.30 at the #KKWFRAGRANCE &amp; #KKWBEAUTY Pop-Up and 01.31 at KKWFRAGRANCE.CON https://t.co/psJ2jwAeZh",3129,284,2019,62585119,3413,0.01,232
1629,"So excited to announce we are bringing BACK the original 3 @kkwfragrance #KKWHEARTS + launching 3 new heart fragrances: Wifey, Baddie &amp; Baby Girl exclusively at the Pop-Up on 01.30 and online 01.31 at https://t.co/tbQezJJIwC #KKWFRAGRANCE https://t.co/IE6m9OyeVN",5373,528,2019,62585119,5901,0.01,266
1630,Guess what we are launching just in time for Valentines Day???!!!,26390,757,2019,62585119,27147,0.04,65
1631,We also sold out of our bundles of the Classic Red lipstick and liners!!! So hurry up and get the red lipstick before it‚Äôs gone!!!!!üíãüíãüíã,4715,173,2019,62585119,4888,0.01,135
1632,OMGGGGG didnt have time to fully post yesterday but we SOOD OUT of our lip liners so fast !!!!!!!,9685,267,2019,62585119,9952,0.02,97
1633,Just wait üòú‚ú®üíï https://t.co/tmeDCvPrH5,10831,462,2019,62585119,11293,0.02,37
1634,We need to do snap chat movies  again!!!! https://t.co/pYJJoFapur,50320,4479,2019,62585119,54799,0.09,65
1635,Who get their Classic Red Lipstick and Liner bundle before we sold out!? Shop the Classic Red lipstick now for $18 at https://t.co/PoBZ3bhjs8 üíã,2206,91,2019,62585119,2297,0.0,143
1636,Our @kkwbeauty Classic Red Lipstick and Lip Liner is available NOW on https://t.co/aIjp1MBlpZ https://t.co/UXROkmTEgT,2785,147,2019,62585119,2932,0.0,117
1637,Classic Red Lipstick &amp; Red 1 Liner launch TODAY at 12PM PST at https://t.co/PoBZ3bhjs8 #KKWBEAUTY üíãüíÑ https://t.co/aflyHcPPkJ,2399,160,2019,62585119,2559,0.0,128
1638,TODAY at 12 PM PST Classic Red Lip Launches https://t.co/PoBZ3bhjs8 üíã https://t.co/7DyUO1ROW7,10300,549,2019,62585119,10849,0.02,93
1639,Wearing Peach 1 and Peach Lip Liner 1 with blush Destiny https://t.co/aIjp1MBlpZ https://t.co/aFwh4CoBSk,10294,513,2019,62585119,10807,0.02,104
1640,"Shop our first ever Classic Red Cr√®me Lipstick for $18 &amp; matching Red 1 Lip Liner for $12 exclusively at the #KKWBEAUTY Pop-Up at @southcoastplaza in Costa Mesa, open until from 10AM-9PM tonight! https://t.co/I0g4dpFC5I",2447,131,2019,62585119,2578,0.0,223
1641,Thanks @alexwangny for the drip ‚úåüèº https://t.co/Ip0b1vlGc5,75214,4553,2019,62585119,79767,0.13,58
1642,"Classic Red Cr√®me Lipstick + Red 1 Lip Liner launches TOMORROW, 01.23 exclusively to the #KKWBEAUTY Pop-Up in @southcoastplaza &amp; online at https://t.co/PoBZ3bhjs8 on 01.25 at 12PM PST üíãüíÑ
üì∏ by @GregSwalesart https://t.co/AfWbzk1y5N",4424,204,2019,62585119,4628,0.01,235
1643,I actually remember this day. I was staying with my grandma &amp; grandpa in San Diego and she got me this dress from her kids clothing store and we had to stop and take a picture because that‚Äôs what grand parents do ü§ó‚ù§Ô∏èüì∑ https://t.co/EJMfI3sGMT,40074,1058,2019,62585119,41132,0.07,245
1644,üë∏üèª https://t.co/Np8ZqhwT9y,24014,1385,2019,62585119,25399,0.04,26
1645,Here‚Äôs a snippet #SundayService #RealLove https://t.co/1O3Qwmo1eb,9376,1000,2019,62585119,10376,0.02,65
1646,The Sunday Service was so beautiful yesterday. I forgot to post about it but just uploaded some videos on my IG stories üíé‚ú®,8558,270,2019,62585119,8828,0.01,122
1647,Obsessed with this new red lip üíãüíãüíã get ready to shop the @kkwbeauty Classic Red Lip this Friday!!!! https://t.co/sbyklMQhdE https://t.co/ALsgQNWI2G,5061,236,2019,62585119,5297,0.01,147
1648,"20% off the @kkwbeauty Glam Bible bundle ends tomorrow, 01.21 at 11:59PM PST!! Available at the #KKWBEAUTY Pop-Up in @southcoastplaza &amp; online at https://t.co/PoBZ3bhjs8 while supplies last!!! https://t.co/18B340cT6c",2697,125,2019,62585119,2822,0.0,220
1649,You guys have no idea how much that call means to me!!!!! 112 is my favorite group! I literally almost cried! Kourtney and Khloe completely feel me. They love 112 too üíïüíïüíï,34921,1173,2019,62585119,36094,0.06,170
1650,Ummmm so this happened tonight!!!! #112 https://t.co/zOZEgGPJRl,140352,15229,2019,62585119,155581,0.25,63
1651,"20% OFF on the @kkwbeauty Glam Bible Smokey Volume I Bundle starts NOW online at https://t.co/PoBZ3bhjs8 and at our Pop-Up in @southcoastplaza. Sale ends 01.21 at 11:59PM PST, while supplies last #KKWBEAUTY https://t.co/Qst6EYZKmZ",2276,129,2019,62585119,2405,0.0,230
1652,SHOP ALL BODY SCENTS NOW https://t.co/tbQezJs782 https://t.co/yCO1gTGMaF,11012,475,2019,62585119,11487,0.02,72
1653,Classic Red Lip üíã Dropping online Jan 25 https://t.co/PoBZ3bhjs8 https://t.co/59s1wgDOwI,20906,1069,2019,62585119,21975,0.04,88
1654,üíé VERSACE FITTINGS üíé https://t.co/pcf9UALyZ7,108832,6152,2019,62585119,114984,0.18,44
1655,Our 1st ever Classic Red Creme Lipstick &amp; Red 1 Lip Liner are true red shades that pair beautifully together while adding shape &amp; dimension to the lips. Launching exclusively to the #KKWBEAUTY Pop-Up on 01.23 @southcoastplaza &amp; online at https://t.co/PoBZ3bhjs8 on 01.25 at 12PM https://t.co/T5TCFY30zX,10873,596,2019,62585119,11469,0.02,314
1656,üíéüí∞üí°üîå https://t.co/5s7y1Dy9Fp,10286,517,2019,62585119,10803,0.02,28
1657,üòú https://t.co/K4V7OmZOnz,16281,751,2019,62585119,17032,0.03,25
1658,Happy Birthday to my baby Chi!!!! The sweetest baby in the whole world! Mommy and Daddy love you so much! https://t.co/aXrYOKEQ3w,196658,9366,2019,62585119,206024,0.33,129
1659,Thanks boo! https://t.co/y2Y82mbUkx,3892,122,2019,62585119,4014,0.01,35
1660,Reflective booties they turn light with flash https://t.co/SfS4jwzMYr,2921,84,2019,62585119,3005,0.0,69
1661,Yes https://t.co/xa0FpnheBy,1839,81,2019,62585119,1920,0.0,27
1662,Just found this fitting pic from Halloween https://t.co/xqpSqw4wVa,96435,6381,2019,62585119,102816,0.16,66
1663,WWHL https://t.co/4IeczKdbOa,14472,710,2019,62585119,15182,0.02,28
1664,Tune-in to @BravoTV tonight at 11! I‚Äôll be on @BravoWWHL with @Andy! https://t.co/HWMmjVTfs5,2993,190,2019,62585119,3183,0.01,92
1665,Shout out to Northie!!! ü•∞ü•∞ü•∞ @Caiden817 https://t.co/gp9LjggMtU,7797,436,2019,62585119,8233,0.01,62
1666,"I want to make it very clear, he is not condoning anyone‚Äôs actions or unacceptable disgusting behavior. My husband‚Äôs words are being taken out of context due to timing.",31950,1589,2019,62585119,33539,0.05,168
1667,"I‚Äôm going to nip this in the bud right now. Kanye was speaking about his own experience of everyone quick to say they are cancelling him because of differences in opinion &amp; not being perfect. The analogies were in context to his own experiences, not defending anyone else.",22969,1361,2019,62585119,24330,0.04,276
1668,BB Kiki https://t.co/tpul346YAf,56156,1897,2019,62585119,58053,0.09,31
1669,Same!!! That‚Äôs why We are excited to do this like the good old days! https://t.co/MzxJeebc6X,4563,171,2019,62585119,4734,0.01,92
1670,Get ready!!! https://t.co/m7sP6GcM8q,6304,242,2019,62585119,6546,0.01,36
1671,Casino Royale! Happy Birthday John!!!! https://t.co/vviB3BUCb7,183884,13098,2019,62585119,196982,0.31,62
1672,Shop now at https://t.co/PoBZ3bhjs8 and get free shipping on domestic orders over $75 and international orders over $100! Ends TONIGHT at 11:59PM PST!! #KKWBEAUTY @kkwbeauty https://t.co/pWYEALc3xz,3370,169,2019,62585119,3539,0.01,197
1673,SHOP NOW at https://t.co/PoBZ3bhjs8 #KKWBEAUTY https://t.co/1Vmm14sguU,1580,103,2019,62585119,1683,0.0,70
1674,new grillz https://t.co/m4gbVQalt4,94432,8640,2019,62585119,103072,0.16,34
1675,"Have the best story about this look! I had a Barbie deal &amp; she was going 2 wear this exact look! Then the deal got cancelled, the Kim K Barbie would no longer B produced. Kanye knew how sad I was, called Mattel &amp; made all my dreams come true by having my prototype made just 4 me! https://t.co/F1r2Ai8WWC",61750,3610,2019,62585119,65360,0.1,312
1676,üíï https://t.co/BwUMyrywIh,26179,939,2019,62585119,27118,0.04,25
1677,God Bless you Matthew!!!! https://t.co/3csWFou0zK,3891,132,2019,62585119,4023,0.01,49
1678,North in my closet ‚ú® https://t.co/kAarAobhsP,80936,4126,2019,62585119,85062,0.14,44
1679,üíï https://t.co/nPCXMPr7Nx,40011,2623,2019,62585119,42634,0.07,25
1680,Every time we are on vacay we always say we‚Äôre gonna do one and then we get lazy https://t.co/zBYKVLHzv1,29303,1264,2019,62585119,30567,0.05,104
1681,So proud of @fitgurlmel!! Watch her tonight on #TitanGames on @nbc https://t.co/M8LGNECbs3,2312,158,2019,62585119,2470,0.0,90
1682,YEEZY https://t.co/xbaeBtHgI7,4489,194,2019,62585119,4683,0.01,29
1683,Nope! I was wearing hot pink https://t.co/0VyTRX0xKS,3126,111,2019,62585119,3237,0.01,52
1684,Big Facts https://t.co/pdzafw47LI,2298,95,2019,62585119,2393,0.0,33
1685,I was there! üôãüèª‚Äç‚ôÄÔ∏è https://t.co/JdvWS0QDHj,12218,656,2019,62585119,12874,0.02,42
1686,Yes! I learned in high school and had to do it twice! https://t.co/cmgOl06ikC,15657,591,2019,62585119,16248,0.03,77
1687,P.S. I still have this sweatsuit and this bag üíï https://t.co/8tSLlb0UwE,58935,2700,2019,62585119,61635,0.1,71
1688,Fun Fact- in this pic I was on my way to meet Kanye for his Good Life performance for the MTV Awards. I didn‚Äôt really know him but his people called my people lol &amp; I was a girl in the audience at the live performance in Vegas. I met his mom Donda this same night üíï https://t.co/8tSLlb0UwE,105461,7499,2019,62585119,112960,0.18,293
1689,Coming soon... https://t.co/rrxN4B4Vj1,71617,4088,2019,62585119,75705,0.12,38
1690,Oh wait I kept one for myself and extras for the future lol https://t.co/7631Vwuhol,54693,3060,2019,62585119,57753,0.09,83
1691,Happy Birthday Hali!!!! @KimKanyeKimYeFC You really are the best and most loyal and we so appreciate you!,6829,217,2019,62585119,7046,0.01,105
1692,üëèüèºüëèüèºüëèüèº Thank you Governor Haslam  üëèüèºüëèüèºüëèüèº https://t.co/rAiru84fgn,34660,3717,2019,62585119,38377,0.06,64
1693,üíï https://t.co/mgxvzTDlIT,13769,510,2019,62585119,14279,0.02,25
1694,Just hearing music as our Sunday Service was super inspiring. See you next Sunday ‚ú®,13848,527,2019,62585119,14375,0.02,83
1695,Our new Sunday Service is starting. Check out the rehearsals on my Instagram stories ‚ú®,12307,523,2019,62585119,12830,0.02,86
1696,I literally can‚Äôt live without my Cr√®me Contour and Highlight! Available at https://t.co/PoBZ3bhjs8 and at the #KKWBEAUTY Pop-Up in @southcoastplaza https://t.co/KQUryHqzOD,7992,287,2019,62585119,8279,0.01,172
1697,üëèüèºüëèüèºüëèüèº https://t.co/6RbeL2oNLr,43934,2731,2019,62585119,46665,0.07,30
1698,üíï https://t.co/HHQ4gQwSA8,9879,274,2019,62585119,10153,0.02,25
1699,Just got word that Matthew Charles will be coming home within 24 hours. Thank you @realDonaldTrump for signing the 1st step act. This is what true bipartisanship can accomplish. https://t.co/9EnwDSksfw,11959,1772,2019,62585119,13731,0.02,201
1700,Wow this is sooooo amazing!!!!!! Thank you for this!!!! https://t.co/Ge3qSmxnnA,22544,1197,2019,62585119,23741,0.04,79
1701,https://t.co/MmynHploJm,46522,4660,2019,62585119,51182,0.08,23
1702,Ready to serve some looks in 2019 https://t.co/0ih76F0MCc,48471,2453,2019,62585119,50924,0.08,57
1703,Watching BirdBox. I really like it. Who has seen it?,173427,7165,2019,62585119,180592,0.29,52
1704,The best!!! https://t.co/LsKZdFp8BO,216608,13755,2019,62585119,230363,0.37,35
1705,"#FlashingLights Loose Pigment in GUAP ‚ú® Get 20% off the entire collection and up to 60% off other select items during our extended After Christmas Sale ending tomorrow, 01.01 at 11:59PM PST #KKWBEAUTY https://t.co/mddo7t7Nym",3709,160,2019,62585119,3869,0.01,224
1706,"#FlashingLights ‚ö°Ô∏è Get 20% off the entire collection and up to 60% off other select items during the @kkwbeauty  extended After Christmas Sale ending tomorrow, 01.01 at 11:59PM PST #KKWBEAUTY https://t.co/RwHaa1RWbZ",3709,173,2019,62585119,3882,0.01,215
1707,My fave heels ever! All I wear! https://t.co/N196dYcpaW,6350,302,2018,62585119,6652,0.01,55
1708,Happy New Year from @parishilton and I üòç‚ú®üòú https://t.co/MOBVDEFa1H,95741,6926,2018,62585119,102667,0.16,66
1709,üò± https://t.co/5U86VOVa5m,18826,704,2018,62585119,19530,0.03,25
1710,2018 https://t.co/vEzvc9vZly,44740,3499,2018,62585119,48239,0.08,28
1711,More Xmas Eve Pix https://t.co/ErJpa0ZeLU,54311,2575,2018,62585119,56886,0.09,41
1712,Ok we got it! So fun!,12127,468,2018,62585119,12595,0.02,21
1713,We just can‚Äôt connect our Netflix to an interactive system. We aren‚Äôt giving up though...,16775,498,2018,62585119,17273,0.03,89
1714,It‚Äôs taken us like 30mins to figure out how to watch this Black Mirror Bandersnatch Film. I hope it‚Äôs good,45818,1888,2018,62585119,47706,0.08,106
1715,üòú https://t.co/WgzWdomDZg,49138,2310,2018,62585119,51448,0.08,25
1716,"Online at https://t.co/tbQezJs782 and in store at the #KKWBEAUTY &amp; #KKWFRAGRANCE Pop-Up in @southcoastplaza, open until 9PM tonight!! https://t.co/IjxjUkCP8Q",1538,85,2018,62585119,1623,0.0,161
1717,"Online at https://t.co/PoBZ3bhjs8 and in store at the #KKWBEAUTY Pop-Up in @southcoastplaza, open until 9PM tonight!! https://t.co/YozfM95TaR",2880,134,2018,62585119,3014,0.0,141
1718,She picked it though! It‚Äôs a special occasion! https://t.co/dGIEjr7yAN,4832,141,2018,62585119,4973,0.01,70
1719,It just might be a new Classic Red Lip I have launch VERY soon üíã https://t.co/159rpXMUxp,10120,324,2018,62585119,10444,0.02,88
1720,‚ú® end of night mood ‚ú® https://t.co/TWcUFOx3sg,59112,3747,2018,62585119,62859,0.1,45
1721,‚ùÑÔ∏è  Christmas 2018 ‚ùÑÔ∏è https://t.co/4l1LjzKaYv,197274,18447,2018,62585119,215721,0.34,45
1722,Merry Christmas üéÑ https://t.co/SQRHMpVrzq,242206,32607,2018,62585119,274813,0.44,41
1723,‚ùÑÔ∏è https://t.co/wR5tSmOU1i,76314,4409,2018,62585119,80723,0.13,26
1724,My 2 faves!!! https://t.co/0LfMVk5koZ,3194,141,2018,62585119,3335,0.01,37
1725,Just saw the press release from Governor Brown regarding Kevin Cooper! Such amazing news! https://t.co/GUVIgcQYDq,2395,153,2018,62585119,2548,0.0,113
1726,Kardashian West Jenner Christmas Eve Party starts soon ‚ùÑÔ∏è‚ùÑÔ∏è‚ùÑÔ∏è #NorthPole #WinterWonderland https://t.co/O2efL6KlVf,18270,1280,2018,62585119,19550,0.03,114
1727,Sledding Tonight in a gownüôãüèª‚Äç‚ôÄÔ∏è https://t.co/Q6P6enAiBU,46072,2353,2018,62585119,48425,0.08,55
1728,Christmas Eve party preview ‚ùÑÔ∏è https://t.co/1hMrlBgiJ9,25848,1636,2018,62585119,27484,0.04,54
1729,"CHRISTMAS 2018. 
üì∏ pierresnaps https://t.co/TmwGeKS6QR",115537,12503,2018,62585119,128040,0.2,55
1730,Santa was my daddy here ‚ù§Ô∏è https://t.co/OcpcLJumZY,13651,437,2018,62585119,14088,0.02,50
1731,I wanna post what my backyard and whole house looks like but don‚Äôt want to ruin it for everyone coming! What should I do? Maybe post right before everyone comes?,63461,1367,2018,62585119,64828,0.1,161
1732,Kendall and my mom rushed to a meeting after this shoot so this is what we have! As many of us as possible! From our family to yours Merry Christmas,19119,638,2018,62585119,19757,0.03,148
1733,"This year we waited until the last minute to do a card. Schedules we‚Äôre changing, my husband was in and out of town. But The day of this card last minute realized we were all together so we had all of our kids come meet us.",15254,512,2018,62585119,15766,0.03,223
1734,I think the time has come I start a medication for psoriasis. I‚Äôve never seen it like this before and I can‚Äôt even cover it at this point. It‚Äôs taken over my body. Has anyone tried a medication for psoriasis &amp; what kind works best? Need help ASAP!!!,35427,1509,2018,62585119,36936,0.06,253
1735,Celebrate the holidays with me in Kim Kardashian: Hollywood!https://t.co/YqSNsLCmSS https://t.co/66BysIYIHm,3104,185,2018,62585119,3289,0.01,107
1736,Today is launch day! So proud of @khloekardashian &amp; @forevermalika hav ether BECCABFF‚ÄôS collection out at Ulta store and https://t.co/8VTN5bXiZt SHOP IT NOW! So proud of you guys! I‚Äôm obsessed with everything https://t.co/rlBCNNIg16,3270,191,2018,62585119,3461,0.01,236
1737,I LOVE this shoot @kegrand Steven Klein https://t.co/dOVs0LzVio,15041,1311,2018,62585119,16352,0.03,63
1738,Scoop https://t.co/qWjuwyJfFl,29260,3095,2018,62585119,32355,0.05,29
1739,Wait until you see our Christmas decor. I‚Äôm gonna wait until Christmas Eve to show you guys! It‚Äôs sooooo good!!!,39958,1056,2018,62585119,41014,0.07,112
1740,Sisters have you seen the make up challenge so did with @jamescharles doing half of my face &amp; @makeupbymario doing the other half??? Ugh. The stress! LOL be sure to watch this video on James YouTube Channel https://t.co/hBmkxWWUoo,28117,1181,2018,62585119,29298,0.05,234
1741,Obsessed with my Glam Bible! Shop it now at https://t.co/sbyklMQhdE https://t.co/YKzUYijfc9,3888,240,2018,62585119,4128,0.01,91
1742,These are my fave 350‚Äôs üò±üòç https://t.co/ZpspsLEilA,29199,1829,2018,62585119,31028,0.05,50
1743,https://t.co/yKBpVRpuAX,3624,345,2018,62585119,3969,0.01,23
1744,I hope you have the best birthday üíã https://t.co/DiwTU7faTi,3479,117,2018,62585119,3596,0.01,59
1745,Congrats Ellen! Can‚Äôt wait to watch this!!!! https://t.co/7RLoClQHYl,21041,945,2018,62585119,21986,0.04,68
1746,Me &amp; my bff! ü•∞ North came to visit me on set &amp; said momma can we do a photo shoot together just me &amp; you! I followed her poses &amp; direction so here it is! I always dreamed of having a baby girl &amp; she‚Äôs perfect! https://t.co/qyNG6wmjQZ,256165,22642,2018,62585119,278807,0.45,253
1747,Baby K https://t.co/3ide8U9gLV,80113,2767,2018,62585119,82880,0.13,30
1748,Watch the Beauty Battle I did with @jamescharles and @MakeupByMario!! https://t.co/FmCRSnpwt9,16481,779,2018,62585119,17260,0.03,93
1749,My two nephews born on the same day!!!! Mason &amp; Reign I love you to the moon and back! Watching you grow up has been the best journey ever! Can‚Äôt wait to celebrate with you guys! https://t.co/jl0PkdgbPl,57223,1891,2018,62585119,59114,0.09,206
1750,"My husband is the most brilliant person, the most genius person that I know. He has broken so many boundaries, everything from music, stage design, fashion and culture and will continue to change the world.",155842,14374,2018,62585119,170216,0.27,206
1751,Thank you @wwd for Product of the Year award for @KKWFRAGRANCE!!! #KKWFRAGRANCE #beautyincawards https://t.co/7wjKOy0f4M,2668,134,2018,62585119,2802,0.0,120
1752,Ok I have al of my sisters and my mom on set! I‚Äôm trying to surprise them with a Christmas Card shoot but just thought of this idea and Kanye is out of town! üò≠ What do I do????,45057,1133,2018,62585120,46190,0.07,176
1753,Damn sis!!!!!!!! Get it giiiiirrrrrrrlllllllll https://t.co/o1qtAvcIBg,82279,4393,2018,62585120,86672,0.14,70
1754,Thank you @wwd for this great honor!!!!! PRODUCT OF THE YEAR for @KKWFRAGRANCE https://t.co/ei81443ZJT,3772,185,2018,62585120,3957,0.01,102
1755,Who has gone to my @kkwbeauty pop up shop? Be sure to check it out at @southcoastplaza in Costa Mesa https://t.co/Pni9sRPzcf,2308,105,2018,62585120,2413,0.0,124
1756,"Shop @kkwbeauty &amp; @KKWFRAGRANCE today to get your products before the holiday!! Last day to order to receive by Christmas is TOMORROW, December 13th only at https://t.co/PoBZ3bhjs8 and https://t.co/tbQezJs782 https://t.co/67GKTjBD9H",1665,98,2018,62585120,1763,0.0,236
1757,ü•∞ü•∞ü•∞ https://t.co/1mxUCE9x8m,7538,344,2018,62585120,7882,0.01,27
1758,Queen üëë Carine @CRFASHIONBOOK https://t.co/1yy6DKgOyz,5437,224,2018,62585120,5661,0.01,53
1759,Date night seeing Cher is always a good idea! https://t.co/RojDttUFRW,56490,4571,2018,62585120,61061,0.1,69
1760,ü•∞ü•∞ü•∞ https://t.co/iKziqPmXnz,2706,137,2018,62585120,2843,0.0,27
1761,üî•üî•üî•ü•∞ü•∞ü•∞ https://t.co/A1alR1qwSR,3442,121,2018,62585120,3563,0.01,30
1762,"Selected Participants will be notified by phone or email TOMORROW, 12.12.18 that they have been selected to participate in the Event. Each Selected Participant will be allowed to bring ONE guest to the Event. Good Luck!! #KKWBeautyPopUp",2167,119,2018,62585120,2286,0.0,236
1763,"LAST DAY TO ENTER!  
50 participants will be selected at random to attend a private event hosted by me on December 17th at @southcoastplaza. 
TODAY is the last day to enter to submit an entry in person with our store staff! No purchase necessary. #KKWBeautyPopUp https://t.co/uUYWr74VY7",1441,90,2018,62585120,1531,0.0,288
1764,Celebrating Saint with a Tarzan themed party üçÉ https://t.co/qCjkdJaK4Z,117644,10449,2018,62585120,128093,0.2,70
1765,Where‚Äôs my car at?!?! https://t.co/WKufmWFHTH,31514,2347,2018,62585120,33861,0.05,45
1766,VERSACE NIGHT IV https://t.co/v2doyEaEyG,173160,24550,2018,62585120,197710,0.32,40
1767,VERSACE NIGHTS III https://t.co/YcIgrPXhXi,15551,1676,2018,62585120,17227,0.03,42
1768,VERSACE NIGHTS II https://t.co/7zRaA2BDdD,10979,701,2018,62585120,11680,0.02,41
1769,VERSACE NIGHTS https://t.co/5X9N0nutF6,34824,3319,2018,62585120,38143,0.06,38
1770,Awww I‚Äôm not crying YOU are! Lol https://t.co/YGl4xC7Eah,4760,180,2018,62585120,4940,0.01,56
1771,Awww thank you Myleeza!!!! ü•∞ü•∞ü•∞ https://t.co/2XPAu2P2zo,1000,48,2018,62585120,1048,0.0,54
1772,Now let‚Äôs watch Busy Tonight and live tweet! @BusyPhilipps,1117,60,2018,62585120,1177,0.0,58
1773,The music in the finale üéº #Reborn #KSG,1645,146,2018,62585120,1791,0.0,38
1774,ü•∞ https://t.co/WOshTUI3sh,733,39,2018,62585120,772,0.0,25
1775,Absolutely!!! https://t.co/IAyDdNUo5F,11065,449,2018,62585120,11514,0.02,37
1776,ü•∞ https://t.co/29b4AkJSNF,875,58,2018,62585120,933,0.0,25
1777,This call makes me cry every time I see it. @MakeupByMario filmed this on his cell phone. I‚Äôm so glad we captured these moments,1892,92,2018,62585120,1984,0.0,127
1778,Thank you ü•∞ https://t.co/qNGdQC4mbw,893,53,2018,62585120,946,0.0,35
1779,ü•∞ https://t.co/UWRquUffVw,771,43,2018,62585120,814,0.0,25
1780,Thank you üòç https://t.co/XNn9rum3td,578,32,2018,62585120,610,0.0,35
1781,Always üíØ https://t.co/yllwPBtZ8E,8559,324,2018,62585120,8883,0.01,32
1782,i pray you have a better week https://t.co/fBnRVg4jN1,1246,58,2018,62585120,1304,0.0,53
1783,‚úÖ https://t.co/sBqibrINxd,647,38,2018,62585120,685,0.0,25
1784,ü•∞ https://t.co/uvpWncAfAb,2069,109,2018,62585120,2178,0.0,25
1785,Facts! https://t.co/akBQNWblJN,1036,58,2018,62585120,1094,0.0,30
1786,I know I‚Äôm late! How‚Äôs the finale of KUWTK so far???,10246,305,2018,62585120,10551,0.02,52
1787,TONIGHT OUR SEASON FINALE OF KEEPING UP WITH THE KARDASHIANS ON E! https://t.co/ke8A9eMEeP,12963,847,2018,62585120,13810,0.02,90
1788,üòçüòç show us your pics from the pop up by tagging @kkwbeauty &amp; #KKWBEAUTYPopUp and geotagging @southcoastplaza!! https://t.co/3b16SVc4tM,3129,108,2018,62585120,3237,0.01,138
1789,Don‚Äôt miss out!! Final hours to get FREE SHIPPING on domestic orders over $50! Ends tonight at 11:59PM PST only at https://t.co/PoBZ3bhjs8 #KKWBEAUTY https://t.co/7RCRVNAnJQ,1425,72,2018,62585120,1497,0.0,173
1790,üòç https://t.co/XtixO95RA2,2786,114,2018,62585120,2900,0.0,25
1791,"Only a few days left to enter!!! 50 participants will be selected at random to attend a private event hosted by me on 12.17 at @southcoastplaza. To enter, visit our #KKWBEAUTY Pop-Up until 12/11 to submit an entry in person with our store staff. No purchase necessary! https://t.co/jMMJVvhZnb",1331,74,2018,62585120,1405,0.0,292
1792,Congrats!!!! Can I get a copy? https://t.co/8fBeKRKqpv,102791,5901,2018,62585120,108692,0.17,54
1793,TODAY ONLY! Shop @kkwbeauty and get FREE SHIPPING on domestic orders over $50!! Online only at https://t.co/PoBZ3bhjs8 ending tonight at 11:59PM PST. You don‚Äôt want to miss this!! https://t.co/V5wT5TAqGN,1570,88,2018,62585120,1658,0.0,203
1794,My @kkwbeauty pop up is here!!!! This is such a dream come true! Please go check it out at @southcoastplaza in Costa Mesa! We have all of my make up and fragrance. We worked so hard on this store and it‚Äôs visually everything I dreamed it would be! https://t.co/HgMJx73oOT,5646,345,2018,62585120,5991,0.01,271
1795,The best!!!! https://t.co/vSCV0fh58m,9053,616,2018,62585120,9669,0.02,36
1796,Shop your favs today at the  @kkwbeauty &amp; @KKWFRAGRANCE Pop-Up in @southcoastplaza!! Show us your experience in the store by tagging #KKWBEAUTYPopUp and geotagging South Coast Plaza! So excited to see your pics!!! https://t.co/qTS7P5zyey,2100,132,2018,62585120,2232,0.0,241
1797,https://t.co/PoBZ3bhjs8 https://t.co/WklWJybTKg,1205,62,2018,62585120,1267,0.0,47
1798,Congrats babe on your 69th Grammy nomination!!!!!! #ProducerOfTheYear @kanyewest,63791,5055,2018,62585120,68846,0.11,80
1799,üö®üòçüî•ü•∞ https://t.co/YcvP0pxveV,12243,799,2018,62585120,13042,0.02,28
1800,Yesss!!!! Congrats babe!!! ü•∞üéºüíØ https://t.co/VHDoUNH5v5,3375,204,2018,62585120,3579,0.01,54
1801,Beyond excited to announce that I‚Äôm adding the #RobertoCavalliSS19 collection in my game. Their V1PER sneaker is making its exclusive debut in Kim Kardashian: Hollywood!: https://t.co/FLuYkaqJtT https://t.co/4pMWnV4UCX,1970,124,2018,62585120,2094,0.0,218
1802,We weren‚Äôt even filming our show at this time but when I got the call I asked Mario to film it on his iphone. These raw moments really are so special. https://t.co/kb7eVGlfu6,6131,375,2018,62585120,6506,0.01,174
1803,‚ù§Ô∏è‚ù§Ô∏è‚ù§Ô∏è https://t.co/cqJFrVlVBJ,2789,132,2018,62585120,2921,0.0,30
1804,This Sunday is our finale and it‚Äôs really so emotional. I cry every time I watch this clip https://t.co/KCSOqFIMmg,7721,503,2018,62585120,8224,0.01,114
1805,"Very calm except for when she wants food lol She LOVES food! She has the best personality, so easy and chill https://t.co/CJTGtQ2YiX",8642,321,2018,62585120,8963,0.01,132
1806,Cutie ü•∞ https://t.co/ltviPNIV0l,48948,2257,2018,62585120,51205,0.08,31
1807,I still gotta wear this black though https://t.co/Zd7OhdSL7F,10131,345,2018,62585120,10476,0.02,60
1808,ü•∞ https://t.co/dNMgS1LWaq,2435,78,2018,62585120,2513,0.0,25
1809,"I hate that I am bringing attention to this but this is absolutely disgusting that you would find this funny to mess with Travis &amp; Kylie who just started a family together. This is really damaging to relationships, families and is just so wrong! https://t.co/KtodBpmiHR",210587,32847,2018,62585120,243434,0.39,273
1810,"I‚Äôm in a huge meeting and my mom just said ‚Äúthank you,next‚Äù to everyone. She‚Äôs really milking this guys üòÇ",547880,50847,2018,62585120,598727,0.96,105
1811,Happy Birthday to my favorite boy my Sainty Joon. I must have done something really special to deserve having you as my son. I love you to the galaxy and back. https://t.co/bA7s2Bfewj,152315,8423,2018,62585120,160738,0.26,183
1812,Studio Time https://t.co/33SDZkusQ4,42255,2191,2018,62585120,44446,0.07,35
1813,üíï https://t.co/SeKN4ORlLE,1357,62,2018,62585120,1419,0.0,25
1814,Thank you!!! We worked really hard at this store! https://t.co/NOAvm3KIIL,1848,61,2018,62585120,1909,0.0,73
1815,The Cher Show was sooooo good! I learned so much about her that I didn‚Äôt know. She really opened up about her life and all of the actors were sooo good! You all have to check it when in NYC. We had the best time! ‚ú®,6275,256,2018,62585120,6531,0.01,214
1816,Yes all perfumes will be there! https://t.co/PqYsFttfC9,1363,59,2018,62585120,1422,0.0,55
1817,I may even try to stop by the pop-up today to see some of you there...üëÄ @southcoastplaza #kkwbeauty #KKWFRAGRANCE #costamesa,1443,85,2018,62585120,1528,0.0,124
1818,üö® First Look Alert üö® The @KKWBEAUTY @KKWFRAGRANCE Pop-Up at @southcoastplaza opens TODAY at 12:30PM. I can‚Äôt wait for u to experience the store &amp; all of the surprises exclusive to this location!Don‚Äôt forget to share w me your pics by tagging me &amp; our brand accounts when u visit https://t.co/FP4rRqzaUb,5570,444,2018,62585120,6014,0.01,310
1819,The #KKWBEAUTY &amp; #KKWFRAGRANCE Pop-Up opens tomorrow at 12:30PM! Find out how you can enter to win an invite to a private event with me @southcoastplaza on December 17th: https://t.co/oldJToCO1o https://t.co/1VKrlCdMtt,2538,142,2018,62585120,2680,0.0,222
1820,Day 3 of 12 Days of #KKWBEAUTY Christmas! Pick any two #FlashingLights product for only $25! Ends TONIGHT at 11:59PM PST only at https://t.co/PoBZ3bhjs8 https://t.co/dO6pWnjQ2e,1885,117,2018,62585120,2002,0.0,176
1821,üòç https://t.co/ZHc87nvNwl,70639,5487,2018,62585120,76126,0.12,25
1822,https://t.co/PoBZ3bhjs8 https://t.co/URk69xh3Ch,1514,88,2018,62585120,1602,0.0,47
1823,üíï @NaomiCampbell is forever my inspo üíï,7037,543,2018,62585120,7580,0.01,38
1824,Get the @kkwbeauty #UltralighttBeams Duos for only $25 until tonight at 11:59PM PST at https://t.co/PoBZ3bhjs8 #KKWBEAUTY https://t.co/dB7ULG20ga,1734,90,2018,62585120,1824,0.0,145
1825,.@JessyMichele of @cut_50 is amazing. Her leadership to help pass the #FirstStepAct isn't about politics ‚Äì it's personal. And this would be a HUGE win for our justice system at large. #PassFirstStep https://t.co/MRzJXebVTj,1211,122,2018,62585120,1333,0.0,222
1826,The @kkwfragrance Crystal Gardenia Trio Gift Sets feature all 3 signature scents in travel size 10mL bottles for only $35!! Available now https://t.co/tbQezJs782 https://t.co/t5d1sP8Z4F,2906,157,2018,62585120,3063,0.0,185
1827,Shop the brand new Crystal Gardenia Trio Gift Sets now at https://t.co/tbQezJs782!#KKWFRAGRANCE https://t.co/mXMsFpGN3o,894,53,2018,62585120,947,0.0,119
1828,Brand new @KKWFRAGRANCE Crystal Gardenia Trio Gift Sets just in time for the holidays! The Gift Set comprises all 3 signature scents in travel size 10mL bottles for only $35- the perfect stocking stuffer or great for traveling! Available today at 12PM PST https://t.co/AGqG9P75Ou,1486,104,2018,62585120,1590,0.0,279
1829,Tokyo with @takashipom https://t.co/d0YcVT26WU,15368,893,2018,62585120,16261,0.03,46
1830,If you are able to help the family would be so grateful!  https://t.co/10E2wSIlzM,3560,371,2018,62585120,3931,0.01,81
1831,Yessss baby!!! üî•üî•üî• https://t.co/Kw17iTRwO4,18445,2325,2018,62585120,20770,0.03,42
1832,Wearing TWINNING from my KKW X KYLIE collab available NOW sat https://t.co/aIjp1MBlpZ https://t.co/82uiagmIXL,4866,323,2018,62585120,5189,0.01,109
1833,Celebrate the holidays with me TONIGHT during ‚ÄúA Legendary Christmas with John and Chrissy‚Äù at 10/9c after #RockCenterXmas on @NBC. #ALegendaryChristmas https://t.co/9U1VtamiTd,4889,269,2018,62585120,5158,0.01,176
1834,Fittings.... https://t.co/NSTNnzlE7o,88030,5755,2018,62585120,93785,0.15,36
1835,TOKYO w @takashipom https://t.co/xQFnUclSMl,21888,1468,2018,62585120,23356,0.04,43
1836,20 minutes left! Shop our @kkwbeauty &amp; @KKWFRAGRANCE #CyberMonday sales both ending TODAY at 12PM PST! You don‚Äôt want to miss this!! https://t.co/0cqb269CiN,2085,122,2018,62585120,2207,0.0,160
1837,Beyond https://t.co/8wUxqXtolI,235501,35974,2018,62585120,271475,0.43,30
1838,"I already have my plans for November 28 - join me by watching ""A Legendary Christmas with John and Chrissy"" at 10/9c on @nbc #ALegendaryChristmas https://t.co/hrHLVb1mYw",9230,748,2018,62585120,9978,0.02,169
1839,Thankful our babies are besties üëØ https://t.co/dO2p91AsMZ,110804,4680,2018,62585120,115484,0.18,57
1840,"#KKWXKYLIE round 2 includes two matte liquid lipsticks, one velvet liquid lipstick and a gloss topper, for $42. Available now at https://t.co/PoBZ3bhjs8 #KKWBEAUTY https://t.co/OaUGbLiPPe",1459,72,2018,62585120,1531,0.0,187
1841,20% off site wide ends tomorrow at 12PM PST!! https://t.co/tbQezJs782 https://t.co/5zqRDv1Lkq,745,44,2018,62585120,789,0.0,93
1842,One day left! Shop now!!! https://t.co/PoBZ3bhjs8 https://t.co/zbvu4xgzY0,1868,94,2018,62585120,1962,0.0,73
1843,üëºüèº https://t.co/SZJXpcRe1g,20423,841,2018,62585120,21264,0.03,26
1844,"Shop the @kkwfragrance #CyberMonday sale now! Get 20% off site wide at https://t.co/tbQezJs782. Sale ends Tuesday, 11.27 at 12PM PST https://t.co/mFeJgh6SYq",1127,64,2018,62585120,1191,0.0,156
1845,"Shop the @kkwbeauty #CyberMonday sale now! Get 30% off site wide at https://t.co/PoBZ3bhjs8. Sale ends Tuesday, 11.27 at 12PM PST https://t.co/qT9mn5jz13",1134,70,2018,62585120,1204,0.0,153
1846,#KKWFRAGRANCE is available in all @ultabeauty stores nationwide TODAY! #KKWFragranceUltaBeauty https://t.co/Ew6ZHTPwxK,2969,177,2018,62585120,3146,0.01,118
1847,"Only a few hours left to shop our #BlackFriday sale to buy your #KKWBEAUTY favs 30-50% off and our holiday must have #GlamBible Smokey Volume I. Choose #Afterpay at checkout to purchase for 4 easy, equal payments. Our sale ends tonight at 11:59pm PST at https://t.co/PoBZ3byUQI https://t.co/vW9wwHmSLC",2364,152,2018,62585120,2516,0.0,301
1848,https://t.co/tbQezJJIwC https://t.co/29FBzvsxY6,1805,98,2018,62585120,1903,0.0,47
1849,We added #AfterPay to our sites to make purchasing easier! Choose AfterPay at checkout to purchase your #BlackFriday favs and the Must Have #GlamBible in 4 easy payments. Our 30-50% off site wide #KKWBeauty sale and 30% off site wide #KKWFragrance sale ends tonight at 11:59pm PST https://t.co/fflclDEx5m,1418,92,2018,62585120,1510,0.0,304
1850,üòç https://t.co/0L28jFzwst,80021,2712,2018,62585120,82733,0.13,25
1851,üòç https://t.co/PcwlxrNAnF,5293,131,2018,62585120,5424,0.01,25
1852,üíï https://t.co/XFtAFE1dPY,1671,53,2018,62585120,1724,0.0,25
1853,"SOUL SISTER, DOUBLE TROUBLE, TWINNING, MAIN BAE
Shop the brand new #KKWXKYLIE Lip Sets at https://t.co/CIEp69AbyG https://t.co/EekpVoFAej",1598,94,2018,62585120,1692,0.0,138
1854,"Shop the @kkwbeauty Glam Bible Smokey Volume I + Tools &amp; Accessories now AND get 30-50% off site wide during the #BlackFriday sale, some exclusions apply. You also don‚Äôt want to miss @KKWFRAGRANCE‚Äôs 30% off site wide sale. Both end tomorrow at 11:59PM PST #KKWBEAUTY #KKWFRAGRANCE https://t.co/X8rpo6Sfp5",1472,91,2018,62585120,1563,0.0,308
1855,‚ù§Ô∏è https://t.co/QFPXMHHYaF,1299,47,2018,62585120,1346,0.0,26
1856,https://t.co/4CipIjiElC,38427,3323,2018,62585120,41750,0.07,23
1857,https://t.co/aKPYBAPL43,9562,750,2018,62585120,10312,0.02,23
1858,Dream with the finishing touches https://t.co/7AP4zUTY33,14390,960,2018,62585120,15350,0.02,56
1859,Final Look #GlamBibleSnokeyVolume1 https://t.co/l17agExevt,20247,1770,2018,62585120,22017,0.04,58
1860,https://t.co/RAsXf4FtXg,8205,883,2018,62585120,9088,0.01,23
1861,https://t.co/JC0GqHNtBc,333726,60264,2018,62585120,393990,0.63,23
1862,https://t.co/CEIJZCMQkq,9877,1031,2018,62585120,10908,0.02,23
1863,https://t.co/RPj7KjAFav,20049,1753,2018,62585120,21802,0.03,23
1864,https://t.co/NDUulGEkEx,14774,1339,2018,62585120,16113,0.03,23
1865,https://t.co/sbyklMQhdE https://t.co/ESCa83kFcs,3119,233,2018,62585120,3352,0.01,47
1866,So humble though.... https://t.co/WXjiwGNutr,127507,14806,2018,62585120,142313,0.23,44
1867,Tutorial with make up artist North West https://t.co/ggdwe1wsXC,9167,755,2018,62585120,9922,0.02,63
1868,Glam Bible Palette- The 6 pan eyeshadow palette for the ultimate smokey eye is sold for $30 on https://t.co/sbyklMQhdE. I have this small palette in my purse and make up bag because it‚Äôs so small and has the most perfect shadows! https://t.co/TCUznoC75C,896,52,2018,62585120,948,0.0,253
1869,I LOVE THE GLAM BIBLE whole look!! This lip liner and highlighter are my fave üòçIt‚Äôs all available NOW on https://t.co/aIjp1MBlpZ https://t.co/xLuHLnhWyX,2317,154,2018,62585120,2471,0.0,152
1870,Yessssss https://t.co/9FyEMNRh4I,11255,410,2018,62585120,11665,0.02,32
1871,üíã https://t.co/5zi0EKAKo7,1031,55,2018,62585120,1086,0.0,25
1872,"SURPRISE RESTOCK! Crystal Gardenia Oud is back by popular demand! Shop now while they last + get 30% off during our #BlackFriday Sale. You also don‚Äôt want to miss @kkwbeauty 30-50% off site wide sale. Both end tomorrow, 11.24 at 11:59PM PST #KKWFRAGRANCE #KKWBEAUTY https://t.co/ID0E39bqE9",1043,76,2018,62585120,1119,0.0,289
1873,The #KKWBEAUTY Glam Bible Smokey Volume I + Cosmetics Bag and Tools launch TODAY at 12PM PST only at https://t.co/PoBZ3byUQI!! https://t.co/Mxg6J5ZFu7,1854,146,2018,62585120,2000,0.0,150
1874,One day left to shop the @kkwbeauty Black Friday Sale! Get 30-50% off site wide only at https://t.co/PoBZ3byUQI. Sale ends tomorrow at 12PM PST #KKWBEAUTY https://t.co/nLtiEct9Tx,919,71,2018,62585120,990,0.0,178
1875,"#KKWBODY II &amp; III RESTOCK + BLACK FRIDAY SALE! 
Shop now and get 30% off all #KKWFRAGRANCE site wide. Discount Applied on Site, no promo code needed. Sale ends Saturday, 11.24 at 11:59PM PST only on https://t.co/tbQezJJIwC https://t.co/izYJYaTUiE",1216,96,2018,62585120,1312,0.0,251
1876,I‚Äôm so thankful that Ms. Alice Johnson gets to enjoy Thanksgiving this year with her family: God is so good üôèüèº https://t.co/VsJh96VMY2,19987,916,2018,62585120,20903,0.03,134
1877,".@kkwbeauty Black Friday Sale!
Shop now and get 30% - 50% off site wide. Excludes new Glam Bible collection, cosmetic bag and tools. Discount applied on site, no promo code needed. Sale ends Saturday at 11:59PM PST only on https://t.co/PoBZ3byUQI https://t.co/EaVSFUUwII",1206,84,2018,62585120,1290,0.0,271
1878,I‚Äôm thankful for the glow up https://t.co/zDuN0S6lco,63064,3192,2018,62585120,66256,0.11,52
1879,https://t.co/PoBZ3byUQI https://t.co/EG6ya3Epai,2828,168,2018,62585120,2996,0.0,47
1880,Shop the @KKWFRAGRANCE Black Friday Sale &amp; #KKWBODY II &amp; III restock starting tomorrow at 6pm! https://t.co/dzJnMm4mPX,1288,87,2018,62585120,1375,0.0,126
1881,Shop the #KKWBEAUTY Black Friday Sale starting tomorrow at 6PM PST!! https://t.co/PoBZ3byUQI https://t.co/MEkQUvMhGa,1530,86,2018,62585120,1616,0.0,116
1882,Tune in today at 3pm to watch me on @TheEllenShow!!! https://t.co/6DDfQ2qMkQ,19352,1353,2018,62585120,20705,0.03,76
1883,"An intense black, the first ever #KKWBEAUTY Mascara instantly defines and creates fuller and thicker lashes with just one coat. Available for purchase individually for $18 or in the Glam Bible Smokey Volume I for $150 this Friday, 11.23 at 12PM PST only at https://t.co/PoBZ3bhjs8 https://t.co/oBqpFgYriR",1904,101,2018,62585120,2005,0.0,304
1884,"Funny when I look through my phone and find old fitting pics, sometimes the fittings look better then the actual final look üò± lol https://t.co/vM08RiDkWu",27915,1167,2018,62585120,29082,0.05,153
1885,Interview glam using the new @kkwbeauty glam bible launching Black Friday!!! LOVE the lip liner and lipstick from this collection (Classic Icon I &amp; Classic Icon Liner) https://t.co/PoBZ3bhjs8 https://t.co/pBiUfeNJ60,3999,225,2018,62585120,4224,0.01,219
1886,Good luck! I hope you get the jobs! https://t.co/WXZ0KVAept,72100,4779,2018,62585120,76879,0.12,59
1887,Wow reading my mind https://t.co/yE0lRfNx1a,7705,237,2018,62585120,7942,0.01,43
1888,I just witnessed the best funniest thing OF ALL TIME OMG @ArianaGrande üòÇ,66997,3287,2018,62585120,70284,0.11,72
1889,KKW X KYLIE COMING NOV 23 https://t.co/1C8ZYQeeDG https://t.co/qzZ0K4Ushr,11160,679,2018,62585120,11839,0.02,73
1890,https://t.co/RmGzERzQ2y,1477,101,2018,62585120,1578,0.0,23
1891,"Me too, thanks True for working it out perfectly for me üòâ https://t.co/YUY6GEHAOj",4379,129,2018,62585120,4508,0.01,81
1892,Very true. You can‚Äôt ever judge and you always have to live your life for YOU no one else https://t.co/HqsmR6MqPn,5323,350,2018,62585120,5673,0.01,113
1893,BIG FACTS https://t.co/K6H36whJPP,8189,352,2018,62585120,8541,0.01,33
1894,üî• https://t.co/5sKE3Xm8pw,31133,2263,2018,62585120,33396,0.05,25
1895,‚ù§Ô∏è https://t.co/Kkyq7jKhCW,3190,140,2018,62585120,3330,0.01,26
1896,All profits from sales of the YEEZY Calabasas Track Pant in the U.S. will be donated to @calfund and @CAFireFound. Available 11.17 on https://t.co/9zYEr9ekT9 and https://t.co/mgkyP5ZbnF,5313,640,2018,62585120,5953,0.01,185
1897,FAMILY https://t.co/WGd7GLbPfa,94852,5449,2018,62585120,100301,0.16,30
1898,KKW X KYLIE 2 COMING TO https://t.co/mhjyqMy1Gp BLACK FRIDAY https://t.co/SIFSrgYJGg,32363,2513,2018,62585120,34876,0.06,84
1899,üëèüèºüëèüèºüëèüèº https://t.co/hAGrua2pci,3502,195,2018,62585120,3697,0.01,30
1900,Thank you ü§ó https://t.co/umZ73EnOmn,2078,89,2018,62585120,2167,0.0,35
1901,"Shocked &amp; furious to learn smoke from the #WoolseyFire started at former nuclear testing site, Santa Susana Field Lab, &amp; is potentially radioactive.  Sign now to demand that incoming governor @GavinNewsom gets this site cleaned up: https://t.co/3t11HgQbOK",3193,644,2018,62585120,3837,0.01,263
1902,"Shout out to Laura, the Art Director of the #KimKardashianGame! Such a role model for other women interested in the games industry #SheTalksGames https://t.co/VoAkfUzaV5",1082,87,2018,62585120,1169,0.0,169
1903,üôèüèº https://t.co/oLk86ta686,1459,87,2018,62585120,1546,0.0,26
1904,üò±üî•üî•üî•üî•üò± https://t.co/81NQjcUucj,7239,256,2018,62585120,7495,0.01,30
1905,üëèüèºüëèüèºüëèüèº https://t.co/uUwSPVdN2l,8809,997,2018,62585120,9806,0.02,30
1906,I love this look @makeupbymario did using the Glam Bible Smokey Vol 1. This palette really is perfection for a Smokey eye look! I love these lashes &amp; liner! The lip is a new nude that is a bit more mauve than what I have in our nudes collection!  https://t.co/sbyklMQhdE Nov 23 https://t.co/Q8LUyw4vxN,4082,228,2018,62585120,4310,0.01,305
1907,All of the products come in the glam bible book that everyone can order! No specific press boxes https://t.co/6HOQUi6crz,2441,85,2018,62585120,2526,0.0,120
1908,The @kkwbeauty Glam Bible is launching Nov 23. I know you guys are gonna love this! https://t.co/sbyklMQhdE https://t.co/sukGZ79C7R,7900,417,2018,62585120,8317,0.01,131
1909,"The @kkwbeauty Glam Bible (Smokey Volume 1) includes a 6 pan shadow, mascara, lashes, blush, highlighter, two lipsticks, lipgloss, lip liner and eye liner for $150 üò±üíãFriday 11.23 at 12pm PST https://t.co/aIjp1MBlpZ https://t.co/rP9Srt1Vxj",2868,166,2018,62585120,3034,0.0,238
1910,"SO EXCITED TO ANNOUNCE MY @kkwbeauty HOLIDAY COLLECTION!!! KKW Beauty Glam Bible (Smokey Volume I) Featuring the ultimate glam essentials for a complete smokey look I swear by! Coming to https://t.co/PoBZ3bhjs8 on Friday, 11.23 at 12PM PST #KKWBEAUTY https://t.co/xQnKpLOa6H",6030,415,2018,62585120,6445,0.01,274
1911,"My boo üòçüòçüòç Nicki Minaj mentions 'Kim Kardashian's a**' at People's Choice Awards
 https://t.co/pmgVxOefxb",30240,3058,2018,62585120,33298,0.05,106
1912,"My baby Dream, Happy Birthday! We‚Äôve come a long way since this pic lol! I love our snuggles. Saint loves you so much &amp; so do I!!!! https://t.co/pxAiU8RGFy",69363,2516,2018,62585120,71879,0.11,159
1913,Grateful for the heroic @CAFirefighters battling the #CampFire #HillFire and #WoolseyFire and getting people to safety. Join me and my family in donating to the @CAfirefound to support our heroes and their families. Go to https://t.co/R67fNxEVOg,5925,530,2018,62585120,6455,0.01,245
1914,This is beautiful https://t.co/pRbe4Njq5x,23610,1030,2018,62585120,24640,0.04,41
1915,Trying to get my mind off of this fire and snuggling with my niece. We are all safe and that‚Äôs all that matters https://t.co/RPPBTsKNd6,72020,2462,2018,62585120,74482,0.12,135
1916,"Fire Fighters, I love you and thank you for doing all that you can to keep us safe!",114065,6076,2018,62585120,120141,0.19,83
1917,"I heard the flames have hit our property at our home in Hidden Hills but now are more contained and have stopped at the moment. It doesn‚Äôt seems like it is getting worse right now, I just pray the winds are in our favor. God is good. I‚Äôm just praying everyone is safe üôèüèº",82360,3667,2018,62585120,86027,0.14,270
1918,üôèüèºüôèüèºüôèüèº https://t.co/zzejJnE0x6,13213,514,2018,62585120,13727,0.02,30
1919,üíî https://t.co/uc926ggsFw,40164,5718,2018,62585120,45882,0.07,25
1920,My babies https://t.co/CBJpug2grz,161569,11717,2018,62585120,173286,0.28,33
1921,So excited! @KKWFRAGRANCE is coming to @ultabeauty this holiday season! My fragrances launch in all stores across the country on Sunday 11/25! #KKWFragranceUltaBeauty https://t.co/pkKXy85UTh,4633,349,2018,62585120,4982,0.01,190
1922,I voted today for my baby right here and his future!!! https://t.co/OYtRx6cAdT,125094,6067,2018,62585120,131161,0.21,78
1923,‚úÖ https://t.co/loM87xqt5G,59369,2209,2018,62585120,61578,0.1,25
1924,BODY II &amp; BODY III are sold out!!! Go to https://t.co/eAGj098U38 and sign up for restock news! BODY I is still available! https://t.co/P7HdbAwiGD,2217,113,2018,62585120,2330,0.0,149
1925,üñ§üñ§üñ§ https://t.co/dNTTd9JHdf,10279,416,2018,62585120,10695,0.02,27
1926,"Happy Birthday to the best mom in the entire world! What would I do without you!?!My rock, my everything! I‚Äôm just so grateful for everything you do for us! You really are the best support system and friend anyone could ask for! I love you so much forever!!! https://t.co/w8e0x2sdbP",61192,2775,2018,62585120,63967,0.1,282
1927,#KKWBODY II is SOLD OUT! Limited quantities of #KKWBODY III are available now!!! Shop now at https://t.co/tbQezJs782 https://t.co/79X4HW4EUP,1531,82,2018,62585120,1613,0.0,140
1928,Tonight is a really tough episode. I saw what Khlo√© wrote and I will let her really speak on it. We have always been open and honest so tonight was just as real as it gets. #KUWTK https://t.co/qmpXx3EuR2,13818,776,2018,62585120,14594,0.02,203
1929,"Thank u, next üñ§ @ArianaGrande üî•üî•üî•",96441,9698,2018,62585120,106139,0.17,33
1930,Gucci #TomFord https://t.co/RYH24ISncg,58652,4875,2018,62585120,63527,0.1,38
1931,LACMA sister night https://t.co/bXSINR5d76,18474,1142,2018,62585120,19616,0.03,42
1932,üñ§ https://t.co/WUVtNm3VNf,68110,5055,2018,62585120,73165,0.12,25
1933,üòÇ I literally cry when I watch this. It‚Äôs so good https://t.co/I6GsO6Xw2a,157510,15087,2018,62585120,172597,0.28,73
1934,Saw the Grinch today with the Fam! The kids loved it! https://t.co/fy1TXG4mb7,12924,454,2018,62585120,13378,0.02,77
1935,Happy Birthday @kendalljenner I‚Äôve never met a sweeter or prettier human being and someone who has so much fun in life! I hope you get everything you‚Äôve ever dreamed of for your birthday because you deserve it! I‚Äôm so happy you are my sister. I love you https://t.co/krlKnG9cIN,75138,4704,2018,62585120,79842,0.13,277
1936,Baby Party üíï https://t.co/gRO9Pthn0V,101197,7270,2018,62585120,108467,0.17,36
1937,üòÇüòÇüòÇ https://t.co/tKmrMYNv7e,82002,10593,2018,62585120,92595,0.15,27
1938,üòÇüêòüêòüêòüêòüêò https://t.co/QMPt9sborW,43823,2464,2018,62585120,46287,0.07,30
1939,SHOP #KKWBODY II &amp; III NOW at https://t.co/tbQezJs782 #KKWFRAGRANCE https://t.co/CswFxc7srp,2110,140,2018,62585120,2250,0.0,95
1940,"#KKWBODY III (unisex) is a modern, woody floral with notes of lavender, cedarwood, sandalwood, vetiver &amp; vanilla. Available TODAY 12PM PST at https://t.co/tbQezJs782!! https://t.co/lGAo6QhZfd",1354,96,2018,62585120,1450,0.0,195
1941,"#KKWBODY II is a sparkling, beachy floral with notes of bergamot, neroli, creamy coconut milk and musk. Available TODAY at 12PM PST!!! https://t.co/YimjB2U7X4",964,61,2018,62585120,1025,0.0,158
1942,#KKWBODY II &amp; III launch TODAY at 12PM PST at https://t.co/tbQezJs782 #KKWFRAGRANCE @KKWFRAGRANCE https://t.co/TkISOEylDL,1217,88,2018,62585120,1305,0.0,125
1943,I love you my sisters. Forever my angels. https://t.co/ySrRX9DJ8y,117715,16442,2018,62585120,134157,0.21,65
1944,https://t.co/QFW8Kylpxg,12216,693,2018,62585120,12909,0.02,23
1945,Guess who https://t.co/LRD9BN2M6K,55791,3672,2018,62585120,59463,0.1,33
1946,So I‚Äôm almost done getting ready. Last year my fave look was Sonny and Cher. So Jonathan &amp; I are a duo again. Can you guys guess who we are tonight?,11784,285,2018,62585120,12069,0.02,152
1947,Sparkling &amp; Still https://t.co/UvJJXkpUN7,128764,13580,2018,62585120,142344,0.23,45
1948,üòÇ https://t.co/yM27Mxhr8t,43308,3133,2018,62585120,46441,0.07,25
1949,Ye &amp; Lil Pump https://t.co/ZtIfr4Z514,239436,35872,2018,62585120,275308,0.44,41
1950,Wait until you see Saint and Reign‚Äôs Halloween costume‚Äôs,14424,433,2018,62585120,14857,0.02,56
1951,üôãüèª‚Äç‚ôÄÔ∏è https://t.co/btcGp1Bchw,4946,219,2018,62585120,5165,0.01,29
1952,I‚Äôm going to post some videos on my ig stories from the other night with all of my sister angels,10027,278,2018,62585120,10305,0.02,96
1953,Thank you @VictoriasSecret for sending us actual runway looks and real wings to borrow for the night!!! OMG a dream come true! Got to be a Victoria Secret Angel for the night! &amp; Kendall got good practice lol https://t.co/fkDf46eqaD,141386,12239,2018,62585120,153625,0.25,235
1954,I was traveling this year from Africa to Bali and didn‚Äôt have a lot of time to do multiple Halloween looks but I LOVE our Victoria‚Äôs Secret Angels and I have one more iconic one coming tonight üíã,6626,339,2018,62585120,6965,0.01,194
1955,BUY ONE GET ONE FREE on my creme eyeshadow sticks! Today only! https://t.co/FylpdBOcFi #HappyHalloween https://t.co/4LQYTCt9A2,1128,66,2018,62585120,1194,0.0,126
1956,Flashing Nights Collection- Burgundy Freaky &amp; Fire https://t.co/FsvhIerHFs https://t.co/Ia9uoonf9s,4890,314,2018,62585120,5204,0.01,102
1957,‚ú® https://t.co/mgcVOBj27E,22059,1369,2018,62585120,23428,0.04,25
1958,Few hours left!!! Shop the Halloween BOGO sale now at https://t.co/PoBZ3bhjs8 #KKWBEAUTY https://t.co/Ks3tJtYlQH,843,43,2018,62585120,886,0.0,112
1959,Trick or Treat! Don‚Äôt worry I will post Halloween pics tonight. Still into some Bali vibes https://t.co/XhFlsA6fNE,14892,775,2018,62585120,15667,0.03,114
1960,I lied. She really is the most interesting to look at... @kourtneykardash https://t.co/JkAsZ6YyB4,71017,6065,2018,62585120,77082,0.12,97
1961,My little pumpkin üéÉ https://t.co/hDUifmSOBO,117429,7258,2018,62585120,124687,0.2,43
1962,Found this pic from Bali that @MarcusHyde took https://t.co/hmjnylUDjR,18706,884,2018,62585120,19590,0.03,70
1963,Last night at the Gift of Life Gala wearing @Versace Glam by @MakeupByMario @ChrisAppleton1 @TomBachik I‚Äôm wearing @kkwbeauty Flashing Lights burgundy shadows in Freaky and Fire! https://t.co/zRxvmFjwbD,7723,694,2018,62585120,8417,0.01,202
1964,"Last night I was honored to trecieve the Gift Of Life Impact Award and am so grateful to play a part in matching recipients and saving lives! I urge everyone to go to https://t.co/6RQJh5M48M and swab. I did it for my cousin CiCi it‚Äôs so easy!
@giftoflifemarrowregistry
#Swab2Save https://t.co/v8NkEZktQ8",5507,422,2018,62585120,5929,0.01,305
1965,"JOIN THE TEAM! We are hiring for the #KKWBEAUTY Pop-Up at @southcoastplaza. Come apply TODAY, 10.30 from 12-5PM at The Westin South Coast Plaza. For more information go to:  
https://t.co/6gP1BEYblK https://t.co/JyXsdyv8tk",2589,164,2018,62585120,2753,0.0,223
1966,Please pray for my friend @MarcusHyde https://t.co/QIctCk8uhv,4704,378,2018,62585120,5082,0.01,61
1967,I loved my glam this night. @makeupbymario @michaelsilvahair https://t.co/wuQSnmTdY8,24342,1328,2018,62585120,25670,0.04,84
1968,Watch the full episodes &amp; more at https://t.co/HMG1Wp4dJY #youareenough #yourvotecounts #bewoke.vote  #empoweryourself https://t.co/iZoqO6Gvi9,3038,241,2018,62585120,3279,0.01,146
1969,Please check out exclusive interviews now on https://t.co/HMG1Wp4dJY site! Everyone needs to get out &amp; vote now!  #youareenough #yourvotecounts #bewoke.vote  #empoweryourself https://t.co/ci5Zt3XPhy,4140,420,2018,62585120,4560,0.01,202
1970,I recently partnered with an organization called https://t.co/HMG1Wp4dJY with @VanJones68 @RobertFsmithJr and @dtfilmtohoop to encourage the nation to take a stand and Vote!! https://t.co/wsA25BSrNN,1813,185,2018,62585120,1998,0.0,198
1971,"#KKWBODY III (UNISEX) is a modern, woody floral opening with Pink &amp; Black Pepper and finishes with layers of creamy Sandalwood, luxe Cedarwood, Vetiver &amp; Vanilla.",3889,231,2018,62585120,4120,0.01,170
1972,"#KKWBODY II is a sparkling, beachy floral opening with notes of Bergamot, Mandarin &amp; Neroli and finishes with a rich Musk &amp; creamy Coconut Milk, wrapping your skin in a golden warmth.",1408,78,2018,62585120,1486,0.0,191
1973,"So excited to announce the launch of TWO NEW Body fragrances to add to your collection this Friday 11.02 at 12PM PST at https://t.co/tbQezJs782

 #KKWFRAGRANCE https://t.co/ARrijcCtX9",1397,118,2018,62585120,1515,0.0,185
1974,üòÑ https://t.co/dUDuHPVhXM,58445,3020,2018,62585120,61465,0.1,25
1975,üíï https://t.co/IyA02RFUR7,1174,50,2018,62585120,1224,0.0,25
1976,On our show tonight I met with the March For Our Lives kids and learned so much from them! I will be voting Nov 6th to do my part in charging gun laws! I didn‚Äôt know much about midterms until I met with them &amp; now want to spread the word! We can change these laws if we vote!,10711,670,2018,62585120,11381,0.02,279
1977,üíï https://t.co/40V0I2EmJT,1289,68,2018,62585120,1357,0.0,25
1978,Hi! https://t.co/E9AVMVBmRT,863,44,2018,62585120,907,0.0,27
1979,‚ù§Ô∏è https://t.co/MaCcLqcwkB,2932,119,2018,62585120,3051,0.0,26
1980,How pretty is @khloekardashian ‚Äòs baby shower!!,12883,353,2018,62585120,13236,0.02,47
1981,#KUWTK is on now! Tune into E!,1294,88,2018,62585120,1382,0.0,30
1982,We took North to the March for Our lives march. Watch tonight at 9/8c on E! #KUWTK https://t.co/ymoKwhGyEd,2685,196,2018,62585120,2881,0.0,106
1983,Tonight on Keeping Up with the Kardashians @kuwtk https://t.co/o88WjmInGr,4092,246,2018,62585120,4338,0.01,73
1984,"11.02.18 #KKWBODY
@KKWFRAGRANCE https://t.co/dQ9mQgiGsl",7111,369,2018,62585120,7480,0.01,56
1985,11.02.18 #KKWBODY @KKWFRAGRANCE https://t.co/hjJq3NWNv4,4105,241,2018,62585120,4346,0.01,55
1986,11.02.18 #KKWBODY @KKWFRAGRANCE https://t.co/y11AcVrPjO,3795,219,2018,62585120,4014,0.01,55
1987,Soooo good https://t.co/HPgxDWvnPD,3188,118,2018,62585120,3306,0.01,34
1988,Besties in Bali https://t.co/isSrDabqwF,176808,13808,2018,62585120,190616,0.3,39
1989,11.02.18 #KKWBODY @KKWFRAGRANCE https://t.co/zt7TV2PQo3,3690,194,2018,62585120,3884,0.01,55
1990,11.02.18 #KKWBODY @KKWFRAGRANCE https://t.co/8QhZMaxPRX,7343,433,2018,62585120,7776,0.01,55
1991,11.02.18 #KKWBODY @KKWFRAGRANCE https://t.co/KUVQUDKYSy,2810,140,2018,62585120,2950,0.0,55
1992,Bali üíïüå¥ https://t.co/yNLe0EqscY,70215,5020,2018,62585120,75235,0.12,31
1993,https://t.co/6OoPdh4QAF https://t.co/KHD4e8xNOc,4028,221,2018,62585120,4249,0.01,47
1994,Kim Kardashian KKW Body Photos Show Cellulite &amp; Scars https://t.co/3ZgK6KVm8C,2234,137,2018,62585120,2371,0.0,81
1995,Kim Kardashian Is Launching a New Fragrance with a Body-Positive Message https://t.co/L8idYp80FB,2220,136,2018,62585120,2356,0.0,96
1996,11.02.18 #KKWBODY @KKWFRAGRANCE https://t.co/vKVlCBjIk6,3406,200,2018,62585120,3606,0.01,55
1997,#KKWBODY https://t.co/E1suNaYSfo,10041,562,2018,62585120,10603,0.02,32
1998,#KKWBODY https://t.co/KljWpSk2PJ,6021,407,2018,62585120,6428,0.01,32
1999,#KKWBODY https://t.co/4wfJC1aqYH,13717,1034,2018,62585120,14751,0.02,32
2000,My heavenly baby! Showing off the new pink shadows in the Flashy Lights Collection wearing Flashy and High Key available at https://t.co/rrbYqyUk4d üì∏ @david_lachapelle @samvissermakeup @chrisappleton1 https://t.co/HzyLL7gNaN,14353,1360,2018,62585120,15713,0.03,224
2001,My cutie üí•‚ö°Ô∏èüí• https://t.co/UPgiCh6bzn,164604,6928,2018,62585120,171532,0.27,37
2002,üì∏ @david_lachapelle for @kkwbeauty wearing GOLD Big Bank &amp; Rollie available now at https://t.co/aIjp1MBlpZ https://t.co/IPXcfefpHU,4252,265,2018,62585120,4517,0.01,134
2003,#TransRightsAreHumanRights https://t.co/juiAvdQSfo,52072,9173,2018,62585120,61245,0.1,50
2004,Just catching up on birthday wishes! I‚Äôm so lucky I love you all so much!!!!,18686,760,2018,62585120,19446,0.03,76
2005,Love you! https://t.co/MZTI0e5jvr,13411,657,2018,62585120,14068,0.02,33
2006,‚ù§Ô∏è https://t.co/DyKuoMeOkz,2225,86,2018,62585120,2311,0.0,26
2007,THANK YOU ‚ú®‚ú®‚ú® https://t.co/401iTAZHfa,2948,137,2018,62585120,3085,0.0,37
2008,‚ú® https://t.co/E6LVQcWiBA,1567,74,2018,62585120,1641,0.0,25
2009,I love you @cicibussey forever https://t.co/G2CgOfEjOC,5669,306,2018,62585120,5975,0.01,54
2010,üîÆ https://t.co/2Qo79yKhqg,2972,154,2018,62585120,3126,0.0,25
2011,‚ù§Ô∏è https://t.co/BrcoaKKCJj,6033,266,2018,62585120,6299,0.01,26
2012,Only 90 mins left to shop my birthday sale! 20% off my makeup essentials at https://t.co/PoBZ3bhjs8 https://t.co/iThwLdMgz6,3201,168,2018,62585120,3369,0.01,123
2013,Watch me on #TheAlecBaldwinShow Tonight at 10|9c on ABC @AlecBaldwinShow https://t.co/9ZwxBys8Bs,5007,367,2018,62585120,5374,0.01,96
2014,Another amazing shot by @david_lachapelle wearing the colors Bands and Guap available now on https://t.co/FsvhIerHFs https://t.co/4L9Y7FcwxQ,4403,261,2018,62585120,4664,0.01,140
2015,Watch me on #TheAlecBaldwinShow Sunday at 10|9c on ABC @AlecBaldwinShow https://t.co/VtSw7QLU1a,1987,142,2018,62585120,2129,0.0,95
2016,Happy Halloween https://t.co/6AA7BCoJr6,31006,1890,2018,62585120,32896,0.05,39
2017,üòÇ https://t.co/ZOWx6D5xrG,65112,7694,2018,62585120,72806,0.12,25
2018,Tune in tomorrow night to see my interview with Alec https://t.co/l6v1D0NQ11,1395,80,2018,62585120,1475,0.0,76
2019,Shop now!! Get 20% off my must haves at https://t.co/PoBZ3bhjs8 #KKWBEAUTY https://t.co/YCl0dSUrPR,1304,80,2018,62585120,1384,0.0,98
2020,The most beautiful birthday flowers in the world!!!!! I have the sweetest most creative husband! Thank you babe love you so much!!! https://t.co/hpv8HFH6kQ,147952,12124,2018,62585120,160076,0.26,155
2021,Watching the new season of Making A Murderer on Netflix,16388,858,2018,62585120,17246,0.03,55
2022,I surprised my adorable goddaughter Sophia Pippen at her #DWTSJuniors Disney Night rehearsal!! Watch on Sunday! @DWTSJuniors https://t.co/zQDDdky8YH,4271,232,2018,62585120,4503,0.01,148
2023,Turquoise Tears @kkwbeauty Flashing Lights Collection of shadows and pigments are available NOW aim https://t.co/aIjp1MBlpZ üì∏ @david_lachapelle @chrisappleton1 @samvissermakeup https://t.co/UaKyEPwSsE,3784,347,2018,62585120,4131,0.01,200
2024,Legends https://t.co/0bpaQNQlZV,15675,630,2018,62585120,16305,0.03,31
2025,Everyone tune in to watch Sophia!!! https://t.co/HXKsf3btyf,3004,126,2018,62585120,3130,0.01,59
2026,Love you Amanda! Go kill it out there in life!!!! You‚Äôre amazing and deserve the absolute best! Cheers to the 7 cyber years but bigger cheers to realizing your dreams and making that become a reality! Thanks for always supporting. Love always!!! https://t.co/mpIASGjHzf,4240,178,2018,62585120,4418,0.01,269
2027,OMG WOW!!!!!! https://t.co/x23mVU7808,7285,343,2018,62585120,7628,0.01,37
2028,"Shop #FlashingLights now!! 7 Pressed &amp; Loose Powder Pigments all in bright, jewel-toned shades ‚ö°Ô∏è Available only at https://t.co/PoBZ3bhjs8 #KKWBEAUTY https://t.co/Z4nTsZKADr",1381,118,2018,62585120,1499,0.0,178
2029,#FlashingLights launches TODAY at 12PM PST on https://t.co/PoBZ3bhjs8 ‚ö°Ô∏è‚ú® Shop the 7 brand new Pressed &amp; Loose Powder Pigments at 12PM PST #KKWBEAUTY https://t.co/nuKTHg5ue1,1152,89,2018,62585120,1241,0.0,177
2030,#FlashingLights launches TODAY at 12PM PST!!! ‚ö°Ô∏è https://t.co/PoBZ3bhjs8 https://t.co/LJul2cejRH,2070,136,2018,62585120,2206,0.0,96
2031,üïä @kkwbeauty by @david_lachapelle                                 We used the blue shadow and silver shadow in the crease and lighter blue pigment on the brow bone. All available tomorrow at Kkw https://t.co/hueP5QTGbR üïäüïäüïä https://t.co/FBALzUWcTD,6433,462,2018,62585120,6895,0.01,246
2032,So excited for tomorrow! My flashing lights collection launches tomorrow at noon https://t.co/sbyklMQhdE 7 new vibrant shimmery pigments &amp; highly pigmented pressed individual shadows! https://t.co/JFGJlLHrJO,1846,135,2018,62585120,1981,0.0,211
2033,üòç #FlashingLights launch TOMORROW at 12PM PST!!! https://t.co/cnvU52Ihli,2029,107,2018,62585120,2136,0.0,72
2034,A little silver eye this morning! Flashing Lights Collection by @david_lachapelle  Available this Friday Exclusively on https://t.co/sbyklMQhdE https://t.co/NWOFMJTibU,9013,758,2018,62585120,9771,0.02,167
2035,üíô https://t.co/RxtPC1SrH2,5084,264,2018,62585120,5348,0.01,25
2036,"New @kkwbeauty by David LaChapelle! A New collection featuring 7 Pressed &amp; Loose Powder Pigments, all in bright &amp; jewel-toned shades!!!!! Available this Friday 10.19 at 12PM PST https://t.co/tuB3UAAKng",6140,469,2018,62585120,6609,0.01,209
2037,#FlashingLights by @kkwbeauty is available this Friday 10.19 at 12PM PST only at https://t.co/PoBZ3bhjs8!! https://t.co/CKA3qrzwhg,2115,121,2018,62585120,2236,0.0,130
2038,Tonight on a new Keeping Up with the Kardashians #KUWTK https://t.co/X5yDXANXPy,6027,376,2018,62585120,6403,0.01,79
2039,I was so impressed by the Google Campus. They have a Wellness Center with doctors daily for health &amp; mental health. Quiet zones &amp; sleep pods for naps. They take mental health seriously at Google. Happy to have spent my #WorldMentaHealthDay there üíï,26033,1357,2018,62585120,27390,0.04,255
2040,I‚Äôm at @Google today talking with @AliceMarieFree about mass incarceration and prison reform.,5432,382,2018,62585120,5814,0.01,93
2041,Thank you @tiffanyandco for having me at your beautiful Blue Book event and letting me wear some pretty serious jewels! #TiffanysBlueBook https://t.co/e7Dg7EK5Gw,17079,1344,2018,62585120,18423,0.03,161
2042,Thank you @RICKOWENSONLINE https://t.co/chJ9bSARjK,23942,1592,2018,62585120,25534,0.04,50
2043,üíç Tiffany‚Äôs Blue Book Event üíç @TiffanyAndCo https://t.co/k7YuU5b1Qw,11973,760,2018,62585120,12733,0.02,67
2044,üòò https://t.co/onOVgf3fZn,2404,92,2018,62585120,2496,0.0,25
2045,"Wait if you think those ü§°ü§°‚Äôs were wearing @kkwbeauty in the Japan episode you‚Äôre mistaken! ü§° ü§£ Love you Khloe &amp; Kourt! And it wasn‚Äôt the color of the shadow,  it was a bright color mixed w all of the accessories and hair and outfit choices! A full ü§° combo!!!! üòàü§°üòàü§°üòà",5666,258,2018,62585120,5924,0.01,269
2046,"Today is the LAST day to register to vote in many states including Texas, Georgia, Arizona, Florida, and Illinois. Go to https://t.co/HyLl7F1SCf now for info!! Use your voice, register now. üá∫üá∏ https://t.co/eSr7gJlrJN",2884,592,2018,62585120,3476,0.01,216
2047,üíïüíïüíï LOVE This thank you üíïüíïüíï https://t.co/so7RlYTDcX,3735,155,2018,62585120,3890,0.01,51
2048,Excited to announce that our next KKW Beauty and Fragrance pop-up will be coming soon to @southcoastplaza this Holiday 2018/2019. Follow @kkwbeauty for news including how you can win a chance to celebrate the store opening with me at a private store event! #kkwbeautyscp https://t.co/nmX6b8OJTL,1292,108,2018,62585120,1400,0.0,294
2049,"Tune in to watch @MiloManheim on Dancing With The Stars tonight!! Vote at 1-800-868-3410!!! Good luck, Milo! https://t.co/iTIaTvwbZP",7420,503,2018,62585120,7923,0.01,132
2050,Gaga is so pretty üåü This movie is really good,64669,6455,2018,62585120,71124,0.11,45
2051,Watching A Star Is Born with @KylieJenner &amp; @jordynwoods üåü,39231,2800,2018,62585120,42031,0.07,62
2052,üòÇ https://t.co/KVM5K1n0mS,2298,138,2018,62585120,2436,0.0,25
2053,üíï https://t.co/6vV4gsdtvX,4579,217,2018,62585120,4796,0.01,25
2054,üíï https://t.co/HIoTM6Sr7Q,1699,101,2018,62585120,1800,0.0,25
2055,Not with green and yellow shadow and chandelier earrings üòÇ https://t.co/W6NlBhvCQE,4167,261,2018,62585120,4428,0.01,82
2056,Yup! https://t.co/oO7GCIhttd,1267,72,2018,62585120,1339,0.0,28
2057,Lol I needed a solo shot üòÇüòÇüòÇ #KUWTK,1292,70,2018,62585120,1362,0.0,35
2058,I miss Japan! It‚Äôs so beautiful there!,8851,611,2018,62585120,9462,0.02,38
2059,Miss my pink hair #KUWTK,2628,151,2018,62585120,2779,0.0,24
2060,It‚Äôs a part of our show so not sure exactly But it‚Äôs so cute! This episode we mix in fun animated characters https://t.co/uaNgJPi72J,1768,79,2018,62585120,1847,0.0,132
2061,Tonight tune into #KUWTK for our Japan episode https://t.co/vYsrSmqiet,9176,905,2018,62585120,10081,0.02,70
2062,Tune in tonight to watch Keeping Up With The Kardashians on E! https://t.co/KXnzmsUbiP,2604,205,2018,62585120,2809,0.0,86
2063,"Governor Brown, please add Kevin Cooper to your legacy of smart, fair  and thoughtful criminal justice reforms.               https://t.co/OzhZIWdxWL",1468,206,2018,62585120,1674,0.0,149
2064,Watch a brand new episode of You Kiddin‚Äô Me now on Facebook Watch #YouKiddinMe https://t.co/xg81S6KxWG https://t.co/Fox4OJWrpp,2701,158,2018,62585120,2859,0.0,126
2065,Neon vibes üî´üíö #KimKardashianGamehttp://smarturl.it/PlayKKH https://t.co/l7heMQ8AzJ,6071,280,2018,62585120,6351,0.01,82
2066,The 90‚Äôs . Just me and my pager üìü sitting in our parents car acting like we could drive. I was 13. We might have snuck out and taken it for a spin https://t.co/a1v6DhRkFK,90894,6933,2018,62585120,97827,0.16,170
2067,The @kkwbeauty Powder Contour Singles are back in stock!! Shop them now only at https://t.co/PoBZ3bhjs8 https://t.co/lgbVrFY8Xz,1585,76,2018,62585120,1661,0.0,127
2068,"Chanel vintage, lets please be specific https://t.co/yHc9C8gpHK",106199,14355,2018,62585120,120554,0.19,63
2069,"The #KKWBEAUTY Powder Contour Singles are back in stock tomorrow, 10.05 at 12PM PST only at https://t.co/PoBZ3bhjs8!! https://t.co/pg2ybNqRlJ",1525,73,2018,62585120,1598,0.0,141
2070,Congrats Kokes üëèüèºüëèüèºüëèüèº https://t.co/FVWVPoiDNV,4081,177,2018,62585120,4258,0.01,45
2071,Happy Birthday beautiful soul @colinags,4292,162,2018,62585120,4454,0.01,39
2072,üòç https://t.co/2unA9FAsfO,1793,70,2018,62585120,1863,0.0,25
2073,üíó https://t.co/6rd6D2HAUD,2155,77,2018,62585120,2232,0.0,25
2074,https://t.co/oNqwNgIXy5,1954,150,2018,62585120,2104,0.0,23
2075,I‚Äôm on @ashleygraham podcast today!!!! It‚Äôs so fun! I‚Äôm obsessed with podcasts and obsessed with Ashley to check it out! #PrettyBigDeal https://t.co/askDDDKU24,2083,131,2018,62585120,2214,0.0,159
2076,‚ù§Ô∏è We Got Love ‚ù§Ô∏è https://t.co/lqT9iTZr0g,83254,5342,2018,62585120,88596,0.14,41
2077,üòç https://t.co/6I7GtgUMj8,2130,99,2018,62585120,2229,0.0,25
2078,This is so cute!!!!! https://t.co/gTFOTJBjuU,3956,192,2018,62585120,4148,0.01,44
2079,They stole our go pro and we couldn‚Äôt find it for the longest and when we did this is what we see üòÇ https://t.co/lPdDYCikJJ,51951,5486,2018,62585120,57437,0.09,123
2080,üòÇüòÇüòÇ perri-ye https://t.co/ItzVqVyxMX,28773,3218,2018,62585120,31991,0.05,36
2081,Nov 23 Black Friday YANDHI           TRUST ME it is worth the wait üò±üòòüí¶üí∞üëëüî•üé•üíãüëÖüëèüèºüíïüòçüîåü§©,51573,9041,2018,62585120,60614,0.1,82
2082,Keeping Up With The Kardashians is on tonight! https://t.co/5tZz8cfB0D,16473,1202,2018,62585120,17675,0.03,70
2083,Tonight‚Äôs SNL performance is gonna be crazy!!!! Tune in!,19056,1121,2018,62585120,20177,0.03,56
2084,Fuck it was bad like real bad FML https://t.co/g7WJ165xOm,11850,523,2018,62585120,12373,0.02,57
2085,Classic Blossom Palette is back üå∏ Shop now: https://t.co/i5tLEPBwrM https://t.co/7Wt6eeYeDk,3281,190,2018,62585120,3471,0.01,91
2086,Classic Blossom Collection restocks today!!! üå∏ https://t.co/aIjp1MBlpZ https://t.co/45gqlJoxht,9372,527,2018,62585120,9899,0.02,94
2087,üíµüíµüíµ https://t.co/ruTTrshXdn,32732,3256,2018,62585120,35988,0.06,27
2088,üí∞üí∞üí∞ https://t.co/hCYXYGcvUD,113167,14000,2018,62585120,127167,0.2,27
2089,"Classic Blossom Palette üå∏ Back in stock tomorrow, 9/28 at 12PM PST https://t.co/PoBZ3bhjs8 https://t.co/VXEKOthARB",2128,117,2018,62585120,2245,0.0,114
2090,"The Classic Blossom Palette is back in stock TOMORROW, 9/28 at 12PM PST only at https://t.co/PoBZ3bhjs8 üå∏ https://t.co/iVa3Sl5lUP",1497,79,2018,62585120,1576,0.0,129
2091,"We‚Äôre halfway through the wildest season yet! Brand new #KUWTK this Sunday, 9PM PT/ET https://t.co/7VOhtmP7z7",11903,1200,2018,62585120,13103,0.02,109
2092,"The @kkwbeauty Classic Blossom Palette üå∏ Back in stock this Friday, 9/28 at 12PM PST! https://t.co/qQ1V36u6VP",4313,228,2018,62585120,4541,0.01,109
2093,morning cuties https://t.co/I8PYGsBWkm,246926,20949,2018,62585120,267875,0.43,38
2094,üëèüèºüëèüèºüëèüèº https://t.co/ukcMQxUfxr,27107,2601,2018,62585120,29708,0.05,30
2095,The Classic Blossom Palette is SOLD OUT üå∏ Can‚Äôt wait to see all your looks with this! Sign up for restock updates: https://t.co/tQHlxG7Mzd https://t.co/q3z6xMDl00,2711,159,2018,62585120,2870,0.0,162
2096,üíï https://t.co/3dAqG23GaT,3119,129,2018,62585120,3248,0.01,25
2097,OMG we do! It is pretty gross https://t.co/bW5HqAe6iL,8271,378,2018,62585120,8649,0.01,53
2098,Awww this part of GABBANA makes me so sad üò¢üò¢üò¢,6597,308,2018,62585120,6905,0.01,45
2099,Always! Consistency is key üîë https://t.co/hcdldX2vcG,99088,21976,2018,62585120,121064,0.19,52
2100,üíï https://t.co/f5awUnPqsd,1089,54,2018,62585120,1143,0.0,25
2101,Beyond vibing #KUWTK https://t.co/5yqd8c6VgV,1575,77,2018,62585120,1652,0.0,44
2102,I was so happy knowing i was having a baby too https://t.co/MPZuAqgPMb,6827,287,2018,62585120,7114,0.01,70
2103,I would see stuff online and screengrab and send it on our family group chats #KUWTK https://t.co/P2e6xcidLE,1879,90,2018,62585120,1969,0.0,108
2104,I hate how @kourtneykardash says issues. She like drags it,10597,498,2018,62585120,11095,0.02,58
2105,LOL the shade my mom threw at Kourtney üòÇüå¥,3580,108,2018,62585120,3688,0.01,41
2106,Awwww Gabbana baby,2609,118,2018,62585120,2727,0.0,18
2107,#KUWTK starts now!!!!,1388,104,2018,62585120,1492,0.0,21
2108,Hope you‚Äôre all loving my family‚Äôs episode of #YouKiddinMe on @FacebookWatch.¬†¬†Click ‚ÄúFOLLOW‚Äù on the show page and tune into new episodes each week that I executive produced.¬†¬†https://t.co/d272Egb7wa,1539,100,2018,62585120,1639,0.0,199
2109,My baby üòç she was The LOL Doll THRILLA https://t.co/n2hobWW5H2,15916,1092,2018,62585120,17008,0.03,62
2110,OMG üòçüòçüòç https://t.co/BsL7XaoW8G,7218,272,2018,62585120,7490,0.01,31
2111,We tortured my mom! I feel so bad https://t.co/2HVl57lKqZ,1905,78,2018,62585120,1983,0.0,57
2112,üòÇüôà https://t.co/tvakvCYa6H,5704,372,2018,62585120,6076,0.01,26
2113,üòÇ https://t.co/AAMOcsMwaO,3825,149,2018,62585120,3974,0.01,25
2114,"It‚Äôs time to laugh your¬†üçë off with me and my family during our episode of #YouKiddinMe premiering right NOW, only on @facebookwatch: https://t.co/WKwUBpRtyY https://t.co/o4hZrwyWsQ",1722,175,2018,62585120,1897,0.0,180
2115,8th grade- Drew Barrymore was my everything! https://t.co/F6Taj5HuQ8,50837,2432,2018,62585120,53269,0.09,68
2116,Beautiful ‚ú®‚ú®‚ú® https://t.co/V5TtpX3RiY,3400,114,2018,62585120,3514,0.01,37
2117,Facts https://t.co/xfBa1C8YuD,20895,1196,2018,62585120,22091,0.04,29
2118,Guess who üòÇ https://t.co/DhnHlUQmCT,204495,21757,2018,62585120,226252,0.36,35
2119,SHOP NOW ‚ú® https://t.co/tbQezJs782 https://t.co/sR9fAkJOi9,1264,71,2018,62585120,1335,0.0,58
2120,Love this pic for my @KKWFRAGRANCE Crystal Gardenia. IT RESTOCKS TODAY AT NOON! PST https://t.co/eAGj098U38 https://t.co/l7uptrZEYE,5232,283,2018,62585120,5515,0.01,131
2121,"Crystal Gardenia is back in stock tomorrow, 9/21 at 12PM PST at https://t.co/tbQezJs782 ‚ú® @KKWFRAGRANCE https://t.co/QMo1o6Wf98",1921,98,2018,62585120,2019,0.0,127
2122,Fashion Week vibes in the #KimKardashianGame! https://t.co/FahUuZIyvw https://t.co/CjgP4aBxWC,2691,144,2018,62585120,2835,0.0,93
2123,üå∏üå∏üå∏ https://t.co/6qTFuPxf1C,3391,115,2018,62585121,3506,0.01,27
2124,7th grade. This was my go to lipstick. It‚Äôs gotta make a comeback https://t.co/0KbveCHb7a,74315,5654,2018,62585121,79969,0.13,89
2125,Amen to this! https://t.co/AuxdAie2Jr,10743,846,2018,62585121,11589,0.02,37
2126,üòÇüòÇüòÇ https://t.co/rCdhTIT7Iy,37396,4680,2018,62585121,42076,0.07,27
2127,‚ù§Ô∏è‚ù§Ô∏è‚ù§Ô∏è https://t.co/T4Z5ztLh7Q,2120,94,2018,62585121,2214,0.0,30
2128,Love this campaign shot from our @kkwbeauty Powder Contour &amp; Highlight Kit! We also just won Allure Magazine‚Äôs ‚ÄúBest Contour Kit‚Äù for Best of Beauty 2018! @allure Shop now at https://t.co/PoBZ3bhjs8 https://t.co/lMkYeSv8FC,4971,311,2018,62585121,5282,0.01,226
2129,Why thank you. I hope you are too.üíï https://t.co/6QiNwsjbK8,17635,771,2018,62585121,18406,0.03,59
2130,üëÖüíãüçë https://t.co/J9iGsFI7I0,6880,331,2018,62585121,7211,0.01,27
2131,No it was after we just make up like that. https://t.co/7JS8i0J4mO,8375,308,2018,62585121,8683,0.01,66
2132,üëÖ https://t.co/Wpqh2RJdD9,3431,263,2018,62585121,3694,0.01,25
2133,FR FR https://t.co/l8HO0AbWN8,5755,388,2018,62585121,6143,0.01,29
2134,‚ù§Ô∏è https://t.co/n3EPWFhDLm,2391,107,2018,62585121,2498,0.0,26
2135,KUWTK is in now! Tune into E!,3953,191,2018,62585121,4144,0.01,29
2136,I have rhythm I just don‚Äôt love to dance https://t.co/HXCYeroTBZ,2565,141,2018,62585121,2706,0.0,64
2137,Please stop with this fake narrative. She was NEVER my nemesis. We simply stopped working together but we have always remained super close friends. https://t.co/dJeXRQbeFL,25087,1231,2018,62585121,26318,0.04,171
2138,üòç https://t.co/pUkkUJtY7W,3086,105,2018,62585121,3191,0.01,25
2139,üå∏‚ú® https://t.co/uNWwrqzy7B,1676,68,2018,62585121,1744,0.0,26
2140,üíï The Triplets üíï https://t.co/HUWgn02T2m,419396,55450,2018,62585121,474846,0.76,40
2141,Happy Birthday beautiful!!!!!! https://t.co/u1zQlh6TEU,3310,105,2018,62585121,3415,0.01,54
2142,What did you guys order from the Classic Blossom Collection?! Tweet me! So excited to see all of your looks üå∏üíã,5291,182,2018,62585121,5473,0.01,110
2143,Shop the new Classic Blossom Collection NOW at https://t.co/PoBZ3bhjs8 üå∏ #KKWBEAUTY https://t.co/98aFCfOTPC,3897,271,2018,62585121,4168,0.01,107
2144,Almost here!!! Classic Blossom Collection is about to drop in just a few minutes at https://t.co/PoBZ3bhjs8 üå∏ https://t.co/fBnMTnePJb,1716,124,2018,62585121,1840,0.0,133
