,full_text,favorite_count,retweet_count,created_at,user.followers_count,engagement,performance,twtlength
0,"Democrat “leadership,” despite their denials, are putting tremendous pressure on their members to vote yes on this ridiculous Impeachment. If they vote yes, it will be much easier for Republicans to win in 2020!",42155,11552,2019,67625690,53707,0.08,211
1,"Wow! “In a stunning rebuke of the FBI, the FISA court severly chastised the FBI for the FISA abuses brought to light in the recent Inspector General’s Report. There were at least 17 significant errors.” @FoxNews Statement by the Court was long and tough. Means my case was a SCAM!",51700,16370,2019,67625690,68070,0.1,280
2,https://t.co/WzLB5s41m3,43049,10887,2019,67625690,53936,0.08,23
3,Senator Dan Sullivan is doing a great job for the people of Alaska while supporting our #MAGA Agenda. He fights hard everyday to support our Veterans and the Military. Dan is Strong on the #2A and is 100% pro-jobs. I give Dan Sullivan my Complete and Total Endorsement!,31008,8385,2019,67625690,39393,0.06,269
4,".@Buddy_Carter is a BUSINESSMAN first. He takes care of our Vets and Troops and is leading the fight to SLASH drug prices! Buddy's 100% pro-Wall &amp; 100% pro-jobs. He will KEEP AMERICA GREAT and has my total, Strong Endorsement!",24855,6959,2019,67625690,31814,0.05,230
5,"Congressman @Denver4VA Riggleman is a true CONSERVATIVE leader who has done a great job for Virginia and will support our #MAGA Agenda. He defends our right to bear arms, protect our Borders &amp; help small businesses. Denver has my Total Endorsement!",21807,6338,2019,67625690,28145,0.04,252
6,"Congressman @MarkwayneMullin is a big time #MAGA supporter! Markwayne has fought hard for Oklahoma Veterans and Military, he loves our Farmers and he’s Strong on Border Security. I give Markwayne my Complete and Total Endorsement!",20375,5884,2019,67625690,26259,0.04,230
7,Congresswoman Kay @GrangerCampaign has worked hard for Texas and been a strong supporter of our #MAGA Agenda. She’s strong on #2A and Securing our Border and is 100% pro-life. Kay has my Complete and Total Endorsement!,23125,6692,2019,67625690,29817,0.04,218
8,We support @JeanineAnez in Bolivia as she works to ensure a peaceful democratic transition through free elections. We denounce the ongoing violence and those that provoke it both in Bolivia and from afar. The U.S. stands with the people of the region for peace and democracy!,48531,12258,2019,67625690,60789,0.09,275
9,"Senator Josh Hawley (R-Mo) “They (the Dems) don’t have anything. This whole thing is a joke, and it’s time to get the President exonerated. The House has no evidence of any impeachable offense. There’s nothing there, and they didn’t even charge a crime. They’ve had their.....",51388,14596,2019,67625690,65984,0.1,276
10,Would be sooo great if the Fed would further lower interest rates and quantitative ease. The Dollar is very strong against other currencies and there is almost no inflation. This is the time to do it. Exports would zoom!,72129,17738,2019,67625690,89867,0.13,220
11,"The new USA Today Poll, just out, has me leading all of the Democrat contenders. That’s hard to believe since the Fake News &amp; 3 year Scams and Witch Hunts, as phony as they are, just never seem to end. The American people are smart. They see the great economy, &amp; everything else!",64538,16668,2019,67625690,81206,0.12,287
12,Impeachment Poll numbers are starting to drop like a rock now that people are understanding better what this whole Democrat Scam is all about!,81692,18726,2019,67625690,100418,0.15,142
13,".@FoxNews  “Trump wins major victories in China and USMCA trade deals, defense spending and Space Force.” Thank you!",46933,11636,2019,67625690,58569,0.09,116
14,"The Stock Market hit another Record High yesterday, number 133 in less than three years as your all time favorite President, and the Radical Left, Do Nothing Democrats, want to impeach me. Don’t worry, I have done nothing wrong. Actually, they have!",67498,16494,2019,67625690,83992,0.12,249
15,Congressman Jeff Van Drew is very popular in our great and very united Republican Party. It was a tribute to him that he was able to win his heavily Republican district as a Democrat. People like that are not easily replaceable!,76618,16039,2019,67625690,92657,0.14,228
16,https://t.co/YLmzkgro4d,86786,22848,2019,67625690,109634,0.16,23
17,https://t.co/Kd1RSELPLp,43765,13556,2019,67625690,57321,0.08,23
18,New Stock Market high! I will never get bored of telling you that – and we will never get tired of winning!,158153,33505,2019,67625690,191658,0.28,107
19,Wow! https://t.co/gYGUEKpGac,64703,23237,2019,67625690,87940,0.13,28
20,Thank you Devin. Great reflexes! https://t.co/46jb64LalD,50396,11552,2019,67625690,61948,0.09,56
21,Thank you CC! https://t.co/qfagL6s78G,27313,7354,2019,67625690,34667,0.05,37
22,"I look very much forward to debating whoever the lucky person is who stumbles across the finish line in the little watched Do Nothing Democrat Debates. My record is so good on the Economy and all else, including debating, that perhaps I would consider more than 3 debates.....",81470,18094,2019,67625690,99564,0.15,276
23,"READ THE TRANSCRIPTS! The Impeachment Hoax is the greatest con job in the history of American politics! The Fake News Media, and their partner, the Democrat Party, are working overtime to make life for the United Republican Party, and all it stands for, as difficult as possible!",79519,20402,2019,67625690,99921,0.15,279
24,“The American people see through it.” https://t.co/1WTujQY7e6,58657,15448,2019,67625690,74105,0.11,61
25,"“Here in America it will be the same victory as BREXIT, but even more so. In the U.S., while all of this has been going on, the Impeachment, the obstruction, the resistance, President Trump has managed to deliver not just promises, but a record which adds up to one.....",70377,18001,2019,67625690,88378,0.13,270
26,Watch these two great people talk about the Impeachment Hoax. Will be by far the best hour on television! https://t.co/O8VmH3ipkw,54517,14551,2019,67625690,69068,0.1,129
27,Congressional Do Nothing Democrats are being absolutely decimated in their districts on the subject of the Impeachment Hoax. People that voted for them are literally screaming in their faces. Crazy Nancy is finding defending Shifty Schiff harder than she thought! #2020Election,79515,21999,2019,67625690,101514,0.15,277
28,"Because Nancy’s teeth were falling out of her mouth, and she didn’t have time to think! https://t.co/rx3pcyofip",107790,26705,2019,67625690,134495,0.2,111
29,Fake News! https://t.co/NWaeaG1exu,44643,12858,2019,67625690,57501,0.09,34
30,".@seanhannity, who will be interviewed on @marklevinshow tonight at 8:00 P.M., @foxnews, stated about the Impeachment Hoax, “This is outrages lying, corruption and propaganda. Should never be allowed to happen.”",48558,12514,2019,67625690,61072,0.09,211
31,"Approval Rating in Republican Party = 95%, a Record! Overall Approval Rating = 51%. Think of where I’d be without the never ending, 24 hour a day, phony Witch Hunt, that started 3 years ago!",93266,21056,2019,67625690,114322,0.17,190
32,"The @foxnewPolls, always inaccurate, are heavily weighted toward Dems. So ridiculous - same thing happened in 2016. They got it all wrong. Get a new pollster!",69993,14995,2019,67625690,84988,0.13,158
33,“The President did nothing wrong here. There is no crime.” @charliekirk11  Impeachment Hoax!,52704,11907,2019,67625690,64611,0.1,92
34,"“There is no bribery, or any crime at all, alleged in the Articles of Impeachment. This is a first in the history of our Country.” @JudgeJeanine @RepMikeJohnson",43180,11497,2019,67625690,54677,0.08,160
35,"So now Comey’s admitting he was wrong. Wow, but he’s only doing so because he got caught red handed. He was actually caught a long time ago. So what are the consequences for his unlawful conduct. Could it be years in jail? Where are the apologies to me and others, Jim?",149958,39691,2019,67625690,189649,0.28,269
36,A PERFECT phone call. “Can you do us (not me. Us is referring to our Country) a favor.” Then go on to talk about “Country” and “U.S. Attorney General.” The Impeachment Hoax is just a continuation of the Witch Hunt which has been going on for 3 years. We will win!  #MAGAKAG #2020,58810,14067,2019,67625690,72877,0.11,279
37,"As bad as the I.G. Report is for the FBI and others, and it is really bad, remember that I.G. Horowitz was appointed by Obama. There was tremendous bias and guilt exposed, so obvious, but Horowitz couldn’t get himself to say it. Big credibility loss. Obama knew everything!",91846,27690,2019,67625690,119536,0.18,273
38,Far from it! https://t.co/kXyaC1LDwV,36287,10359,2019,67625690,46646,0.07,36
39,Crooked Hillary caught again. She is a total train wreck! https://t.co/iqtuwzbaIV,80641,25412,2019,67625690,106053,0.16,81
40,Schiff’s correcting the record memo has turned out to be totally wrong (based on the I.G. Report)! A very big lie. @MariaBartiromo And @DevinNunes has turned out to be completely right. Congratulations to Devin. The Fake News Media should apologize to all!,59815,17781,2019,67625690,77596,0.11,256
41,"Wow, that would be big. Always heard Jeff is very smart! https://t.co/7yDPU4N3wd",54685,12692,2019,67625690,67377,0.1,80
42,"Thank you for your honesty Jeff. All of the Democrats know you are right, but unlike you, they don’t have the “guts” to say so! https://t.co/OUc46HUwPq",71404,17982,2019,67625690,89386,0.13,151
43,I will see Navy at the White House to present the Commander-in-Chief’s Trophy! https://t.co/V3oAZjWqEo,50079,10398,2019,67625690,60477,0.09,102
44,"Incredible young, strong and brilliant people. Army/Navy! https://t.co/I4F8xIxorA",74354,13935,2019,67625690,88289,0.13,81
45,Congratulations to Tiger and the entire U.S. Team on a great comeback and tremendous WIN. True Champions! https://t.co/wyjBAgoF7J,85570,15590,2019,67625690,101160,0.15,129
46,"It was my Great Honor to attend the 120th Army-Navy game today in Philadelphia, Pennsylvania! @NavyFB @ArmyWP_Football @ArmyNavyGame https://t.co/HipWiZKmiP",59722,13907,2019,67625690,73629,0.11,156
47,Both Commiecast MSNBC &amp; Fake News CNN are watching their Ratings TANK.  Fredo on CNN is dying. Don’t know why @FoxNews wants to be more like them? They’ll all die together as other outlets take their place. Only pro Trump Fox shows do well. Rest are nothing. How’s Shep doing?,95718,24758,2019,67625690,120476,0.18,280
48,"Hard to believe that @FoxNews will be interviewing sleazebag &amp; totally discredited former FBI Director James Comey, &amp; also corrupt politician Adam “Shifty” Schiff. Fox is trying sooo hard to be politically correct, and yet they were totally shut out from the failed Dem debates!",92745,23454,2019,67625690,116199,0.17,286
49,Congratulations @NavyFB! https://t.co/eoDccVFzJS,35508,7775,2019,67625690,43283,0.06,48
50,"The last time I spoke to Debbie Dingell was her call thanking me for granting top memorial and funeral service honors for her then just departed husband, long time Congressman John Dingell. Now I watch her ripping me as part of the Democrats Impeachment Hoax. Really pathetic!",105396,24714,2019,67625690,130110,0.19,276
51,https://t.co/zHSZxlgYvT,75401,18256,2019,67625690,93657,0.14,23
52,"Chuck Schumer sat for years during the Obama Administration and watched as China ripped off the United States. He &amp; the Do Nothing Democrats did NOTHING as this $ carnage took place. Now, without even seeing it, he snipes at our GREAT new deal with China. Too bad Cryin’ Chuck!",122038,32748,2019,67625690,154786,0.23,281
53,"On my way to the #ArmyNavyGame in Philadelphia, Pennsylvania! https://t.co/tWnDNRFyO1",62557,12671,2019,67625690,75228,0.11,85
54,https://t.co/Z0VHUlAwMD,70370,20913,2019,67625690,91283,0.13,23
55,https://t.co/97NvLGxMuj,41268,12775,2019,67625690,54043,0.08,23
56,"“There are 31 House Democrats in Trump won Congressional Districts. Those Dems will have to answer to their constituents come 2020. If you look at the facts, there’s no crime, there’s no witness, there’s no evidence, there’s no victim, President Zelensky said there was....",79968,20959,2019,67625690,100927,0.15,273
57,"“Independent voters are fed up and frustrated with the Democrats.” Congressman Michael Waltz, Florida",69058,14705,2019,67625690,83763,0.12,101
58,"After watching the disgraceful way that a wonderful man, @BrettKavanaugh, was treated by the Democrats, and now seeing first hand how these same Radical Left, Do Nothing Dems are treating the whole Impeachment Hoax, I understand why so many Dems are voting Republican!",113058,27725,2019,67625690,140783,0.21,268
59,25 Million Evangelical Christians are not registered to vote. We are working hard to get them registered! @robertjeffress @LouDobbs,108480,29014,2019,67625690,137494,0.2,131
60,“The FBI declares in a court filing that it has absolutely no records of disciplinary action against any lawyers in Russia Fisa Case despite 17 acts of misconduct. There is nothing noble about their leadership. FISA Court appears to be either corrupt or incompetent.” @LouDobbs,88428,26831,2019,67625690,115259,0.17,277
61,"It’s not fair that I’m being Impeached when I’ve done absolutely nothing wrong! The Radical Left, Do Nothing Democrats have become the Party of Hate. They are so bad for our Country!",168256,34419,2019,67625690,202675,0.3,182
62,"HAPPY BIRTHDAY! #Guard383 
https://t.co/iMnczcCHgN",56611,14251,2019,67625690,70862,0.1,51
63,“This whole process has been rigged from the start.”  @RepDLesko,83086,17879,2019,67625690,100965,0.15,64
64,"We have agreed to a very large Phase One Deal with China. They have agreed to many structural changes and massive purchases of Agricultural Product, Energy, and Manufactured Goods, plus much more. The 25% Tariffs will remain as is, with 7 1/2% put on much of the remainder....",98600,25755,2019,67625690,124355,0.18,276
65,"The Wall Street Journal story on the China Deal is completely wrong, especially their statement on Tariffs. Fake News. They should find a better leaker!",109068,27183,2019,67625690,136251,0.2,152
66,Record Stock Market &amp; Jobs!,80943,16221,2019,67625690,97164,0.14,31
67,"How do you get Impeached when you have done NOTHING wrong (a perfect call), have created the best economy in the history of our Country, rebuilt our Military, fixed the V.A. (Choice!), cut Taxes &amp; Regs, protected your 2nd A, created Jobs, Jobs, Jobs, and soooo much more? Crazy!",139410,31219,2019,67625690,170629,0.25,282
68,"Congratulations to @foxandfriends on being named, BY FAR, the Number One Rated cable news show. CNN and MSNBC have totally tanked, their ratings are terrible. They have zero credibility!",80924,17234,2019,67625690,98158,0.15,186
69,“All of our presidents would be impeached under this Rogue House of Democrat Leadership.” @marklevinshow,58816,14126,2019,67625690,72942,0.11,104
70,The Republican Party is more united now than at any time in its history - by far!,101161,18694,2019,67625690,119855,0.18,81
71,The Do Nothing Democrats have become the Party of lies and deception! The Republicans are the Party of the American Dream!,87001,20530,2019,67625690,107531,0.16,122
72,"Poll numbers have gone through the roof in favor of No Impeachment, especially with Swing States and Independents in Swing States. People have figured out that the Democrats have no case, it is a total Hoax. Even Pelosi admitted yesterday that she began this scam 2 1/2 years ago!",87596,21635,2019,67625690,109231,0.16,280
73,"My Approval Rating in the Republican Party is 95%, a Record. Thank you! #2020Election",82826,16029,2019,67625690,98855,0.15,85
74,"The Republicans House members were fantastic yesterday. It always helps to have a much better case, in fact the Dems have no case at all, but the unity &amp; sheer brilliance of these Republican warriors, all of them, was a beautiful sight to see. Dems had no answers and wanted out!",84986,20635,2019,67625690,105621,0.16,283
75,Congratulations to Boris Johnson on his great WIN! Britain and the United States will now be free to strike a massive new Trade Deal after BREXIT. This deal has the potential to be far bigger and more lucrative than any deal that could be made with the E.U. Celebrate Boris!,201002,47333,2019,67625690,248335,0.37,274
76,“Last night House Judiciary Chairman Jerry Nadler admitted that Democrats are pursuing Impeachment because it’s too dangerous to simply let the American people pick the next president in 2020.” @kilmeade  @FoxNews,76476,23936,2019,67625690,100412,0.15,213
77,Looking like a big win for Boris in the U.K.!,129487,20328,2019,67625690,149815,0.22,45
78,"Nancy Pelosi just got duped in an interview to admitting that she has been working on impeaching me for “two and a half years.” In other words, she lied. This was the Radical Left, Do Nothing Democrats plan all along, long before the Ukraine phone call. Impeachment Hoax!",137906,39270,2019,67625690,177176,0.26,271
79,“I think it’s obvious to all the American public that this is a railroad job!” @JimPressOffice https://t.co/MlYNny1pqg,50237,15280,2019,67625690,65517,0.1,118
80,"I also have constantly asked, “Why aren’t Germany, France and other European countries helping Ukraine more? They are the biggest beneficiaries. Why is it always the good ol’ United States?” The Radical Left, Do Nothing Democrats, never mention this at their phony hearing!",88134,21937,2019,67625690,110071,0.16,273
81,"Dems Veronica Escobar and Jackson Lee purposely misquoted my call. I said I want you to do us (our Country!) a favor, not me a favor. They know that but decided to LIE in order to make a fraudulent point! Very sad.",94183,24764,2019,67625690,118947,0.18,214
82,"Getting VERY close to a BIG DEAL with China. They want it, and so do we!",156676,28574,2019,67625690,185250,0.27,72
83,Big!!! https://t.co/powyhHM50y,37403,10322,2019,67625690,47725,0.07,30
84,ANTIFA will not be going after Bryce or @ColbyCovMMA anytime soon. They much prefer people who can’t fight back! https://t.co/s2M2RHkDsE,61004,16722,2019,67625690,77726,0.11,136
85,#ThrowbackThursday🇺🇸 https://t.co/8gd1OEtu3h,81183,18324,2019,67625690,99507,0.15,44
86,I agree! https://t.co/lZeAPRqgNa,29932,7757,2019,67625690,37689,0.06,32
87,Dirty cops! https://t.co/CVC1awEjZE,35045,10561,2019,67625690,45606,0.07,35
88,Amazing! https://t.co/powyhHM50y,22423,5928,2019,67625690,28351,0.04,32
89,Very dishonest pols! https://t.co/N12Q4RcHuH,23313,5944,2019,67625688,29257,0.04,44
90,True! https://t.co/CVC1awEjZE,20252,5464,2019,67625688,25716,0.04,29
91,Congratulations to JUDGE LAWRENCE VANDYKE on being confirmed to the Ninth Circuit. Great job!,62554,13154,2019,67625688,75708,0.11,93
92,Very sad! https://t.co/N12Q4RcHuH,33002,8268,2019,67625688,41270,0.06,33
93,"I will be there in two weeks, The Southern White House! https://t.co/2djJrzAEfZ",49030,9141,2019,67625688,58171,0.09,79
94,What a great evening! https://t.co/1hNqDdVayL,22712,4669,2019,67625688,27381,0.04,45
95,Thank you! https://t.co/JxbhOpL4Zo,17638,4010,2019,67625688,21648,0.03,34
96,A fantastic night in Pennsylvania! https://t.co/GZfQGbTIOl,17474,3979,2019,67625688,21453,0.03,58
97,Great deal for USA! https://t.co/9ViVwNYbSL,22516,6416,2019,67625688,28932,0.04,43
98,"So ridiculous. Greta must work on her Anger Management problem, then go to a good old fashioned movie with a friend! Chill Greta, Chill! https://t.co/M8ZtS8okzE",230382,56722,2019,67625688,287104,0.42,160
99,No crime! https://t.co/8BF9BOEraE,21852,5921,2019,67625688,27773,0.04,33
100,"It’s great to have a wonderful subject, President Trump. Fake News like CNN &amp; MSNBC are dying. If they treated me fairly, they would do well. Have Zero credibility! https://t.co/Yt8N8Dgsco",28801,6706,2019,67625688,35507,0.05,192
101,“New Polls Say Most Americans Oppose Impeachment.” @foxandfriends  I did nothing wrong. This will be the first Impeachment ever where there was no crime. They don’t even allege a crime. Crazy!,84150,18814,2019,67625688,102964,0.15,192
102,Great Rally in Pennsylvania last night. Congressman Lloyd Smucker (PA-11) was there and I informed him that he has my complete and total Endorsement for the upcoming 2020 Election. Lloyd has done a great job. I am with him all the way!  #MAGA,73429,15854,2019,67625688,89283,0.13,242
103,They spied on my campaign! https://t.co/sOotkhk5fw,93393,27397,2019,67625688,120790,0.18,50
104,They will never do it! https://t.co/5vlnzRg6GN,40935,11704,2019,67625688,52639,0.08,46
105,"The News Media in our Country is FAKE and in many cases, totally CORRUPT! https://t.co/hj9plf0GMC",68292,21596,2019,67625688,89888,0.13,97
106,"“The Exclusive @Ami_Magazine Poll, What Orthodox Jews really think about President Trump” @JakeTurx https://t.co/bYaDIbKPAa https://t.co/TRtFKA8bGj",23581,7065,2019,67625688,30646,0.05,147
107,"Wow! All of our priorities have made it into the final NDAA: Pay Raise for our Troops, Rebuilding our Military, Paid Parental Leave, Border Security, and Space Force! Congress – don’t delay this anymore! I will sign this historic defense legislation immediately!",119850,28763,2019,67625688,148613,0.22,262
108,“Zero evidence that any law was broken. They’re not even alleging that a law was broken. This is an abuse of the Constitution. It is using Impeachment as a campaign tool.” @SenTedCruz,80561,21788,2019,67625688,102349,0.15,183
109,They were just upset that I demanded they pay their fair share for NATO. Their countries are delinquent. I raised $530 Billion more from NATO countries! Thank you Charles. https://t.co/1klX5GtK8r,59244,15946,2019,67625688,75190,0.11,195
110,https://t.co/ruQBK6gNLL,37643,11958,2019,67625688,49601,0.07,23
111,"After years of rebuilding OTHER NATIONS, we are finally rebuilding OUR NATION. In everything we do, we are putting AMERICA FIRST! #KAG2020 https://t.co/sS0Y01MJYd",77041,20047,2019,67625688,97088,0.14,162
112,"Day after day, we are exposing the depravity, dishonesty and sickness of the corrupt Washington establishment — and with your help, we are going to complete the mission and DRAIN THE SWAMP! #KAG2020 https://t.co/SM5hocqoNi",68324,18846,2019,67625688,87170,0.13,222
113,"THANK YOU PENNSYLVANIA! With your help, your devotion, and your drive, we are going to keep on working, we are going to keep on fighting, and we are going to keep ON WINNING! We are ONE movement, ONE people, ONE family, and ONE GLORIOUS NATION UNDER GOD! 
https://t.co/g64HD9yL9N",96335,27739,2019,67625688,124074,0.18,280
114,"Just had a very good meeting with Foreign Minister Sergey Lavrov and representatives of Russia. Discussed many items including Trade, Iran, North Korea, INF Treaty, Nuclear Arms Control, and Election Meddling. Look forward to continuing our dialogue in the near future! https://t.co/tHecH9a9ck",44955,10865,2019,67625688,55820,0.08,293
115,"On my way to Hershey, Pennsylvania for a rally. See everyone soon. I love Hershey chocolate! https://t.co/bDUYBK8KRc",98437,18729,2019,67625688,117166,0.17,116
116,"Just received a briefing on the horrific shootout that took place in Jersey City, NJ. Our thoughts &amp; prayers are w/ the victims &amp; their families during this very difficult &amp; tragic time. We will continue to monitor the situation as we assist local &amp; state officials on the ground.",71239,14561,2019,67625688,85800,0.13,296
117,"Read the Transcripts! “us” is a reference to USA, not me!",78389,17410,2019,67625688,95799,0.14,57
118,"Shifty Schiff, a totally corrupt politician, made up a horrible and fraudulent statement, read it to Congress, and said those words came from me. He got caught, was very embarrassed, yet nothing happened to him for committing this fraud. He’ll eventually have to answer for this!",141709,35243,2019,67625688,176952,0.26,279
119,WITCH HUNT!,92417,19196,2019,67625688,111613,0.17,11
120,"Nadler just said that I “pressured Ukraine to interfere in our 2020 Election.” Ridiculous, and he knows that is not true. Both the President &amp; Foreign Minister of Ukraine said, many times, that there “WAS NO PRESSURE.” Nadler and the Dems know this, but refuse to acknowledge!",84350,21924,2019,67625688,106274,0.16,280
121,Looking like very good Democrat support for USMCA. That would be great for our Country!,64216,13594,2019,67625688,77810,0.12,87
122,"America’s great USMCA Trade Bill is looking good. It will be the best and most important trade deal ever made by the USA. Good for everybody - Farmers, Manufacturers, Energy, Unions - tremendous support. Importantly, we will finally end our Country’s worst Trade Deal, NAFTA!",86242,20973,2019,67625688,107215,0.16,275
123,"To Impeach a President who has proven through results, including producing perhaps the strongest economy in our country’s history, to have one of the most successful presidencies ever, and most importantly, who has done NOTHING wrong, is sheer Political Madness! #2020Election",110491,28225,2019,67625688,138716,0.21,276
124,“I can’t remember anything quite like this (the I.G. Report).” @brithume @BretBaier,48558,11800,2019,67625688,60358,0.09,83
125,"I don’t know what report current Director of the FBI Christopher Wray was reading, but it sure wasn’t the one given to me. With that kind of attitude, he will never be able to fix the FBI, which is badly broken despite having some of the greatest men &amp; women working there!",131254,33708,2019,67625688,164962,0.24,277
126,"“You have to look at the 17 instances of misconduct cited in the Report, they are very bad. The FISA Court was clearly taken for a ride on this, a failure of the FBI up and fown the chain of command. It’s about as strong a medicine as I’ve seen in a report of this kind...",71239,19527,2019,67625688,90766,0.13,272
127,A great choice. Bill is a winner! https://t.co/yxrB8aDIL9,63542,12817,2019,67625688,76359,0.11,57
128,Read the Transcripts!,116448,23679,2019,67625688,140127,0.21,21
129,True! https://t.co/1seRjQ11ru,58256,15658,2019,67625688,73914,0.11,29
130,The Do Nothing Democrats are a disgrace! https://t.co/BlaAqsiw8z,72218,19485,2019,67625688,91703,0.14,64
131,The best Economy ever! https://t.co/Ql8f16uGXD,75260,19806,2019,67625688,95066,0.14,46
132,Witch Hunt! https://t.co/XrJSUsm9Wq,53133,14069,2019,67625688,67202,0.1,35
133,The Real Deal! https://t.co/jUXHPU85PQ,72215,22726,2019,67625688,94941,0.14,38
134,Witch Hunt! https://t.co/JIJk7l5TAX,43196,12366,2019,67625688,55562,0.08,35
135,Let our great soldiers fight! https://t.co/qBGdF9sVnJ,57606,14625,2019,67616848,72231,0.11,53
136,AMERICA FIRST! https://t.co/dOU1MK1Lwu,59595,15333,2019,67616848,74928,0.11,38
137,“The Democrats have thrown a wrecking ball at our Democracy.” @MariaBartiromo,60777,14145,2019,67616848,74922,0.11,77
138,“No president in American history has been treated like this.” @marklevinshow,118300,25501,2019,67616848,143801,0.21,77
139,.CNN is a ratings disaster. Lost all credibility! https://t.co/SKnLFNTGzU,57849,14821,2019,67616848,72670,0.11,73
140,What he did is illegal. Schiff is a corrupt politician and a criminal! https://t.co/uLzJY5MjW3,75051,22832,2019,67616848,97883,0.14,94
141,"“This would be the first Impeachment in American history without a specific criminal statute or crime that the president whose impeached would have allegedly committed.” Paul Gigot, The Wall Street Journal",75545,20837,2019,67616848,96382,0.14,205
142,"“The Democrats haven’t come up with a smocking gun. Nancy Pelosi, by raising this to the level of Impeachment, has raised the bar impossibly high. This comes after three years of nonstop investigations of Trump, the Russian collusion narrative, the Mueller Report, &amp; now the.....",51773,13627,2019,67616848,65400,0.1,283
143,I.G. report out tomorrow. That will be the big story!,106244,26576,2019,67616848,132820,0.2,53
144,“I think the Democrats are going to lose many members over this.” @DebbieLesko @edhenry,33245,8111,2019,67616848,41356,0.06,87
145,The Wall is going up fast! https://t.co/8tmUsC9oPq,52146,11935,2019,67616848,64081,0.09,50
146,"I got NATO countries to pay 530 Billion Dollars a year more, and the U.S. less, and came home to a Fake News Media that mocked me. Didn’t think that was possible!",114089,27554,2019,67616848,141643,0.21,162
147,Great! https://t.co/YEbqKEJBq2,19358,4748,2019,67616848,24106,0.04,30
148,"Don’t get why @FoxNews puts losers on like @RepSwalwell (who got ZERO as presidential candidate before quitting), Pramila Jayapal, David Cicilline and others who are Radical Left Haters? The Dems wouldn’t let @FoxNews get near their bad ratings debates, yet Fox panders. Pathetic!",54958,14507,2019,67616848,69465,0.1,280
149,"“Any president has the authority to investigate corruption. The President himself released the transcript of the call. Now the Democrats have no evidence of a crime and no evidence of violating the law. This is a kangaroo court in the House, but it’s going to go to the Senate,...",77014,19370,2019,67616848,96384,0.14,280
150,".@SenTedCruz  “The Democrats are now admitting that they can’t prove a crime, they can’t prove a law was violated, and here’s why. Any president, any administration, is justified in investigating corruption, and there was serious evidence of real corruption concerning Hunter....",54475,16059,2019,67616848,70534,0.1,279
151,"Less than 48 hours before start of the Impeachment Hearing Hoax, on Monday, the No Due Process, Do Nothing Democrats are, believe it or not, changing the Impeachment Guidelines because the facts are not on their side. When you can’t win the game, change the rules!",118166,32107,2019,67616848,150273,0.22,264
152,"Kim Jong Un is too smart and has far too much to lose, everything actually, if he acts in a hostile way. He signed a strong Denuclearization Agreement with me in Singapore. He does not want to void his special relationship with the President of the United States or interfere.... https://t.co/THfOjfB2uE",43036,11762,2019,67616848,54798,0.08,303
153,https://t.co/HvENCXZBYe,50944,16550,2019,67616848,67494,0.1,23
154,https://t.co/kaiJymPjE9,42132,13275,2019,67616848,55407,0.08,23
155,"Congratulations to @TitoOrtiz on tonight’s huge WIN, a Great American Patriot! https://t.co/m4tJpfzVte",57485,13676,2019,67616848,71161,0.11,102
156,"The United States Secret Service Deputy Assistant Director, Anthony Ornato, will become my new Deputy Chief of Staff for Operations. I have worked with Tony for 3 years - he will do a fantastic job! Thank you to Dan Walsh for his great service, and congratulations to Tony!",65775,14595,2019,67616848,80370,0.12,273
157,"“Not only have the Democrats not advanced key pieces of legislation that would help the economy, but the polls, especially in early states, are showing that voters are tuning out.” @PeteHegseth They don’t want our greatest of all presidents impeached!",55390,14823,2019,67616848,70213,0.1,251
158,"“Why re-elect Democrats when you know that this is what they are doing with their majority. Their case is not strong because first it was Russian Collusion, then it was obstruction, then it was Ukraine, now their pivoting back to Russia. Why would they be doing that?” Lisa Booth",72344,18826,2019,67616848,91170,0.13,279
159,Our Economy is the envy of the World!,136826,24506,2019,67616848,161332,0.24,37
160,"Hard to believe, but if Nancy Pelosi had put our great Trade Deal with Mexico and Canada, USMCA, up for a vote long ago, our economy would be even better. If she doesn’t move quickly, it will collapse!",82527,22011,2019,67616848,104538,0.15,201
161,The United States will not rest until we bring every American wrongfully detained in Iran and around the world back home to their loved ones! https://t.co/2kWgJhvrtY,68516,18180,2019,67616848,86696,0.13,165
162,"Taken during the Obama Administration (despite $150 Billion gift), returned during the Trump Administration. Thank you to Iran on a very fair negotiation. See, we can make a deal together! https://t.co/rZaY9p8xzV",54185,15885,2019,67616848,70070,0.1,212
163,"While the world is not doing well economically, our Country is doing better, perhaps, than it has ever done before. Jobs, Jobs, Jobs!",96333,20807,2019,67616848,117140,0.17,133
164,"Read the Transcripts! Also, see where I say “us” (our Country) as opposed to “me” (meaning me) and where I then say that the Attorney General (of the United States) will call you. People still remember Schiff’s made up and fraudulent version of my conversation. Witch Hunt!",106490,25393,2019,67616848,131883,0.2,273
165,"Why is the World Bank loaning money to China? Can this be possible? China has plenty of money, and if they don’t, they create it. STOP!",137750,35658,2019,67616848,173408,0.26,135
166,Fake News @CNN is reporting that I am “still using personal cell phone for calls despite repeated security warnings.” This is totally false information and reporting. I haven’t had a personal cell phone for years. Only use government approved and issued phones. Retract!,130327,36087,2019,67616848,166414,0.25,270
167,"Nadler hasn’t had a single fact witness testify! Zero substance—Country wants #USMCA and Growth, not Impeachment. Polls have tanked on the Do Nothing Democrats!",73715,19099,2019,67616848,92814,0.14,160
168,"GREAT WORK yesterday by the Senate to support our Historically Black Colleges and Universities! Thank you @BetsyDeVosED, @SenAlexander, and @SenatorTimScott for your leadership...",36770,9460,2019,67616848,46230,0.07,179
169,"Congressman @LanceGooden has done a wonderful job for the people of Texas while supporting our #MAGA Agenda. He continues to protect your very important #2A. Lance is Strong on Crime and the Border, he Loves our Great Vets and Military. Lance has my Complete &amp; Total Endorsement!",35291,9226,2019,67616848,44517,0.07,283
170,"All necessary work has been completed to declare Mexican Cartels terrorist organizations. Statutorily we are ready to do so. However, at the request of a man who I like and respect, and has worked so well with us, President Andres Manuel @LopezObrador_ we....",57429,15504,2019,67616848,72933,0.11,259
171,"JOBS, JOBS, JOBS! https://t.co/QCtWgld2RW",95230,27002,2019,67616848,122232,0.18,41
172,"King Salman of Saudi Arabia just called to express his sincere condolences and give his sympathies to the families and friends of the warriors who were killed and wounded in the attack that took place in Pensacola, Florida....",76924,20734,2019,67616848,97658,0.14,226
173,"Just received a full briefing on the tragic shooting at NAS Pensacola in Florida, and spoke to @GovRonDeSantis. My thoughts and prayers are with the victims and their families during this difficult time. We are continuing to monitor the situation as the investigation is ongoing.",59594,13616,2019,67616848,73210,0.11,279
174,"Without the horror show that is the Radical Left, Do Nothing Democrats, the Stock Markets and Economy would be even better, if that is possible, and the Border would be closed to the evil of Drugs, Gangs and all other problems! #2020",89139,23525,2019,67616848,112664,0.17,233
175,"“This is a blowout. Look at these manufacturing numbers, a blowout.” @MariaBartiromo",69392,16118,2019,67616848,85510,0.13,84
176,GREAT JOBS REPORT!,96379,18022,2019,67616848,114401,0.17,18
177,"Stock Markets Up Record Numbers. For this year alone, Dow up 18.65%, S&amp;P up 24.36%, Nasdaq Composite up 29.17%. “It’s the economy, stupid.”",90467,21099,2019,67616848,111566,0.16,143
178,Do not believe any article or story you read or see that uses “anonymous sources” having to do with trade or any other subject. Only accept information if it has an actual living name on it. The Fake News Media makes up many “sources say” stories. Do not believe them!,157547,38597,2019,67616848,196144,0.29,268
179,Where’s the Fake Whistleblower? Where’s Whistleblower number 2? Where’s the phony informer who got it all wrong?,137431,31012,2019,67616848,168443,0.25,112
180,"The story today that we are sending 12,000 troops to Saudi Arabia is false or, to put it more accurately, Fake News!",108905,27587,2019,67616848,136492,0.2,116
181,https://t.co/nSyY8ysJtp,108764,27200,2019,67616848,135964,0.2,23
182,Republican Approval Rating = 95%. Thank you!,165380,29185,2019,67616848,194565,0.29,44
183,"Nancy Pelosi just had a nervous fit. She hates that we will soon have 182 great new judges and sooo much more. Stock Market and employment records. She says she “prays for the President.” I don’t believe her, not even close. Help the homeless in your district Nancy. USMCA?",192117,50390,2019,67616848,242507,0.36,273
184,THANK YOU! #MAGA🇺🇸 https://t.co/v8KfvhqnXE,120859,26755,2019,67616848,147614,0.22,42
185,"The Do Nothing, Radical Left Democrats have just announced that they are going to seek to Impeach me over NOTHING. They already gave up on the ridiculous Mueller “stuff,” so now they hang their hats on two totally appropriate (perfect) phone calls with the Ukrainian President....",81997,21175,2019,67616848,103172,0.15,280
186,"The Do Nothing Democrats had a historically bad day yesterday in the House. They have no Impeachment case and are demeaning our Country. But nothing matters to them, they have gone crazy. Therefore I say, if you are going to impeach me, do it now, fast, so we can have a fair....",132068,33610,2019,67616848,165678,0.25,279
187,"Tremendous things achieved for U.S. on my NATO trip. Proudly for our Country, no President has ever achieved so much in so little time. Without a U.S. increase, other countries have already increased by $130 Billion-with $400 Billion soon. Such a thing has never been done before!",70336,16838,2019,67616848,87174,0.13,280
188,"When I said, in my phone call to the President of Ukraine, “I would like you to do US a favor though because our country has been through a lot and Ukraine knows a lot about it.” With the word “us” I am referring to the United States, our Country. I then went on to say that......",100055,21657,2019,67616848,121712,0.18,280
189,"Just read the best Maureen Dowd column, in the New York Times, EVER (although she treated me great before politics), but it was written by her brother, Kevin. Someone in the News Media should hire her wonderful, talented, and very smart brother! https://t.co/lO9s1qLK8A",47430,13461,2019,67616848,60891,0.09,269
190,".@NATO has now recognized SPACE as an operational domain and the alliance is STRONGER for it. U.S. leadership ensures peace through strength and we must continue to show strength and WIN on all fronts – land, air, sea, and SPACE!",68980,16684,2019,67625690,85664,0.13,229
191,"The Fake News Media is doing everything possible to belittle my VERY successful trip to London for NATO. I got along great with the NATO leaders, even getting them to pay $130 Billion a year more, &amp; $400 Billion a year more in 3 years. No increase for U.S., only deep respect!",148849,33874,2019,67625690,182723,0.27,280
192,"Great progress has been made by NATO over the last three years. Countries other than the U.S. have agreed to pay 130 Billion Dollars more per year, and by 2024, that number will be 400 Billion Dollars. NATO will be richer and stronger than ever before....",82615,18312,2019,67625690,100927,0.15,255
193,Enjoyed my meeting with Prime Minister @BorisJohnson of the United Kingdom at @10DowningStreet last night. Talked about numerous subjects including @NATO and Trade.,61845,12867,2019,67625690,74712,0.11,164
194,Thank you! https://t.co/KDVaYDKZLa,64805,12509,2019,67625690,77314,0.11,34
195,Too bad. We will miss you Kamala! https://t.co/QQd9SiFc0y,115462,20796,2019,67625690,136258,0.2,57
196,"The United States of America supports the brave people of Iran who are protesting for their FREEDOM. We have under the Trump Administration, and always will!",124701,27078,2019,67625690,151779,0.22,157
197,True! https://t.co/Mr1L4Vv3eA,61857,15412,2019,67625690,77269,0.11,29
198,"Mini Mike Bloomberg has instructed his third rate news organization not to investigate him or any Democrat, but to go after President Trump, only. The Failing New York Times thinks that is O.K., because their hatred &amp; bias is so great they can’t even see straight. It’s not O.K.!",126362,32636,2019,67625690,158998,0.24,283
199,"Just landed in the United Kingdom, heading to London for NATO meetings tomorrow. Prior to landing I read the Republicans Report on the Impeachment Hoax. Great job! Radical Left has NO CASE. Read the Transcripts. Shouldn’t even be allowed. Can we go to Supreme Court to stop?",105819,23682,2019,67625690,129501,0.19,274
200,"The Fed should lower rates (there is almost no inflation) and loosen, making us competitive with other nations, and manufacturing will SOAR! Dollar is very strong relative to others.",70746,17356,2019,67625690,88102,0.13,182
201,"Manufacturers are being held back by the strong Dollar, which is being propped up by the ridiculous policies of the Federal Reserve - Which has called interest rates and quantitative tightening wrong from the first days of Jay Powell!",55464,14822,2019,67625690,70286,0.1,234
202,https://t.co/zlfV4MOkom,30669,9791,2019,67625690,40460,0.06,23
203,Thank you to President Zelensky. Case over. The Do Nothing Democrats should finally go back to work! https://t.co/XrJSUsm9Wq,56683,16817,2019,67625690,73500,0.11,124
204,"In the 3 decades before my election, NATO spending declined by two-thirds, and only 3 other NATO members were meeting their financial obligations. Since I took office, the number of NATO allies fulfilling their obligations more than DOUBLED, and NATO spending increased by $130B!",57045,15370,2019,67625690,72415,0.11,279
205,"Great job by @RepDougCollins of Georgia over the weekend in representing the Republican Party, and myself, against the Impeachment Hoax!",43173,10493,2019,67625690,53666,0.08,136
206,"When Lisa Page, the lover of Peter Strzok, talks about being “crushed”, and how innocent she is, ask her to read Peter’s “Insurance Policy” text, to her, just in case Hillary loses. Also, why were the lovers text messages scrubbed after he left Mueller. Where are they Lisa?",106193,29806,2019,67625690,135999,0.2,274
207,"The Republican Party has NEVER been so united! This Impeachment Scam is just a continuation of the 3 year Witch Hunt, but it is only bringing us even closer together!",90295,20363,2019,67625690,110658,0.16,166
208,"Not only did I see it @Doks_Art, I think it is fantastic. You are a wonderful artist, never give up your dream! https://t.co/LVVCUJz5CW",114896,31757,2019,67625690,146653,0.22,135
209,Thank you to Great Republican @SenJohnKennedy for the job he did in representing both the Republican Party and myself against Sleepy Eyes Chuck Todd on Meet the Depressed!,68892,16550,2019,67625690,85442,0.13,171
210,"Thank you to Congressman Ben @Cline4Virginia for the Great remarks this morning on the illegitimate Impeachment Hoax. He understands the Do Nothing Democrats very well. Also, and as usual, @RepAndyBiggsAZ was fantastic!",33498,8567,2019,67625690,42065,0.06,219
211,Heading to Europe to represent our Country and fight hard for the American People while the Do Nothing Democrats purposely scheduled an Impeachment Hoax hearing on the same date as NATO. Not nice! https://t.co/LCXYhoOWF6,80120,19994,2019,67625690,100114,0.15,220
212,"The Do Nothing Democrats get 3 Constitutional lawyers for their Impeachment hoax (they will need them!), the Republicans get one. Oh, that sounds fair!",75986,18416,2019,67625690,94402,0.14,151
213,"“When the law enforcers turn out to be the law breakers, then we have totally upended the rule of law. Nobody is safe and everybody is in trouble. Our system of government is under attack.”  @GovMikeHuckabee",67006,20402,2019,67625690,87408,0.13,207
214,"“The Democrats don’t have any evidence, but they are still going to do it anyway. That’s the sham that’s going on here.”  @jasoninthehouse Chaffetz",44788,11586,2019,67625690,56374,0.08,147
215,"Breaking News: The President of Ukraine has just again announced that President Trump has done nothing wrong with respect to Ukraine and our interactions or calls. If the Radical Left Democrats were sane, which they are not, it would be case over!",122371,32683,2019,67625690,155054,0.23,247
216,"“The United States has outperformed the rest of the world in an eye popping fashion. I don’t think we’ve seen numbers like that.” Mohamed El-Erian, Allianz Chief Economic Adviser. But despite this there is tremendous potential for growth, far greater than most have understood!",52874,13560,2019,67625690,66434,0.1,277
217,"“The American people are going to see this for what it is. It is a political effort by the Democrats, and the President certainly doesn’t have to aid in the Impeachment effort.” Robert Ray @MariaBartiromo  Democrats are getting “killed” in their home districts. 2020!",46643,12555,2019,67625690,59198,0.09,267
218,"“The process has been unfair. Republicans can’t even get their own witnesses. It gets me that Adam Schiff is not punishable for lying, in any way.” @MariaBartiromo",59021,15005,2019,67625690,74026,0.11,163
219,"U.S. Markets are up as much as 21% since the announcement of Tariffs on 3/1/2018 - and the U.S. is taking in massive amounts of money (and giving some to our farmers, who have been targeted by China)!",59797,14056,2019,67625690,73853,0.11,200
220,"Brazil and Argentina have been presiding over a massive devaluation of their currencies. which is not good for our farmers. Therefore, effective immediately, I will restore the Tariffs on all Steel &amp; Aluminum that is shipped into the U.S. from those countries. The Federal....",75941,20169,2019,67625690,96110,0.14,280
221,“It is clear that there is none of the bipartisan support that Speaker Pelosi said for months was essential for Impeachment.” Chris Wallace @FoxNews,46303,11332,2019,67625690,57635,0.09,148
222,“Trump Economy Breaks Holiday Shopping Records.” @FoxNews,54852,12944,2019,67625690,67796,0.1,57
223,"Great writer and historian, Doug Wead, has written a true (not Fake News) account of what is going on in Washington and the White House. His new book, INSIDE TRUMP’S WHITE HOUSE, is an incredible description of a very exciting and successful time in our Country’s history. Buy it!",60360,14635,2019,67625690,74995,0.11,280
224,"“Donald Trump was framed back in 2016.” @MariaBartiromo  100% correct, Maria, and we can never let this happen to another president again!",69564,17824,2019,67625690,87388,0.13,138
225,"On World AIDS Day, The First Lady and I express our support for those living with HIV/AIDS and mourn the lives lost. We reaffirm our commitment to end the HIV/AIDS epidemic....",96912,19708,2019,67625690,116620,0.17,176
226,“Schiff’s impeachment hearings wasting time when Congress must do real work” https://t.co/4lb9bWrVRL,86072,22377,2019,67625690,108449,0.16,100
227,"“Trump did nothing impeachable, day-by-day review of all impeachment hearing testimony shows” @GreggJarrett https://t.co/QbFeEmWkTB",51602,14353,2019,67625690,65955,0.1,131
228,"“Sen. Tim Scott Says Trump 'Innocent,' 'No Way' Senate Convicts” https://t.co/P6ONkI8n0P",57830,16052,2019,67625690,73882,0.11,88
229,An incredible experience! https://t.co/n6BNQY6dIx,63915,14591,2019,67625690,78506,0.12,49
230,Nancy Pelosi won’t put it up for a vote. Has delayed it for 6 months. See you in #2020! https://t.co/lOrWm9u10r,70182,20747,2019,67625690,90929,0.13,111
231,"I will be representing our Country in London at NATO, while the Democrats are holding the most ridiculous Impeachment hearings in history. Read the Transcripts, NOTHING was done or said wrong! The Radical Left is undercutting our Country. Hearings scheduled on same dates as NATO!",106358,26090,2019,67625690,132448,0.2,280
232,Robert Johnson knows business &amp; politics. He also understands lowest African American Unemployment in U.S. history! https://t.co/NalNOFG53T,42333,11394,2019,67625690,53727,0.08,143
233,And the Do Nothing Democrats want to impeach President Trump? https://t.co/i3tPDJtuuA,70850,16010,2019,67625690,86860,0.13,85
234,Thank you to @BuckMcNeely1 and Oliver North for the nice words and thoughts in an excellent interview. Best wishes!,33599,7112,2019,67625690,40711,0.06,115
235,https://t.co/AUoFQexhR4,47399,14027,2019,67625690,61426,0.09,23
236,Just returned to the United States after spending a GREAT Thanksgiving with our Courageous American Warriors in Afghanistan! https://t.co/b2vgY5BH6z,212990,40132,2019,67625690,253122,0.37,148
237,I thought Newsweek was out of business? https://t.co/3ro4eSJloo,183114,43158,2019,67625690,226272,0.33,63
238,HAPPY THANKSGIVING! https://t.co/7SGZnHindW,285279,68569,2019,67625690,353848,0.52,43
239,HAPPY THANKSGIVING! https://t.co/2GoxJEk6fN,196034,33754,2019,67625690,229788,0.34,43
240,95% Approval Rating in the Republican Party. Thank you!,179072,28033,2019,67625690,207105,0.31,55
241,"New Stock Market Record today, AGAIN. Congratulations USA!",133033,24180,2019,67625690,157213,0.23,58
242,People now realize it is a Democrat Hoax! https://t.co/6O3lFa2wU7,82019,19206,2019,67625690,101225,0.15,65
243,https://t.co/11nzKwOCtU,699949,201291,2019,67625690,901240,1.33,23
244,"GOD BLESS THE U.S.A.! #MAGA
https://t.co/CYkQGHAgcx",131297,30484,2019,67625690,161781,0.24,52
245,https://t.co/Jd7IbQBUvu,75816,18223,2019,67625690,94039,0.14,23
246,THANK YOU FLORIDA! #KAG2020 https://t.co/mNB4KMEj9u,91406,20872,2019,67625690,112278,0.17,51
247,“OMB Official: Ukraine Aid Held Up Because Other Countries Weren't Giving” https://t.co/nYwMq3M5SB,59940,18268,2019,67625690,78208,0.12,98
248,https://t.co/1EYKod0tee,78313,18375,2019,67625690,96688,0.14,23
249,"The D.C. Wolves and Fake News Media are reading far too much into people being forced by Courts to testify before Congress. I am fighting for future Presidents and the Office of the President. Other than that, I would actually like people to testify. Don McGahn’s respected....",89468,22485,2019,67625690,111953,0.17,277
250,"When the Military rips down an old &amp; badly broken Border Wall in an important location, &amp; replaces it with a brand new 30 ft. high Steel &amp; Concrete Wall, Nancy Pelosi says we are not building a Wall. Wrong, and it is going up fast. Brandon Judd just gave us great marks! @FoxNews",97175,23448,2019,67625690,120623,0.18,291
251,I will always protect our great warfighters. I’ve got your backs!,159415,29740,2019,67625690,189155,0.28,65
252,Great job Heather! https://t.co/8OX8wkug4t,32109,6821,2019,67625690,38930,0.06,42
253,"“Poll shows Dems losing interest in Impeachment inquiry all across the board. These Polls are actually devastating to the Democrats. But the writing was on the wall. He’s done so many great things. He’s devastated ISIS &amp; killed AlBaghdadi, building Wall.” Jason Meister @FoxNews",63748,15356,2019,67625690,79104,0.12,282
254,https://t.co/Rya9MUlX1v,31692,8939,2019,67625690,40631,0.06,23
255,“Democrats committed to impeaching Trump for no reason.” Will backfire into big 2020 Victory for Republicans! @IngrahamAngle,77181,16303,2019,67625690,93484,0.14,124
256,"“DOW, NASDAQ, S&amp;P 500 CLOSE AT RECORD HIGHS” https://t.co/q8IuuuUGjb",85449,21893,2019,67625690,107342,0.16,72
257,https://t.co/BETsNAWsNs,64861,15667,2019,67625690,80528,0.12,23
258,Another new Stock Market Record. Enjoy!,128550,23093,2019,67625690,151643,0.22,39
259,“The Democrats are getting hit and slammed on Impeachment. It is getting less and less popular by the day.” @kilmeade @foxandfriends,75788,16721,2019,67625690,92509,0.14,132
260,"Support for Impeachment is dropping like a rock, down into the 20’s in some Polls. Dems should now get down to work and finally approve USMCA, and much more!",115058,27042,2019,67625690,142100,0.21,157
261,“President Trump is facing a process which is unprecedented for its unfairness.” Sam Dewey,79001,16387,2019,67625690,95388,0.14,90
262,"I was not pleased with the way that Navy Seal Eddie Gallagher’s trial was handled by the Navy. He was treated very badly but, despite this, was completely exonerated on all major charges. I then restored Eddie’s rank. Likewise, large cost overruns from past administration’s.....",94992,23173,2019,67625690,118165,0.17,279
263,Democrats going back to their Districts for Thanksgiving are getting absolutely hammered by their constituents over the phony Impeachment Scam. Republicans will have a great #2020 Election!,108839,25285,2019,67625690,134124,0.2,189
264,"“The whole Russia thing was a Hoax, and the Ukraine thing is a Hoax, and the Democrats are a Joke. This is a disaster for them!” @DevinNunes @FoxNews The Do Nothing Democrats are hurting our Country, and they don’t care!",81148,22270,2019,67625690,103418,0.15,220
265,"The Impeachment Scam is driving Republican Poll Numbers UP, UP, UP! Thank you Shifty.",116852,25402,2019,67625690,142254,0.21,85
266,"This is a great and well reseached book on Justice K. The Ruth Marcus book is a badly written &amp; reseached disaster. So many incorrect facts. Fake News, just like the @washingtonpost! https://t.co/i6GwghuEsU",30206,9016,2019,67625690,39222,0.06,210
267,Witch Hunt! https://t.co/CvZtyHMsGo,41504,11863,2019,67625690,53367,0.08,35
268,But I did nothing wrong. Read the Transcripts (2)! https://t.co/Ef9O5kOgrg,33848,8414,2019,67625688,42262,0.06,74
269,100% Correct! https://t.co/VJfkmaraGV,35217,8862,2019,67625688,44079,0.07,37
270,"Agnes, your great boy Ronald is looking down, very proud of you! https://t.co/BHPu6IIdAN",57870,16744,2019,67625688,74614,0.11,88
271,Exclusive: Elise Stefanik Reflects on Her Two-Week Whirlwind https://t.co/5SownqVBuD,23043,6297,2019,67625688,29340,0.04,84
272,The Unspoken Truth: What Impeachment Exposed About Trump and 2020 https://t.co/pYTYBcD55I,26509,8124,2019,67625688,34633,0.05,89
273,This is the real story behind the Do Nothing Democrats! https://t.co/4tPTICdSR1,66424,23280,2019,67625688,89704,0.13,79
274,"Too bad we didn’t have the G-7 here. I offered to pick up the entire cost, would have saved at least $35,000,000 for the USA. Best location. Very stupid people thought I would gain. Wrong! Looking at Camp David. Will announce soon. https://t.co/8RF7IHVyxN",65764,17128,2019,67625688,82892,0.12,255
275,"Polls have now turned very strongly against Impeachment, especially in swing states. 75% to 25%. Thank you!",143244,29326,2019,67625688,172570,0.26,107
276,"Nancy Pelosi, Adam Schiff, AOC and the rest of the Democrats are not getting important legislation done, hence, the Do Nothing Democrats. USMCA, National Defense Authorization Act, Gun Safety, Prescription Drug Prices, &amp; Infrastructure are dead in the water because of the Dems!",91198,27285,2019,67625688,118483,0.18,282
277,"Navy Seal Eddie Gallagher will be on @foxandfriends this morning at 7:30 A.M. Have no fear, all will end well for everyone!",59741,12616,2019,67625688,72357,0.11,123
278,Pushed hard to have Apple build in USA! https://t.co/BRfXBkJdc2,75884,16750,2019,67625688,92634,0.14,63
279,https://t.co/XexXL5HYRU,45619,15265,2019,67625688,60884,0.09,23
280,https://t.co/x7ATRLwGpY,33456,9739,2019,67625688,43195,0.06,23
281,https://t.co/iSzJDM7CZw,35780,10817,2019,67625688,46597,0.07,23
282,"95% Approval Rate in the Republican Party, a record! Thank you!",150990,27814,2019,67625688,178804,0.26,63
283,Thank you Kevin for the nice words! https://t.co/DfY1V38EhD,40571,8813,2019,67625688,49384,0.07,59
284,"NEW YORK POST EDITORIAL. “Worse Than Pointless. All those hours of televised testimony plainly failed on their announced goal: to change American’s minds. Part of the problem is that Democrats already leaked the best evidence they had. More important, NOT ONE WITNESS OFFERED.....",69602,17916,2019,67625688,87518,0.13,280
285,"Daniel Cameron, who just won the A.G. race in the Great Commonwealth of Kentucky, is a young and very talented political star. You will be hearing much from Cameron in the years to come!",57937,12824,2019,67625688,70761,0.1,186
286,"“The Democrats dirty tricks have started this whole thing. The Whistleblower, the guy who took his case to Schiff’s staff first, is what really blows the lid off this entire saga. He worked for Biden on Ukraine policy when Biden was VP. He worked for deep state henchman John",70003,20099,2019,67625688,90102,0.13,275
287,"Joe Concha, The Hill: “In Emerson College Poll, Impeachment among independents, 49% Oppose, 34% Support. You see why Pelosi is reluctant to go in with this. Dems have to go home and explain why they haven’t done something on Opioid crisis, drug prices, USMCA, the Border, etc.",75126,20047,2019,67625688,95173,0.14,276
288,"Adam Schiff will be compelled to testify should the Democrats decide, despite the fact that my presidential conversations were totally appropriate (perfect), to go forward with the Impeachment Hoax. Polls have now turned very strongly against Impeachment!",108688,25686,2019,67625688,134374,0.2,255
289,“The support for Impeachment is not there. I think the Democrats will have to come up with a new game plan.” @jasoninthehouse @FoxNews,95181,20885,2019,67625688,116066,0.17,134
290,https://t.co/Mn4EJ7Jbh8,107408,32501,2019,67625688,139909,0.21,23
291,.@SecAzar and I will soon release a plan to let Florida and other States import prescription drugs that are MUCH CHEAPER than what we have now! Hard-working Americans don’t deserve to pay such high prices for the drugs they need. We are fighting DAILY to make sure this HAPPENS...,77785,20363,2019,67625688,98148,0.15,280
292,"Thank you to @senatemajldr Mitch McConnell and @GOPLeader Kevin McCarthy for their Great Leadership! There has never been so much unity and spirit in the Republican Party, as there is right now!",75512,17993,2019,67625688,93505,0.14,194
293,"I will be interviewed on @foxandfriends this morning at 8:00 A.M. I know that there’s not much to talk about, but we will try to keep the conversation going. Enjoy! @SteveDoocy @ainsleyearhardt @kilmeade",67643,13211,2019,67625688,80854,0.12,203
294,"“Former FBI Employee Accused of Altering FISA Documents.” Hello, here we go! @foxandfriends",115824,32547,2019,67625688,148371,0.22,91
295,https://t.co/h92LyjD0Eh,30196,9229,2019,67625688,39425,0.06,23
296,"Thank you @EliseStefanik and @SteveScalise, GREAT JOB! https://t.co/K8qQbCAXbj",42407,12297,2019,67625688,54704,0.08,78
297,https://t.co/HvYx12NUkS,50803,16593,2019,67625688,67396,0.1,23
298,MARK LEVIN ON IMPEACHMENT HYSTERIA! https://t.co/sFT4qGqajO,39990,13880,2019,67625688,53870,0.08,59
299,"""SCHIFF'S CHARADE"" @SeanHannity https://t.co/Go2HsiEyTT",35110,11030,2019,67625688,46140,0.07,55
300,"SCHIFF'S ""FACT"" WITNESSES! https://t.co/Pab2y1BVoN",116817,43981,2019,67625688,160798,0.24,50
301,Iran has become so unstable that the regime has shut down their entire Internet System so that the Great Iranian people cannot talk about the tremendous violence taking place within the country....,85072,24851,2019,67625688,109923,0.16,197
302,"Ken Starr, Former Independent Counsel: “Does this reach the level of treason, bribery or other high crimes and misdemeanors? My assessment of the evidence so far, NO WHERE CLOSE. The evidence is conflicting &amp; ambiguous. Ambassador Sondland’s testimony stated that....",64729,17463,2019,67625688,82192,0.12,271
303,"I have been watching people making phone calls my entire life. My hearing is, and has been, great. Never have I been watching a person making a call, which was not on speakerphone, and been able to hear or understand a conversation. I’ve even tried, but to no avail. Try it live!",115350,24581,2019,67625688,139931,0.21,279
304,Read the two Transcripts of Ukrainian calls!,66980,14761,2019,67625688,81741,0.12,44
305,The Navy will NOT be taking away Warfighter and Navy Seal Eddie Gallagher’s Trident Pin. This case was handled very badly from the beginning. Get back to business!,89645,23570,2019,67625688,113215,0.17,163
306,“The new House Resolution gives Adam Schiff (the most dishonest man in politics) the power unilaterally to release edited transcripts. Rule 10 gives Chairman Schiff absolutely no jurisdiction. Subpoenas issued as part of Dems’ Impeachment inquiry are illegal.” Sam Dewey @FoxNews,46283,13539,2019,67625688,59822,0.09,279
307,"Corrupt politician Adam Schiff’s lies are growing by the day. Keep fighting tough, Republicans, you are dealing with human scum who have taken Due Process and all of the Republican Party’s rights away from us during the most unfair hearings in American History......",71327,19408,2019,67625688,90735,0.13,266
308,"I never in my wildest dreams thought my name would in any way be associated with the ugly word, Impeachment! The calls (Transcripts) were PERFECT, there was NOTHING said that was wrong. No pressure on Ukraine. Great corruption &amp; dishonesty by Schiff on the other side!",88895,20362,2019,67625688,109257,0.16,272
309,“Freed Taliban hostages arrive in Germany.” @foxandfriends  @FoxNews @OANN  We got them back!,42839,11732,2019,67625688,54571,0.08,93
310,"Bob Mueller, after spending two years and 45 million dollars, went over all of my financials, &amp; my taxes, and found nothing. Now the Witch Hunt continues with local New York Democrat prosecutors going over every financial deal I have ever done. This has never happened to a.....",67950,17746,2019,67625688,85696,0.13,282
311,"The Republican Party, and me, had a GREAT day yesterday with respect to the phony Impeachment Hoax, &amp; yet, when I got home to the White House &amp; checked out the news coverage on much of television, you would have no idea they were reporting on the same event. FAKE &amp; CORRUPT NEWS!",117880,27688,2019,67625688,145568,0.22,291
312,"During my visit yesterday to Austin, Texas, for the startup of the new Mac Pro, &amp; the discussion of a new one $billion campus, also in Texas, I asked Tim Cook to see if he could get Apple involved in building 5G in the U.S. They have it all - Money, Technology, Vision &amp; Cook!l",55006,12823,2019,67625688,67829,0.1,285
313,"Why do @ShannonBream &amp; @FoxNews waste airtime on Democrat Rep. Eric Swalwell, who recently left the Presidential Primaries having attained a grand number of ZERO in the polls. I don’t even know how that is possible. Fox should stay with the people that got them there, not losers!",49557,12395,2019,67625688,61952,0.09,284
314,https://t.co/osezECwPO1,73783,27746,2019,67625688,101529,0.15,23
315,Poll: Trump leads top 2020 Democrats in Wisconsin https://t.co/P7z7Si8I0h.,57769,15203,2019,67625688,72972,0.11,74
316,"“All four of Gordon Sondland’s lawyers are Democrat Donors.” @TuckerCarlson  Despite this, big win today for Republicans!",66524,17507,2019,67625688,84031,0.12,121
317,"Watch @TuckerCarlson, @seanhannity, @IngrahamAngle. Big News! @FoxNews",41428,10406,2019,67625688,51834,0.08,70
318,https://t.co/ytr7dRvbUc https://t.co/G6lGfyxSUs,69472,18426,2019,67625688,87898,0.13,47
319,"If this were a prizefight, they’d stop it!",124647,24820,2019,67625688,149467,0.22,42
320,Today I opened a major Apple Manufacturing plant in Texas that will bring high paying jobs back to America. Today Nancy Pelosi closed Congress because she doesn’t care about American Workers!,134699,33252,2019,67625688,167951,0.25,191
321,I WANT NOTHING! https://t.co/KKUfwSIRAi,63634,17151,2019,67625688,80785,0.12,39
322,"Impeachment Witch Hunt is now OVER! Ambassador Sondland asks U.S. President (me): “What do you want from Ukraine? I keep hearing all these different ideas &amp; theories. What do you want? It was a very abrupt conversation. He was not in a good mood. He (the President) just said,”...",97535,24952,2019,67625688,122487,0.18,284
323,We join families of Kevin King &amp; Tim Weeks in celebrating their release from Taliban captivity. Thanks to President Ghani for his courageous support. Let’s hope this leads to more good things on the peace front like a ceasefire that will help end this long war. Proud of my team!,53116,14226,2019,67625688,67342,0.1,283
324,https://t.co/HbgEgZsPZ9,51159,15389,2019,67625688,66548,0.1,23
325,"Nancy Pelosi will go down as the least productive Speaker of the House in history. She is dominated by AOC Plus 3 and the Radical Left. Mexico and Canada, after waiting for 6 months to be approved, are ready to flee - and who can blame them? Too bad!",110722,28370,2019,67625688,139092,0.21,250
326,“White House Confidence Grows As Hearings Wear On.” @WashTimes  This is just an attempted takedown of the Republican Party by the Do Nothing Democrats. It will never work. #2020,62298,16417,2019,67625688,78715,0.12,177
327,The three year Hoax continues! https://t.co/Yht2KQb5aW,47486,13454,2019,67625688,60940,0.09,54
328,True. Great job @RepMikeTurner! https://t.co/T0AdyNLuVb,36516,11259,2019,67625688,47775,0.07,55
329,Read the transcripts! https://t.co/gQxYzjWehV,44269,12294,2019,67625688,56563,0.08,45
330,Thank you Tennessee! https://t.co/MYP1FaJhUx,61713,16411,2019,67625688,78124,0.12,44
331,"Congressman Van Drew (D-NJ): We’ve spent millions of Dollars, in my opinion, tons of money, tons of time, tons of hurt, fracturing the Nation apart. I haven’t seen this to be a good thing.”",81721,20096,2019,67625688,101817,0.15,189
332,"A great day for Republicans, a great day for our Country!",159696,28823,2019,67625688,188519,0.28,57
333,"I agree, but in the end we will win and save our Country from certain destruction! https://t.co/CPjdxq5hXT",82720,22195,2019,67625688,104915,0.16,106
334,https://t.co/z0I7wBsgTP,69632,21083,2019,67625688,90715,0.13,23
335,https://t.co/HvYx12NUkS,72078,26260,2019,67625688,98338,0.15,23
336,NASDAQ UP 27% THIS YEAR ALONE!,105130,20109,2019,67625688,125239,0.19,30
337,"Nancy Pelosi just stated that “it is dangerous to let the voters decide Trump’s fate.” @FoxNews  In other words, she thinks I’m going to win and doesn’t want to take a chance on letting the voters decide. Like Al Green, she wants to change our voting system. Wow, she’s CRAZY!",145548,42796,2019,67625688,188344,0.28,276
338,The Do Nothing Democrats have disgraced our great Country! https://t.co/lcSs55Wo18,65420,18939,2019,67625688,84359,0.12,82
339,"At my meeting with Jay Powell this morning, I protested fact that our Fed Rate is set too high relative to the interest rates of other competitor countries. In fact, our rates should be lower than all others (we are the U.S.). Too strong a Dollar hurting manufacturers &amp; growth!",76925,18310,2019,67625688,95235,0.14,282
340,Mark Levin speaking one week after I took office. This was always a planned COUP and the Radical Left Democrats will suffer at the polls in 2020! https://t.co/XHd5grQUaM,78774,25162,2019,67625688,103936,0.15,169
341,GREAT NEWS! #MAGA #KAG https://t.co/GXDE2IlGGu,60761,15985,2019,67625688,76746,0.11,46
342,THANK YOU! #MAGA #KAG https://t.co/igO1r1cTHS,63129,15081,2019,67625688,78210,0.12,45
343,https://t.co/BKo27n6tmz,41771,12867,2019,67625688,54638,0.08,23
344,“Congressman Van Drew (D-NJ) SLAMS Democrats for ‘fracturing the Nation’ with Impeachment probe. ‘We already know how it’s going to end.” @FoxNews,71188,18885,2019,67625688,90073,0.13,146
345,"Just finished a very good &amp; cordial meeting at the White House with Jay Powell of the Federal Reserve. Everything was discussed including interest rates, negative interest, low inflation, easing, Dollar strength &amp; its effect on manufacturing, trade with China, E.U. &amp; others, etc.",75490,17339,2019,67625688,92829,0.14,292
346,"Our Crazy, Do Nothing (where’s USMCA, infrastructure, lower drug pricing &amp; much more?) Speaker of the House, Nervous Nancy Pelosi, who is petrified by her Radical Left knowing she will soon be gone (they &amp; Fake News Media are her BOSS), suggested on Sunday’s DEFACE THE NATION....",74131,20297,2019,67625688,94428,0.14,288
