,full_text,favorite_count,retweet_count,created_at,user.followers_count,engagement,performance,twtlength
0,"La noche del gol me está dando vida ahorita😂.

@DeportesTVC",73,3,2019,1898,76,4.0,61
1,ENORME TEOFIMO🇭🇳.,40,5,2019,1898,45,2.37,17
2,Se me quemaron los ojos PORQUE EL FUTURO BRILLAAAA🏆🐾🦁 https://t.co/hWlmD4zrW8,118,8,2019,1898,126,6.64,77
3,Esoooo👍🏼 https://t.co/4xAe5CMRkI,52,6,2019,1898,58,3.06,32
4,"Presidente Eterno.

🖥: @Matamorosfilms https://t.co/VIZimNcvzc",173,41,2019,1898,214,11.28,64
5,Rey de Copas🥂🏆 https://t.co/Qi0OD22Oi0,153,18,2019,1898,171,9.01,38
6,Muy orgulloso de mis amigos de El Milenio. ¡Que excelente iniciativa para que los niños de Olancho tengan una linda navidad🎄! https://t.co/DbiSLStNgf,29,4,2019,1898,33,1.74,149
7,"31 sabores de Baskin Robins, cuál es tu favorito? https://t.co/w9h0f9dl5x",168,17,2019,1898,185,9.75,73
8,"Por los millones de Olimpistas por el mundo, nos vieron volver🏆

¡Juntos! ¡SIEMPRE JUNTOS! https://t.co/x6KLfHnUMG",364,59,2019,1898,423,22.29,116
9,UNA BLANCA NAVIDAD!!! https://t.co/3QUhXvUEHD,307,49,2019,1898,356,18.76,45
10,YA SE ACERCA NOCHE BUENA! YA SE ACERCA NAVIDAD!,176,19,2019,1898,195,10.27,47
11,"Somos uno. Y sabé que pase lo que pase, JAMÁS jugaras en silencio.

Es hoy Olimpia, que nos escuche toda Honduras. ¡JUNTOS! ¡SIEMPRE JUNTOS! ❤️💙 https://t.co/fWdrOLfVa3",233,38,2019,1898,271,14.28,170
12,"Mañana vas con la blanca, la roja... Negra? La del 2003 con AT&amp;T de spónsor. Mañana cada quién juega su propia cábala desde temprano antes de ir al estadio. 

Buenas noches Olimpismo. Que lo recordemos siempre🦁🇳🇱. https://t.co/Oo4PR3bRP7",169,17,2019,1898,186,9.8,243
13,"¡El Domingo por la 31!
¡El Domingo por la 31!
¡El Domingo por la 31!

VAMOS MI LEÓN, QUEREMOS LA COPA🏆.",264,70,2019,1898,334,17.6,107
14,Y dale Olimpia alegría a mi corazón🎶,82,8,2019,1898,90,4.74,36
15,NaNaNaNaNaNaNa NANAY!,25,4,2019,1898,29,1.53,21
16,"JERRRYYYY RICARDOOO🦁🇳🇱

PUM!",33,4,2019,1898,37,1.95,30
17,"No entiendo que los Olimpistas se alteren.

1. Ya sabemos como son. 
2. Ese es el precio de ser el mas grande.

Preocupemonos cuándo no hablen de nosotros, mas bien. Positivismo a 100% en el campamento Olimpia...

¡Juntos! ¡Siempre JUNTOS!🦁🇳🇱

#SomosHonduras",314,67,2019,1898,381,20.07,267
18,OLIMPIA🦁🇳🇱.,72,10,2019,1898,82,4.32,11
19,"Que orgullo este grupo. La historia sigue porque en Olimpia la escribimos en nuestro dia a dia™️. 

¡Juntos! ¡SIEMPRE JUNTOS!🦁🇳🇱

#OlimpiaDNA https://t.co/Ovsa6Bvm0r",289,39,2019,1898,328,17.28,169
20,BLAH BLAH BLAHHHH🤫🤫🤫🤫,44,5,2019,1898,49,2.58,21
21,VAMOS BENGUUU PUM!💥,71,4,2019,1898,75,3.95,19
22,"Eternamente orgulloso. Nos demuestra la importancia de enfócarnos en los problemas núcleares, en lugar de los detalles y sabores de las soluciones. No perdamos la brújula ni por orgullo ni por populismo.

Símbolo de ese 'norte', en los 8 centros Teletón en Honduras: JRFS. https://t.co/V6no1LiyjF",159,11,2019,1898,170,8.96,298
23,Solo quejas.. Acá la realidad. https://t.co/4Q3tIVdYJn,273,60,2019,1898,333,17.54,54
24,"44 puntos. Seguimos haciendo historia. 

¡Juntos, siempre juntos!🦁🇳🇱",184,29,2019,1898,213,11.22,70
25,44.,46,7,2019,1898,53,2.79,3
26,FERRARI VAMOS!,29,1,2019,1898,30,1.58,14
27,"Que hoy quede para la historia. 

🎶¡En la costa nos quieren porque somos el mejor!",100,7,2019,1898,107,5.64,84
28,"Me pongo de pié por las palabras de @allanfajardo29 en Fútbol a Fondo hace unos instantes. 👏

@DeportesTVC",49,2,2019,1898,51,2.69,108
29,"Hay buenas noticias🏥🙏🏼.

Seguimos adelante. ¡Vamos Olimpia!

@MejiaPaton",185,26,2019,1898,211,11.12,76
30,"Mas que orgulloso de este equipo. Seguimos rugiendo paso a paso.

Hoy campeón de las vueltas. La otra semana por el record de puntos. Y con eso a conquistar esa pentagonal e ir por el campeonisimo.

Somos Olimpia. Juntos, siempre juntos🦁🇳🇱.",193,30,2019,1898,223,11.75,244
31,Patón como: 🤷🏻‍♂️,43,4,2019,1898,47,2.48,17
32,"🦁🇳🇱

¡Juntos! ¡Siempre Juntos! 

A firmar nuestro nombre en esto. https://t.co/eA6u3cV58s",237,30,2019,1898,267,14.07,93
33,"Ambiente de final, ambiente de record en vueltas, ambiente de liderato, ambiente de 'estoy en todas y me merezco esta', ambiente de volver a casa. 

Mañana mas que nunca, juntos. Siempre juntos. https://t.co/ssmvCEWu2U",175,29,2019,1898,204,10.75,220
34,"De pié👏🏼. 

Grande el Choco, desde la casa le deseamos lo mejor siempre. https://t.co/ujZLBjcBCq",93,11,2019,1898,104,5.48,98
35,"No bajamos los brazos jamás. Y siempre llevaremos estos colores con orgullo. Ahora a cerrar estos dos juegos con la grandeza que se le debe a nuestra historia.

Somos Olimpia.

¡Juntos! ¡SIEMPRE JUNTOS! 🦁❤️.",124,11,2019,1898,135,7.11,211
36,¡Estas loco Maidanaa🎩!,160,18,2019,1898,178,9.38,22
37,"GOLAZO BENGUUU.

Y RUGEEEEEE LEEEEÓN MAS QUE NUNCA❤️🦁.",64,9,2019,1898,73,3.85,56
38,juntos. siempre juntos. https://t.co/QB4w2gWdM7,180,28,2019,1898,208,10.96,47
39,"hay 📶...

¡J! ¡SJ! https://t.co/pkvZ5L1rko",33,3,2019,1898,36,1.9,44
40,"No tengo mas que ver la realidad de frente y afrontarla así. Nunca caeremos derrotados, simplemente no está en nosotros. 

Buenas noches Olimpismo, gracias por no abandonar jamás.

❤️🦁.",195,24,2019,1898,219,11.54,189
41,"Se lo debemos a nuestra historia, y a nuestra bandera.

¡Hoy juega Olimpia, hoy juega Olimpia, hoy juega Olimpia! Y mi querida Honduras está feliz.

¡Juntos! 
¡SIEMPRE JUNTOS! 🦁🇳🇱 https://t.co/gSDFzXyBkP",349,55,2019,1898,404,21.29,208
42,"""Poderoso rugido, creció con el tiempo."" 

Seguimos escribiendo historias.🦁 https://t.co/8Sb3F7vXhx",305,45,2019,1898,350,18.44,101
43,"Si, soy de Olimpia.

EL MAS GRANDE DE CENTROAMERICA.🇭🇳

¡Juntos, siempre juntos!🦁🇳🇱",220,44,2019,1898,264,13.91,87
44,"Desde temprano el Olimpismo se levanta porque esta noche cueste lo que cueste, esta noche tenemos que ganar.

¡Juntos, siempre juntos!🦁🇳🇱",145,27,2019,1898,172,9.06,139
45,"CONCACAF nos hizo jugar en menos de 72 horas cuartos y semis de champions. Hoy solo recordamos la épica hazaña.

Como siempre contra el mundo, y hasta el final juntos. La historia está de nuestro lado. 🦁🌎 https://t.co/9uuQG3mkhf",292,52,2019,1898,344,18.12,230
46,"Viernes de: ""Se puso la camisa del mas grande."" 

Los leo. https://t.co/lzq8FZ2QJW",167,29,2019,1898,196,10.33,84
47,¡EL DIEGO! https://t.co/jcrrDhyYQW,20,1,2019,1898,21,1.11,34
48,"En el clásico capitalino, la afición local se comportó a la altura, aún después de un resultado desfavorable. Cero incidentes reportados.. 

@Concacaf Las semifinales se deben jugar en suelo hondureño y con afición hondureña.",114,23,2019,1898,137,7.22,227
49,"Que enorme trabajo de este equipo❤️. Todos corriendo 95 minutos. Esto es Olimpia. 

¡JUNTOS, SIEMPRE Y HASTA EL FINAL JUNTOS🦁🇳🇱!",172,25,2019,1898,197,10.38,130
50,BENGUUU PUM PUM PUM!,44,4,2019,1898,48,2.53,20
51,PIE DE ANGEL! VAMOSSSS!,60,10,2019,1898,70,3.69,23
52,"¡Para ser campeón, hoy tenés que ganar🦁🇳🇱!

Dale, dale, dale león... https://t.co/zU8HPZM5Mt",95,15,2019,1898,110,5.8,94
53,"Orgulloso de este equipo. Estamos solamente a dos de volver a esos tiempos mágicos en la historia de este equipo. 

¡Juntos, siempre juntos🦁🇳🇱!",148,22,2019,1898,170,8.96,145
54,"Mas fotos del libro Centenario. Se puede encontrar en La Biblioteca del Congreso, en Washington D.C. 

Se tiene que pedir 2 dias por adelanto, por la magnitúd de libros y pedidos. No hay tantos libros hondureños, pero encontré Los Pioneros, sobre la historia de HRN. https://t.co/XUaOa5pxJc",75,10,2019,1898,85,4.48,292
55,"Y en un pequeño rincón de la biblioteca mas grande del mundo, encontré la Historia del Club Olimpia Deportivo. Archivado aquí, y por el resto de la eternidad humana, el nombre y escudo del mas grande de la historia.

#ElMasGrandeDeCA https://t.co/BX8xNjIok8",238,63,2019,1898,301,15.86,259
56,¡Que golazos!,34,6,2019,1898,40,2.11,13
57,"Ni la muerte nos va a separar. 

¡Juntos, siempre juntos!
🦁🇳🇱🌐 https://t.co/LOasRd00Ev",107,8,2019,1898,115,6.06,89
58,"Hoy comienza la campaña de la Fundación hondureña para el niño con cáncer. 

Aplauso @jcpineda17 @makawas @allanfajardo29 @hernandezjacobo @yanuariopaz @jcnfutbol1 por unirse a esta causa. 

Y también un aplauso y abrazo a mi hermana @Rpastorferrari por siempre luchar por ellos. https://t.co/rV5ITMpAvJ",90,11,2019,1898,101,5.32,307
59,Me va a dar algo.,35,4,2019,1898,39,2.05,17
60,Enorme Harold! Dos de dos penales ❌❌,80,8,2019,1898,88,4.64,36
61,"AUBA! 

#YaGunnersYa",5,2,2019,1898,7,0.37,22
62,"Que bien por los que manejan la cuenta del Platense. Sin ofender pero sí con sentido de humor. De eso se trata el fútbol y si no, te lo estás tomando demasiado enserio. 

El fútbol es lo mas importante de las cosas que no importan. 

@FCPlatense Tendremos nuestra revancha👀 https://t.co/saPPHozawU",68,9,2019,1898,77,4.06,301
63,"En la costa nos quieren porque somos el mejor. 

¡Hoy tenés que ganar!🦁",67,15,2019,1898,82,4.32,73
64,"#FútbolEsVida

@usembassyhn @CDOlimpia @MOTAGUAcom @RealEspanaCD @CDMarathon 

🦁🦅🚂🦖 https://t.co/eejNv1StfG",48,22,2019,1898,70,3.69,111
65,"""Esque no es de tener miedo, es de sentido común.""

2-1 la H.",77,12,2019,1898,89,4.69,63
66,"Olimpia me dió una infancia que no merezco. Como muchos, aprendí a luchar contra todo, a triunfar. 

Como adultos, sería una injusticia privar de esas experiencias a las niñas y los niños de Honduras. Eso sería privar a Honduras de un futuro próspero. 🇭🇳 https://t.co/nEcBEj3hZx",48,8,2019,1898,56,2.95,280
67,"Entiendo el punto de Mr. Chip. Pero si nos va a dar miedo enfrentar a Chile en el Morazán, para qué entónces quisiesemos ir al mundial? 

Honduras no necesita pesimistas, eso sobra. Subase al barco el que quiera apoyar, porque si no está apoyando está ______. https://t.co/GP5DRsEkjm",84,16,2019,1898,100,5.27,285
68,"""Y estoy de pie, como decía la Tota, no te murás por esta porquería.""⚽️

Grande Diego Armando.",25,1,2019,1898,26,1.37,96
69,"Orgulloso de Benguché, un jugador que ha trabajado por llegar adonde está, lo ha alcanzado, y hoy nos demuestra que se lo merece. Por este y muchos mas con la H⚽️. https://t.co/1whVSXYnyL",139,25,2019,1898,164,8.64,187
70,"Tres puntos muy valiosos contra un Minas que no lo hace tan mal. 

A nosotros nos faltan detalles todavía pero este equipó tiene CARA, mucho liderazgo. 

¡Y nuestra gente que sigue a todos lados, nunca jugamos en silencio!

¡Vamos mi león, queremos las copas!🇳🇱🦁",133,22,2019,1898,155,8.17,268
71,"Espero pecar de paranoíco, pero será que nos quieren sacar a como dé lugar😂? 

Pues la copa va a volver a casa, a como dé lugar.",125,24,2019,1898,149,7.85,130
72,"Porque este año, desde La Plata, desde La Plata, nos vino a hacer campeón!

¡Juntos, Siempre Juntos!",47,11,2019,1898,58,3.06,102
73,"DIOS MIO DEIBY DONDE LA PUSO😭

¡VAMOS!",89,19,2019,1898,108,5.69,40
74,"Tenés que dejar el alma, y el corazón. https://t.co/eF8Vpw1AWn",44,4,2019,1898,48,2.53,62
75,"Alex Pineda, Wilson Palacios, Chaco Maidana. 

Tres privilegios🔮🎩 de mi época.",120,14,2019,1898,134,7.06,80
76,"Llegó el Cañonero del Aguán⚽️. 

¡0-1 Olimpia!",33,4,2019,1898,37,1.95,48
77,"Hay noches que la bola solo no entra. En la vuelta remontamos.

Juntos siempre🇳🇱🦁.",57,12,2019,1898,69,3.64,84
78,Por la séptima. Por la historia. Por Honduras. https://t.co/4YoIBEFQ6o,159,32,2019,1898,191,10.06,70
79,"¡Estamos viendo pasos de gigante! Felicidades @OrgulloMotagua, esperamos defender los colores de Honduras. https://t.co/Ps842ig5Yq",27,2,2019,1898,29,1.53,130
80,"Feliz de representar Fundación @televicentrohn como juéz del premio Yo Emprendo en Unitec. Por tercera vez quedo deslumbrado del (potencial) futuro de Honduras, un futuro que será brillante sólo si trabajamos y permitimos espacios para el emprendimiento social. https://t.co/xzYDA12Dvg",26,2,2019,1898,28,1.48,285
81,. https://t.co/9KomKPi3vv,62,9,2019,1898,71,3.74,25
82,"Las dos barras en su lugar, junto al resto de aficionados que venimos a ver FÚTBOL. Como siempre, lo que es el hondureño minoritario y antisocial, tacha una de las pocas cosas buenas que tenemos. 

Desgraciadamente hoy perdimos todos.",116,26,2019,1898,142,7.48,236
83,"Que salen a ganar, que quieren salir campeón, que lo llevan adentro. Como lo llevo yo. 

MATCHDAY 5, señores. 🦁🇳🇱",90,22,2019,1898,112,5.9,115
84,"Tres puntos importantísimos. Estas rascadas a mitád de semana son las que cuentan al final de la temporada. 

¡El sábado cueste lo que cueste🦁🇳🇱!",54,10,2019,1898,64,3.37,147
85,Nunca en silencio. ¡Mañana y el sábado nos vemos en el nacional! https://t.co/zdZLHuj6v3,56,6,2019,1898,62,3.27,88
86,"Somos un pueblo, una nación, cinco estrellas en mi corazón. Vamos mini H, estos últimos 45 nos morimos en la cancha🇭🇳",51,10,2019,1898,61,3.21,117
87,"Como me alegra el ambiente de éste Olimpia. Entre risas y buén ambiente se preparó hoy el equipo para llegar al 100% a San Pedro. 

¡Vamos Olimpia que juntos somos enormes!🇳🇱🦁

Gracias C.T. por recibirnos💪🏼
@TroglioPedro 
@Gustavoreggi19 
@pjmsports https://t.co/Y8kXtWEUnt",77,18,2019,1898,95,5.01,280
88,Vamos H💙,24,2,2019,1898,26,1.37,8
89,"6 / 6 puntos. Haciendo buen fútbol, aunque podemos seguir mejorando. Vamos!🦁🇳🇱",75,14,2019,1898,89,4.69,78
90,El malcriado de Maidana😂,80,11,2019,1898,91,4.79,24
91,WHAT A HIT SON!,10,2,2019,1898,12,0.63,15
92,¡ATCHDAY 2! Que bonito que es volver a verte Olimpia🇳🇱🦁,31,3,2019,1898,34,1.79,55
93,¡Grán inicio a la era Troglio! 3 puntos en la bolsa. Vamos por mas💪🏼🇳🇱🦁.,117,23,2019,1898,140,7.38,72
94,"¡Comenzamos! Otra temporada que no juegan 11, la jugamos millones.

¡Vamos mi león que estás obligado!🦁🇳🇱 https://t.co/JyEuuJzxLh",150,30,2019,1898,180,9.48,131
95,"Foto que me envió un amigo, desde Estambul.

Sonrían, es fútbol. 🦁🇱🇺. https://t.co/977qrYj8uX",204,28,2019,1898,232,12.22,95
96,Tremendo el Olimpia del Pedro.,64,12,2019,1898,76,4.0,30
97,"Para ser campeón, hoy tenés que ganar🎶! Que bonito que es volver a verte Olimpia❤️🦁",17,3,2019,1898,20,1.05,83
98,¡Si alguién me consigue un link para ver Olimpia vs Herediano!🙏🏼🙏🏼🙏🏼,6,2,2019,1898,8,0.42,68
99,"En un baño de Washington volteo y está Joaquín (de todas las personas).

Joaquín cuándo jugamos al tennis?

Joaquín: ""cuando quieras chaval, jugamos ahora si quieres.""

Le di la mano, le conté que era de Honduras, y siguió con su noche. Sonrío, es fútbol. https://t.co/7DUZrhNkEf",20,2,2019,1898,22,1.16,285
100,"GRANDE PROFE RUEDA! 

Hombre maravilla, milagros en San Pedro.. https://t.co/QqRoD3b9L0",76,13,2019,1898,89,4.69,89
101,"Armados a la 1️⃣... 

Armados a las 2️⃣... 

¡Armados a las 3️⃣(1️⃣) !",50,12,2019,1898,62,3.27,74
102,"Que bién montada La Copa africana😮. Hay muchas cosas que CONMEBOL y CONCACAF podrían tomar en próximas ediciones, sobre todo en la presentación.",12,1,2019,1898,13,0.68,144
103,"Nos enojamos cuándo en Honduras un jugador ""se harta"" un gol, cuándo ni el propio Messi puede hacer milagros en una cancha con ""baches"". 

¡Priomordial lo de las canchas en nuestra liga! https://t.co/DHGeX7yCUR",28,6,2019,1898,34,1.79,212
104,"Me pongo de pie. 

Gracias Carlos Will por esas noches mágicas. Te inscribiste en la historia coronandote Tetracampeón por primera y única vez en el fútbol hondureño. Fuiste parte de un año centenario INIGUALABLE. En fin, la camisa de Olimpia te quedó perfecta👏🏼. https://t.co/Tm2fg8SFY2",410,96,2019,1898,506,26.66,289
105,Es de grandes. https://t.co/JhfvSvZTpi,135,19,2019,1898,154,8.11,38
106,El Peter contra la Unión Soviética. Italia 90. https://t.co/5Mm0FBQDqj,41,6,2019,1898,47,2.48,70
107,"El Pedro y El Diego. 

Bienvenido al Club Olimpia🇱🇺🦁. https://t.co/v128OiXqZu",202,44,2019,1898,246,12.96,79
108,"107 años de historia como el equipo que representa a Honduras y a su gente. 

¡Felicidades viejo león! https://t.co/HYZHFVv2Bd",142,32,2019,1898,174,9.17,128
109,Habla con toda la verdad.,32,10,2019,1898,42,2.21,25
110,"Pena. Eso es lo único que siento. Estuvieron bajo el sol y lluvia, llenaron cada cancha.. Lo siento Olimpista, te merecés fútbol del primer mundo y lo único que Honduras te puede ofrecer es un circo que se juega en todos lados menos en la grama.",228,74,2019,1898,302,15.91,245
111,Que bonito que es volver a verte Olimpia🦁❤️ https://t.co/WjInqXyV1y,89,9,2019,1898,98,5.16,67
112,"Llegó el gran dia. Que se juegue en paz y que sea un espectáculo dentro y fuera de la cancha. A por ella.

¡Vamos mi león!🦁🇱🇺",114,19,2019,1898,133,7.01,127
113,"El mejor de este equipo? Para mi el niño entre Tosello y Milton con la medalla😀. 

Bromas😂, Lucigol tiene que ser⚽️. https://t.co/2muHLCisj8",24,1,2019,1898,25,1.32,142
114,"Felicidades a mi grán amigo Manuel! Un genial ingeniero, sin duda👏🏼 https://t.co/IbjMY6fYuH",10,0,2019,1898,10,0.53,91
115,2 de Junio. Acuérdense. https://t.co/V46J2E9wYx,11,0,2019,1898,11,0.58,47
116,Come on you Gunners 🔴. @Arsenal  #ARSCHE,8,2,2019,1898,10,0.53,40
117,"Buen ambiente ayer. El público se va a su casa con dignidad👏🏼. El arbitraje tuvo altos y bajos para ambos. Olimpia muy nervioso en primer tiempo, en el segundo encontramos nuestro juego. 

La vuelta será una verdadera cueva nunca antes montada en estas tierras, solo eso digo🇱🇺.",121,25,2019,1898,146,7.69,280
118,A GOLEAR COMO.....? EVER🦁,28,5,2019,1898,33,1.74,25
119,"A dejarlo todo. A correr y a marcar como... A por la copa. 

¡VAMOS OLIMPIA!🇱🇺🦁🏆",129,35,2019,1898,164,8.64,82
120,"Olimpia es el mas grande porque nunca abandonó. Es la verdad, y la verdad dura por la eternidad.

Grande @relymp https://t.co/uKxpJtCpNg",229,64,2019,1898,293,15.44,138
121,MAXIMO GOLEADOR BENGOOOOLAZOO⚽️,48,4,2019,1898,52,2.74,31
122,Ya vaas a veeer🎶🇱🇺,67,13,2019,1898,80,4.21,18
123,BENGOOLAZO.,55,7,2019,1898,62,3.27,11
124,PUM! Gol del mas querido🦁,25,4,2019,1898,29,1.53,25
125,"Y vamos a salir con todo, y vamos a salir todos, y lo vamos a buscar, y lo vamos a sacar, y nos vamos a meter en esa final. Y después vamos por ella. Vamos mi león❤️",89,19,2019,1898,108,5.69,165
126,"Si Messi se hubiera caído a reclamar no sería Messi. Y si el Chelsea hubiera hecho gol en la contra, Guardiola se enfadaría con sus jugadores por quedarse reclamando. 

Diferencias. https://t.co/5dZ5kovvFR",8,0,2019,1898,8,0.42,207
127,🎩👀. https://t.co/ffuNW8fBW9,19,1,2019,1898,20,1.05,27
128,Primer tiempo 0-1. VAMOS OLIMPIA QUE GANAMOS🇱🇺🦁 https://t.co/5kS4IPWiic,68,10,2019,1898,78,4.11,71
129,"Nos tocará con UPN, el más difícil del torneo. Que se jueguen dos partidazos, que las gradas sean una fiesta, y que logremos otra final. ¡Vamos OLIMPIA!",134,31,2019,1898,165,8.69,152
130,Es mejor el gol de visita o que pase el que quedó arriba en la tabla?,10,2,2019,1898,12,0.63,69
131,"En alta definición, lo que es ser Olimpia. El más grande, lejos🦁🇱🇺.

Tomado: @SVChecho10 que no falla con las buenas tomas. https://t.co/bR450mfwHD",352,100,2019,1898,452,23.81,149
132,"Mas claro que nunca. Si el 51% tiene que ir por ella, lo haremos. Somos el pueblo, el carnaval🏆. https://t.co/fAcTzJImBC",185,36,2019,1898,221,11.64,120
133,Gusta. Gana. Golea. La cima es nuestra🦁.,128,25,2019,1898,153,8.06,40
134,"Soñemos que nuestro país sea de los primeros, si no el primero en el MUNDO dónde el arbitro de una grán final es mujer. Soñemos que por un segundo Honduras sea ejemplo de progreso social.

Espero que mi país no me defraude y  se atreva a soñar con la mente abierta. https://t.co/ThFM9ziKkg",17,2,2019,1898,19,1.0,291
135,I #VoteElis for MLS Player of the Week!,4,0,2019,1898,4,0.21,39
136,Regresamos adonde pertenecemos. Líder absoluto.🦁 ¡Vamos Olimpia!,77,19,2019,1898,96,5.06,64
137,Mañana cueste lo que cueste. A por el podio 🇱🇺🦁.,72,8,2019,1898,80,4.21,48
138,"Un auténtico crack! Tuvo la oportunidad de probarse en @CDOlimpia y @FenafuthOrg. Ahora le toca en @steelers. ¡Éxitos bro👏🏼!

@diegoalorenzana https://t.co/Q8AN7V6Uzs",25,1,2019,1898,26,1.37,168
139,"Xi Jinping Scheme rima mejor que Ponzi Scheme. En las próximas decadas sabremos si se adopta. En 2013 fuí a China y me aseguraron que en 2016 serían la potencia global, que mandarín era el idioma del futuro. Es 2019 y si la frágil narrativa cae, se quiebra, y corta. https://t.co/8xlsE7OB0u",10,0,2019,1898,10,0.53,290
140,"🇪🇸 naaaaah😴😴
🇩🇪 Hertha Berlin
🏴󠁧󠁢󠁥󠁮󠁧󠁿 Arsenal
🇮🇹 Roma
🇫🇷 Lyon
🇳🇱 Ajax
🇵🇹 Benfica
🇧🇷 Flamengo
🇦🇷 River 
🇺🇸 DC United
🇲🇽 América
🇭🇳 CD OLIMPIA",19,0,2019,1898,19,1.0,151
141,"Fecha FIFA, el mal necesario del fútbol de clubes.",10,3,2019,1898,13,0.68,50
142,Si se enojaron cuando le dijimos Alaba. No creo que les guste que ahora es Neuer🤷🏻‍♂️,21,4,2019,1898,25,1.32,85
143,Primer lugar tabla general; candidato CCL. A (1pt) del liderato. Máximo goleador. Que bonito que es volver a verte Olimpia. Y vamos por mas🇱🇺🦁 https://t.co/hs3dmGS3qz,110,8,2019,1898,118,6.22,166
144,https://t.co/1qQpUKaHI3,28,14,2019,1898,42,2.21,23
145,"Bengzy 🎩 (⚽️,⚽️,⚽️.)",21,11,2019,1898,32,1.69,20
146,. https://t.co/ciwlnL3VeV,64,17,2019,1898,81,4.27,25
147,Aplauso de pie a todo el nuevo trabajo de mercadeo que se está haciendo👏🏼. ¡Saquen sus banderas!🇱🇺🇱🇺🇱🇺 https://t.co/d8Rb8Hz48o,47,12,2019,1898,59,3.11,126
148,El león es experto en dominar cualquier circumstancia que se le presente.. ¡El Jueves cueste lo que cueste! 🦁🇱🇺,24,6,2019,1898,30,1.58,111
149,"Si quisieramos salir adelante implementaramos AI en Bancos, Gobierno, Agricultura, y hasta fútbol. Como siempre, la excusa es: o muy caro, o a la gente no le gusta porque pierden sus empleos.. https://t.co/bvXrZD3Kb8",15,2,2019,1898,17,0.9,216
150,¡Vamos mi león! 🇱🇺,61,10,2019,1898,71,3.74,18
151,"Telegrama entre presidentes del Real España y Olimpia. Se refiere a la canción del España en aquel '77 -
""España campeón, la biblia lo dice.""

El fútbol no era de insultos, si no de bromas. Era un juego. https://t.co/5F2xcqqQUV",144,34,2019,1898,178,9.38,230
152,Otra semana que juega el león.. Otra semana que La Ultra Fiel entrega espectáculo en la cancha y en la escuela también. Lo aplaudo de pie👏🏼 https://t.co/Q4lBPd9031,57,12,2019,1898,69,3.64,163
153,"Que fiesta en Danlí! He podido estar en estadios enormes, y probablemente muy caros... Pero parecen bibliotecas. A veces los detalles cuentan👏🏼.",50,8,2019,1898,58,3.06,144
154,PUM💥! EG3 (Alaba),10,4,2019,1898,14,0.74,17
155,Eso significa que Olimpia 1-0 Santos?! 😅 https://t.co/C3EA0l7WYu,19,2,2019,1898,21,1.11,64
156,Que esto sea costumbre en todos los equipos de Honduras👏🏼 https://t.co/L81FQ2KIQB,64,2,2019,1898,66,3.48,81
157,El fútbol es de goles 💃🏻🕺🏻,44,5,2019,1898,49,2.58,26
158,"Dia 3: Será que cambiamos de tema?

Alineación contra Juticalpa:",18,3,2019,1898,21,1.11,66
159,"Sin Donis perdemos la identidad y peso histórico, sin Edrick perdemos juventúd y futuro. Keosseian toma una decisión acertada y justa anunciando que se rotarán el puesto de aquí en adelante. 

¡Vamos Olimpia que juntos somos enormes🇱🇺!",119,22,2019,1898,141,7.43,237
160,Donis Escober. Hoy recordamos el peso de ese nombre.,167,25,2019,1898,192,10.12,52
161,Noo Güity no la maltrate así😂,32,5,2019,1898,37,1.95,29
162,"Lacayo nos pone a 1 punto del liderato; lo peleamos en 7 días. Aún queda mucho por mejorar pero me gusta el dinamismo. Edwin respondió bien al titularismo, Chavasco cada semana impresiona mas. ¡Vamos Olimpia!🇱🇺🦁",62,9,2019,1898,71,3.74,211
163,"Extranjeros 2-0 AntiOlimpistas

#Bonfigli ⚽️",44,10,2019,1898,54,2.85,46
164,Cuátro grandes Olimpistas de paseo por el parque. https://t.co/Xt3UEhxaQz,207,36,2019,1898,243,12.8,73
165,"Y en 90 minutos Chavasco demuestra que tiene ambición y que está de acorde con el compromiso de jugar en un equipo grande. Esperemos que Bonfigli y Bonjour también cumplan. 

Extranjeros 1-0 Antiolimpismo",85,13,2019,1898,98,5.16,206
166,Que el jugador del Olimpia sepa cada véz que salte a la cancha que es un deber cumplirle a los millones de aficionados en todo el mundo; aficionados que viajan de todas partes a pedir que sientan la camiseta. 💪🏼🇱🇺🦁 https://t.co/H6DId66fyK,67,15,2019,1898,82,4.32,238
167,"Puede usted creer que se atreven a comparar😂. Compare y compruebe.

#ElMásGrandeDeCa  🌎 https://t.co/18XaPQXLBJ",80,17,2019,1898,97,5.11,113
168,"En caso de emergencia, llamar al 9-11. https://t.co/nySL2Qc84Z",280,60,2019,1898,340,17.91,62
169,Alejandro! Buen gol de un muy buen jugador y aún mejor muchacho👍🏼 Merecido. Vamos Olimpia!,25,6,2019,1898,31,1.63,90
170,"Tienda de Real Estelí en Nicaragua. País que es igual o mas pobre que Honduras, la diferencia: en Nicaragua se protegen los derechos de autor é intelectuales. Se imagina la cantidad de empleos que se generan? https://t.co/ljqQK6S0Io",42,5,2019,1898,47,2.48,232
171,"Albo, mi buen amigo.. ¡ESTA CAMPAÑA VOLVEREMO-A ESTAR CONTIGO! 🇱🇺",60,14,2019,1898,74,3.9,65
172,Bengolché⚽️. Lo escuchó aquí primero.,15,4,2019,1898,19,1.0,37
173,"H. Ford: 'If I had asked what the people wanted, they would have asked for faster horses. '",17,2,2019,1898,19,1.0,91
174,"Muchos son una moda. Pero no se equivoquen.. Este, este amor es para siempre. https://t.co/n2ydqW0H3G",78,12,2019,1898,90,4.74,101
175,Que en el 2019 se abra un nuevo cápitulo en la historia de este club. Que continúe la páz en los estadios. Que despidamos el Estadio Nacional en una buena nota. Y que el resto de las cosas que están en planos se hagan realidad😲. Por este y por todos los que se vienen. https://t.co/C94KfTkj6c,60,13,2019,1898,73,3.85,292
176,"GRACIAS🙏🏼. Gracias por atreverse, gracias por lograrlo. Hasta siempre Edwin Pavón. https://t.co/hFGxhnE2lo",198,40,2018,1898,238,12.54,106
177,Impecable producción de Rey de Copas por parte de @NacionOlimpista 👌🏼. @TSiHonduras,11,2,2018,1898,13,0.68,83
178,"Duele ver a nuestros jugadores favoritos irse, pero cuando las cosas no salen bien, toca reinventarse. Paciencia, veamos que planes tiene el profe.. https://t.co/K4N9Qxqkmf",54,11,2018,1898,65,3.42,172
179,"Por otro lado, cuándo un promotor Pepsi/MOT grita, 'El que no salte es perro', en un estadio con 30.000 hermanos Oli/Mot ... Eso es incitar violencia directamente dónde no la hay. Creo que una persona con un micrófono tiene que ser un poco mas inteligente y responsable..",219,59,2018,1898,278,14.65,271
180,"Por otro lado, creo que nos equivocamos en que últimamente empezamos a jugar hasta que estamos contra las cuerdas. En mi opinión hay que trabajar más a nuestros jugadores mentalmente.",78,14,2018,1898,92,4.85,183
181,Creo que nos morimos con lo nuestro. El equipo cumplió y dejó todo y perdimos jugando limpio y JUGANDO. Orgulloso de este equipo.,109,21,2018,1898,130,6.85,129
182,"Lo siento Olimpismo, no se pudo hoy. Lo último que haremos será abandonar. Felicidades a mis amigos que son Motagua.",248,35,2018,1898,283,14.91,116
183,"7/7:

Una cita con la historia. A morir en esa cancha muchachos. 🇱🇺🏆🦁 https://t.co/3Bmg91ipYG",110,42,2018,1898,152,8.01,95
184,Dia 6/7: https://t.co/rKDaRTjxv9,138,25,2018,1898,163,8.59,32
185,"3/3: Al final del día, un hombre como Rafael Ferrari definitivamente dejó un plan para el futuro. Sera cuestión de tiempo para que empezemos a ver como se multiplican sus valores a través de los niños en todo el país.",60,6,2018,1898,66,3.48,217
186,"Gracias a toda Honduras, a los Olimpistas, y a la Ultra Fiel. Como le decía a mi abuelo, ""nuestras copas nos hacen grandes, pero nuestra gente nos hace enormes"".",312,68,2018,1898,380,20.02,161
187,"Dia 5/7:

Lo vamos a hacer, y de nuestra manera. https://t.co/g7kj3DQxpn",40,7,2018,1898,47,2.48,74
188,"Que cada día tu corazón se haga un poco mas grande, y siempre llevar en él tu identidad, de dónde vienes. Esa es la respuesta. Gracias por ser mi abuelo.❤️ https://t.co/Pzctzk2qG3",695,98,2018,1898,793,41.78,179
189,"Día 3/7:

""Solo cae un gol y empieza el tembleque."" -CW Mejía https://t.co/2PnxgCygnq",65,19,2018,1898,84,4.43,87
190,"Dia 2/7:

Hablemos de memoria. https://t.co/l6NpN6ja1E",87,42,2018,1898,129,6.8,56
191,Y comienza la (verdadera) gran final del fútbol hondureño🇱🇺 https://t.co/ouPooeHzqF,9,3,2018,1898,12,0.63,83
192,Día 1/7. https://t.co/mqS6Fvzn4j,20,5,2018,1898,25,1.32,32
193,"Se han traído los mejores técnicos, se han aportado todas las comodidades. Su gente les ha llenado todos los estadios de Honduras.. Y solo se les piden ¡🥚🥚! Y amor a la camiseta por la cuál millones quisieran el privilegio de portar. 

Aprovechen esta última oportunidad. https://t.co/vv0I4EaF7C",134,59,2018,1898,193,10.17,297
194,"Aparte de la expulsión jugamos a NADA, y perdemos el partido por falta de méritos. Tenemos una semana para dar un de 180 grados.. Olimpia es Olimpia, y nunca se le puede dar por muerto.",133,42,2018,1898,175,9.22,185
195,"30 minutos y ya se dieron por vencido, ahora lo van a tratar de ganar fuera del contexto futbolístico. Una pena Diego, que mediocridad... Vergüenza nacional!",31,19,2018,1898,50,2.63,157
196,El derbi del Norte de Londres. https://t.co/01w7l7k54g,6,0,2018,1898,6,0.32,54
197,"""Porque cuando el amor no tiene cura, no queda mas que seguir amando. Aunque en ello se nos vaya la vida."" JUGAMOS LA FINAL🏆 https://t.co/U3OhHVCA53",121,34,2018,1898,155,8.17,148
198,"Al otro lado del mundo, aqui estamos, y aqui estaremos. Siempre. Que para ser campeón, hoy tenés que ganar🇱🇺🦁 https://t.co/7Bx0q96xEp",47,3,2018,1898,50,2.63,133
199,"Boniek la manda😲, Will la baja😯, deja a uno en el piso🤭.. Y la define de videojuego🤯. https://t.co/Sbm9NObNjP",115,43,2018,1898,158,8.32,109
200,"No importa cuántos goles metás, cuánto dinero te ganés jugando afuera, o cuántos followers tengas. Si no vivis para servir, no servís para vivir. Y Alberth Elis (como muchos otros que salen) demuestra hoy que sirve para vivir.",47,6,2018,1898,53,2.79,226
201,"Web-Scraping para encontrar los 1,944 clubes fundados hace 100 años o mas. Olimpia el no. 1,584 cuándo fue fundado en 1912. 

(source: Wikipedia) https://t.co/wtnvXEUEqo",7,0,2018,1898,7,0.37,171
202,"Dios puso el cielo, Olimpia puso las estrellas🇱🇺🦁. Buenas noches, el sabado cueste lo que cueste. https://t.co/oqMcVHxQ3t",87,29,2018,1898,116,6.11,121
203,Regresó el Kevin que vimos al inicio de temporada.. A.Reyes debió entrar antes. Carlos W. lo hizo bien de titúlar. La Ultra ya nos tiene malacostumbrados al espectáculo. Y lo mas importante... NUNCA. bajamos. los. brazos. Me atrevo a decir que Jerry la va a traer. 🦁🇱🇺🥚,75,18,2018,1898,93,4.9,269
204,"Un excelente artículo por mi amigo Carlos sobre el contraste en funcionamiento de nuestra sociedad y la familia núclear👏🏼

https://t.co/5D9TTbVLUf",6,1,2018,1898,7,0.37,148
205,Tres penales..?,0,0,2018,1898,0,0.0,15
206,"Que salgan a ganar, que quieran salir campeón. Que lo lleven adentro, como lo llevo yo..🦁🏆🇱🇺 https://t.co/SqAHoeibkJ",55,21,2018,1898,76,4.0,116
207,"""'Serán mis bis-nietos quienes se enteren de lo que HRN ha hecho hoy.'
Entre el instante en que Rafael los imaginó en el futuro y el momento en que ellos, mis… https://t.co/PX9VYUFNLN",4,0,2018,1898,4,0.21,184
208,Aplauso a quién aplauso merece👏🏼! https://t.co/o19aLiheEL,3,0,2018,1898,3,0.16,57
209,"Jugadores, jugadores.. Yo les pido por favor, QUE SUDEN LA CAMISETA.🇱🇺",21,12,2018,1898,33,1.74,70
210,Es el colmo.,8,5,2018,1898,13,0.68,12
211,"Los comentaristas no saben nada. Todos sabemos que el articulo XXVI estipula que si el jugador es de Olimpia, le tienen que romper un tobillo para que sea penal..🙊",20,6,2018,1898,26,1.37,163
212,"Sí, a las 4 de la mañana alguién en la sede del Marathón se tomó el tiempo de postear esto sin siquiera jugar un minuto de fútbol. Soy del verde, soy feliz (porque no espero nada mejor de mi equipo). https://t.co/Ibby4m9gSj",3,1,2018,1898,4,0.21,223
213,"Se equivocan, lo de ayer no es motivo de celebración como lo ven algunos.. Algún día nosotros estuvimos en esa exacta posición, la de atrevernos a poner 🇭🇳 en alto, y quedarnos cortos. Ayer pudo ser la peor noche en la historia del vecino, pero ya festejarla es tocar fondo. https://t.co/rroefv94lO",17,3,2018,1898,20,1.05,298
214,"No es lo mismo verla venir, que bailar con ella.",94,38,2018,1898,132,6.95,48
215,"Sín quirarle su mérito a UPN, hicieron un partidazo👏🏼",2,1,2018,1898,3,0.16,53
216,"Perdemos el invicto, algo que hubiese sido increíble, si no histórico. Pero la prioridad del Olimpismo era jugar bonito, lo que pasa es que de eso no queda record.",26,3,2018,1898,29,1.53,163
217,"Ese día nos convenció en 15 minutos que era el indicado. El surrealismo de ver al fantasma de David esa tarde en el nacional nos dejó apantallados. Felicidades @alberthelis17 por el record, aquí por muchos mas. @HoustonDynamo https://t.co/Kw8WkCfDw5",6,2,2018,1898,8,0.42,249
218,Los dioses del fútbol intervienen. Penal para River.,7,2,2018,1898,9,0.47,52
219,En la costa nos quieren por qué somos el mejor. Y si es en toda Honduras no hay equipo superior🇱🇺 https://t.co/keTxva5OQB,32,11,2018,1898,43,2.27,121
220,"15 jugados, 0 perdidos. Cada vez nos acercamos a la historia que escribió aquél Olimpia campeonisimo. Gracias Umbro❤️. https://t.co/yBSPmzX6zo",60,23,2018,1898,83,4.37,142
221,PONGAN 🥚🥚🥚 QUE GANAMOSSS!,11,4,2018,1898,15,0.79,25
222,JERRRYYY RICARDO DIOS MIO QUE GOLAZO,14,3,2018,1898,17,0.9,36
223,"Quisiera simpatizar con la causa arbitral, pero hacen el payaso de esta manera, semana tras semana..",18,9,2018,1898,27,1.42,100
224,??? ridículo.,12,1,2018,1898,13,0.68,13
225,"Y hoy hace un año, nació la sexta estrellita. Contra todo, en una noche histórica, Olimpia de Honduras otravés rey de Centroamerica. ⭐️🦁🏆 https://t.co/hXkaUoepCn",100,35,2018,1898,135,7.11,161
226,"All eyez on me.

3️⃣1️⃣👀 https://t.co/H8HzWVY9F8",19,7,2018,1898,26,1.37,50
227,"Gracias por la entrega Nahún. 

Bienvenido Manolo, el sabado cueste lo que cueste🇱🇺 https://t.co/R8ZBfjraQu",88,26,2018,1898,114,6.01,109
228,"ONE ARSÈNE WENGER, THERE'S ONLY ONE ARSÈNE WENGER. https://t.co/4XMMkI2aOI",2,0,2018,1898,2,0.11,74
229,"Buenas noches Honduras. Hoy queda claro que sin nuestra gente no podemos llegar lejos. Pero estamos aquí, seguimos unidos, seguimos soñando. 30 + 1 . https://t.co/HajxwcB2Ps",11,3,2018,1898,14,0.74,173
230,"Lo que algunos usan para sacarle 5 minutos al arbitro, nosotros lo usamos para sacar pulmón. Vos sabes va. #OlimpiaID #CuidandoEl0Jornada15 https://t.co/MY3wgwf7sP",25,17,2018,1898,42,2.21,163
231,SALE LEÓN🇱🇺🦁,8,1,2018,1898,9,0.47,12
232,Resultados de la premier desde 1993. El equipo en casa gana el ~49% del tiempo. https://t.co/Mne88ocW7q,6,0,2018,1898,6,0.32,103
233,"Creo que no existe una buena base de datos de equipos hondureños. La primera meta es verificar calendarios y ver que equipos tienen mas ventajas (km viajados, pj / pg, pe, pp). https://t.co/GqCijy3rU6",6,0,2018,1898,6,0.32,200
234,"Ey pero hablando enserio, al final no lo hizo tan mal Dr. Hendry T.",10,0,2018,1898,10,0.53,67
235,"Hoy conmemoramos a Adriel, que en paz descanse. Toda la vida voy a estar🙏🏼.",9,1,2018,1898,10,0.53,75
236,"De la cueva de un león, a la portada del mundo. https://t.co/S12AExp4fW",11,1,2018,1898,12,0.63,71
237,ROJA para Serre !,0,0,2018,1898,0,0.0,17
238,Qué partido veo?,0,0,2018,1898,0,0.0,16
239,"El rey de Honduras, el @CDOlimpia https://t.co/kFB49cYXhD",16,1,2018,1898,17,0.9,57
240,"Y los países que se vendieron a China hoy tiemblan porque el ¥ pierde valor. Es casi como nos mintieron a todos diciendonos que para el 2016 serían la potencia mundiál. Pero nos vamos a morir todos y Tío Sam seguirá siendo el primer, segundo, y tercer mas poderoso del mundo.",13,1,2018,1898,14,0.74,275
241,Por muchos años he escuchado como han ridiculizado al profe Nahún.. cuándo es quizás la persona que mejor conocimiento tiene del fútbol en Honduras. Es debatible su manera de jugar? Sí. Sus resultados no lo son. https://t.co/tguRwf6GUU,9,4,2018,1898,13,0.68,235
242,"Papelón y medio del Alajuelense hoy, orgullo ver al Roro y cia. romperla💪🏼",6,0,2018,1898,6,0.32,74
243,"Mientras ellos invaden canchas, nosotros invadimos islas. Tus copas y tu historia te hacen grande, pero no te equivoqués. Tu gente te hace enorme🦁. https://t.co/ylbs6RB6vt",29,10,2018,1898,39,2.05,171
244,plus they already mad that the Cubs lost🤦🏻‍♂️..,0,0,2018,1898,0,0.0,47
245,"AMZN $1,000,000,000,000.00 

#Amazon",0,0,2018,1898,0,0.0,38
246,En mi otra casa también hay fiesta. #VamosDC #TheDistrict https://t.co/8V3RBFMuoi,3,0,2018,1898,3,0.16,81
247,"Que partido! Seguimos invictos. Respeto al España por salir a jugar. Seguimos invictos, lideres🦁. Si todavía no estás satisfecho con como jugamos, lo siento, estamos tratando de mejorar cada semana. Lo importante es que nos vamos a dormir con otros tres puntos. Vamos mi león❤️",62,15,2018,1898,77,4.06,277
248,"Ahora que podamos ver quién paga qué contenido en redes sociales, veremos las verdaderas intenciones de los que 'luchan por el pueblo' y los que luchan por el pueblo. 👏🏼 https://t.co/uSyj58Mpxd",2,0,2018,1898,2,0.11,193
249,"Como escribió Ferguson: 'No se equivoquen, al final del día un equipo de fútbol es sólo eso. No estamos para salvar el mundo.' 

Las opiniones políticas NUNCA le corresponden a una institución deportiva.

'En el Yankel me dí cuenta que este país no tiene solución.'",22,4,2018,1898,26,1.37,269
250,Alarmante que en el 2017 casi la mitad de Latinoamericanos creen que la democracia no funciona. Aquí el indice democrático por país. Hemos creado una burbúja... https://t.co/c8oaXFJuE2,3,3,2018,1898,6,0.32,184
251,"Seguimos sin jugar fútbol dominante pero los resultados se siguen dando🤷🏻‍♂️. En lo personal prefiero ganar jugando mal que perder jugando bien, pero eso es sujetivo. Lo que no es sujetivo es nuestro lugar en la tabla, Nahún sabe lo que hace. 🦁",30,5,2018,1898,35,1.84,244
252,"Les comparto otro articulo que escribí!

https://t.co/SUOs5g9Kyw",16,2,2018,1898,18,0.95,66
253,"Béndito fútbol. Tres puntos y lideres solitarios después de un partido muy cerrado. Todavía hay mucho por hacer pero hoy nos vamos a dormir con la llave de la ciudad. 🦁🇳🇱

#OlimpiaID https://t.co/WkwZ7p2T8m",54,14,2018,1898,68,3.58,208
254,"Decadas tras decadas, un nombre una historia. 

El domingo cueste lo que cueste. https://t.co/jc7mGRMeYn",12,1,2018,1898,13,0.68,106
255,El hombre mas rico del mundo - no por su cuenta de banco.. Sí por su aportación humana. https://t.co/opluG6bEJ7,7,1,2018,1898,8,0.42,111
256,"Otro gane sufrido, pero en mi opinión hay que seguir con optimismo. Lo mas importante es jugar bien cuando se puede y cuando no, ganar jugando mal. Falta mucha liga. Después del domingo miremos el panorama. 

#RugeLeón",9,1,2018,1898,10,0.53,220
257,Estas son las verdaderas noches mágicas. https://t.co/sc1LuDQ6Sh,34,4,2018,1898,38,2.0,64
258,"Algo que mi familia me ha inculcado es que el silencio es el arma mas poderosa. Si Vargas acusa al Olimpia que es mejor, ponerse a alegar con su ridiculés, o dejar que hable y destruya la moral de sus jugadores, quienes por cierto jugaron muy bien? El que no las debe no las teme.",26,9,2018,1898,35,1.84,280
259,Hoy es el día mundial del león. #WorldLionDay https://t.co/GV2hKkph5K,57,20,2018,1898,77,4.06,69
260,La clase del '92-'93. Invicta. https://t.co/QybEAbtFrO,35,14,2018,1898,49,2.58,54
261,"Los invito a leer Todos Somos Macacos, una columna que escribí para El Milenio! 

https://t.co/RRtPH21jdy",9,1,2018,1898,10,0.53,107
262,"Por cierto, que golazo @Lpz10alex, me recuerda a lo que hacía Lampard.",10,0,2018,1898,10,0.53,70
263,"Hace años no jugabamos así.. Kevin mejor jugador en mi opinión, Menjivar muy seguro, vi al Canales que jugaba en Ceiba, Deiby-Bengtson 🔥, Rony y Diego nos dieron profundidad y aire, Patón un motor, y Costly nuestro Giroud.. Y faltan Salas, Lacayo, etc.. 🦁🇳🇱",50,8,2018,1898,58,3.06,257
264,"Aquí el día que Platense se ganó mi respeto👏🏼. Ojo al que lideraba la fila del Olimpia esa tarde. El pasillo no se trata de ser español o no, se trata de respeto; cultura. Algo que separa a los grandes de los niños. 
@platensefc_hn https://t.co/O2qrdpbJfG",11,2,2018,1898,13,0.68,256
265,"Como buenos Olimpistas, apoyamos a los equipos hondureños cuándo juegan afuera. Vamos @MOTAGUAcom Y @rcdespana! 

#OlimpiaID #MentalidadQueNosDefine https://t.co/vdJqDOGWDR",16,1,2018,1898,17,0.9,174
266,.. Smith indtrodujo la idea de la mano invisible; los mercados libres se autocorrigen. Y después explicó que la economía es mucho mas compleja yá que las personas QUIEREN Y CREEN pensar racionalmente. En realidad la falta de información genera costos inecesarios en la sociedad.,1,0,2018,1898,1,0.05,278
267,"En La Teoría de Sentimientos Morales, Adam Smith habla sobre como es más barato pagar salarios altos que salarios bajos. La idea es que en la época, los esclavos hacián lo minimo para sobrevivir, mientras un salario ganado y el incentivo de crecimiento genera productividad.",5,4,2018,1898,9,0.47,274
268,"Al final del día, Twitter y Facebook habrán perdido ~$200 mil millones. En otras palabras, en un día van a perder el equivalente a la producción TOTAL de Honduras en 10 AÑOS. Siento que si Honduras se hunde mañana tardaría dos días que alguién se dé cuenta😭. https://t.co/z1t9Ed6UCo",3,0,2018,1898,3,0.16,282
269,"Los que han visto mucha liga🇭🇳, cuál ha sido el equipo más táctico que han visto?

@relymp @jcnfutbol @jcpineda08 @jcpineda17 @allanfajardo29 @IsabelTVC @yanuariopaz @sorlandoponce @RichieAbedrabbo @CesarGodoy_ @JimmyArturo etc..",7,2,2018,1898,9,0.47,231
270,En nuestro país le silbaban... Y en el país que nos lleva años-lúz en desarrollo es un heroe. Eso es todo. https://t.co/qZ5zVqZh7V,292,40,2018,1898,332,17.49,130
271,"""Yo no tengo nada que esconder""...
..Es lo que dicen todos cuando enrealidad regalan su información, su privacidad, sus opiniones, sus votos en una urna. https://t.co/7cK2gyjOYL",2,0,2018,1898,2,0.11,178
272,Contento de haber llegado esta tarde a un compromiso ideológico junto @VijilDaniel. La virtúd de esta Honduras es crear una juventúd que no permite la mediocridad.,3,0,2018,1898,3,0.16,163
273,Como vamos a salir adelante con una clase política que duerme a plenas 4 de la tarde? @JuanPabloSabil1,1,0,2018,1898,1,0.05,102
274,Sir Alex Ferguson..😂😭 https://t.co/GZF5qheqBH,0,0,2018,1898,0,0.0,45
275,"La falta de contundencia mordió hoy a los Ingleses. Croacia lo merece, guerreros hasta el final. El fútbol tendrá que esperar (4 años mas😮) para volver a casa..",6,0,2018,1898,6,0.32,160
276,"5 Ingleses defendiendo en todo momento, la clave. Pero como ninguno juega en el Madrid..🤷🏻‍♂️",1,0,2018,1898,1,0.05,93
277,"#LaJornada hablando de la situación de imigración. Casi todos los países (competentes) cuentan con naturalizados, países enormes. Mientras tanto nuestro grano de país pidiendo gustos cuando quisieron convocar a Fabio. Tenemos que cambiar nuestra forma de pensar.",1,0,2018,1898,1,0.05,262
278,Solo quiero que recuerden que en su tiempo atrevieron a silvarle en el Bernabeu😂. Hoy les hizo 'Le Neymar' y les enseñó que ustedes lo necesitan mas a el que el a ustedes. Por otro lado la Juve acostumbrada a enamorar a sus jugadores hasta en el decenso.. #Casillas #Raul,4,0,2018,1898,4,0.21,271
279,Está buscando nuevo equipo? Pués NO siga al AC Milán porqué su administración (basada en China) está a punto de incumplir su pago de €65m correspondiente a Junio. Esto diluirá las acciones de regreso al grupo Eliott y a Silvio Berlusconi. Se viene otra decada infame.,5,2,2018,1898,7,0.37,267
280,QUE PRIVILEGIO DE MUNDIAL.,2,0,2018,1898,2,0.11,26
281,"No entiendo porqué les cuesta reconocer el crecimiento inglés. Como les adelanté hace unos días, estaban destinados a dominar hoy, y lo hicieron. Bienvenidos a la época de 5 atrás, doble pivot, y el delantero soporte que baja a recuperar balones. Y 💀 a su querido 'tiki-taka'.",5,0,2018,1898,5,0.26,276
282,"Deja Vú Brasil 2006, eran tán buenos en papél que estaban destinados a decepcionar.. Ah y Neymar es un fraude por cierto.",2,0,2018,1898,2,0.11,121
283,"Recordando con @JRAFAELFERRARI que el Everton despidió a Roberto Martinez en el 2016, UNA SEMANA antes que el técnico español firmara la clausúla para transferir a Albert Elis del Olimpia al Everton. Lo que pudo ser...",34,12,2018,1898,46,2.42,218
284,KDB dá-KDB quita. #Bel #Bra,0,0,2018,1898,0,0.0,27
285,"Acordemonos que Qatar tendrá más partidos, para mi Müller sigue en la contienda. Por otro lado, jugadores como Mbappe pueden barrer por completo con el record de Klose en los siguentes años.",3,0,2018,1898,3,0.16,190
286,Vean a Inglaterra &lt;&lt;dominar&gt;&gt; a Suecia el Sábado. Su sistema de 5 jugadores dispuesros a defender en cualquier momento ha sido perfeccionado por Southgate desde que entrenó al mismo grupo en inferiores. El fútbol vuelve a casa.,7,2,2018,1898,9,0.47,239
287,110 Minutos se tardaron en jugar contra un equipo que ha dejado el corazón desde el partido inaugural. Ese fué el error de España.,2,0,2018,1898,2,0.11,130
288,Torreira Welcome to Arsenal | 2018 | Skills and Tricks | Compilation | Dubstep Edition,1,0,2018,1898,1,0.05,86
289,"""Volveremo a ser campeones! COMO LA PRIMERA VEZ"" #URU",1,0,2018,1898,1,0.05,53
290,Mi plantilla Olimpista! @NacionOlimpista https://t.co/beceKldlF9,14,2,2018,1898,16,0.84,64
291,Di María el experto en octavos de finales.,2,0,2018,1898,2,0.11,42
292,"Interesante ver como gira la narrativa de nuestro país en este entretiempo del mundial. Realmente somos un país complejo, en el buen sentido de la palabra.",4,0,2018,1898,4,0.21,155
293,Míl millones de bólivares cuesta una taza de café en Venezuela hasta la fecha. Ahí está su Socialismo del siglo 21.,2,0,2018,1898,2,0.11,115
294,Blessing in disguise for England.,0,0,2018,1898,0,0.0,33
295,"Three Lions on the shirt. 

#Eng",0,0,2018,1898,0,0.0,34
296,"QUE DRAMA DIOS MIO

#ImaginandoCosasChingonas",3,0,2018,1898,3,0.16,47
297,Aplauso para Marruecos e Irán👏🏼,9,2,2018,1898,11,0.58,31
298,Es un deporte de 90 minutos y al final SIEMPRE ganan los Alemanes.,3,1,2018,1898,4,0.21,66
299,Papelón del Chucky,1,0,2018,1898,1,0.05,18
300,Madre e hija reunidas. https://t.co/2qNcSpQi6q,1,1,2018,1898,2,0.11,46
301,Messi brilla (por su ausencia),1,0,2018,1898,1,0.05,30
302,"Viendo la noche del gol con. @sebaspastor1 y @JRAFAELFERRARI. 

@GONZALOCARIAS @jcnfutbol1 @jcpineda17 #ManoloKeosseian @yanuariopaz @DeportesTVC 

#LaNocheDelGol",7,2,2018,1898,9,0.47,166
303,El mundial de las sorpresas.,1,2,2018,1898,3,0.16,28
304,Aquí el primer gol de #Russia2018 en el estudio de @DeportesTVC. @sorlandoponce https://t.co/uUdFQVvnhJ,24,7,2018,1898,31,1.63,103
305,"Boca, Palmeiras, Al Hilal, CD Olimpia, LA Galaxy, Galatasaray, Depor, Real Madrid. Quizás era muy perfecto para ser real... 

@BocaJrsOficial @Palmeiras @Alhilal_EN @CDOlimpia @LAGalaxy @Galatasaray @eldepor @realmadrid https://t.co/NtYsV6LRui",12,8,2018,1898,20,1.05,245
306,"¡Honduras está de fiesta, el Olimpia es la historia! https://t.co/dwvscFU4gY",78,29,2018,1898,107,5.64,76
307,"Buenos animos en @DeportesTVC hoy, entusiasmo por el re-debút de #LaJornada. @Remero20",2,0,2018,1898,2,0.11,86
308,"cuándo va a madurar Pogba? Los trucos ganan likes en instagram, no mundiales.",1,0,2018,1898,1,0.05,77
309,en la costa nos quieren porque somos el mejor🇳🇱 https://t.co/Z5SvLldOce,29,8,2018,1898,37,1.95,71
310,"Sir Alex Ferguson sobre agentes: ""La mayoría no hacen nada más que dividir relaciones. Convierten a los jugadores en mercancía- ellos ganan, los equipos y jugadores sufren las consequencias... Muy pocos jugadores necesitan un agente."" https://t.co/2O6IGW5F6S",3,1,2018,1898,4,0.21,258
311,"Una vida sana: 

1. Si toma, no maneje.
2. Duerma 8 horas al día.
3. NUNCA FIRME DOS CONTRATOS AL MISMO TIEMPO. 🤦🏻‍♂️",10,4,2018,1898,14,0.74,121
312,🤷🏻‍♂️ https://t.co/JJmIhLRj7M,1,0,2018,1898,1,0.05,29
313,asi no se me olvidan nunca mis metas🌎🦁 https://t.co/HH5m7vUzjT,30,2,2018,1898,32,1.69,62
314,"Un día despues todavía arde, pero toca levantar cabeza. Somos Olimpia carajo. #OlimpiaMorire https://t.co/rNpOkozXtw",8,3,2018,1898,11,0.58,116
315,".. Y para mi Nahún es el campeón este torneo, casi hace lo imposible con un Olimpia oscuro.",11,4,2018,1898,15,0.79,91
316,#MerciArsène https://t.co/67qC2jDX7Y,1,0,2018,1898,1,0.05,36
317,"Es el gol de Moya uno de los mas rapidos de la historia? 

@DeportesTVC @IsabelTVC @sorlandoponce @carlosfutbol03 @",0,0,2018,1898,0,0.0,117
318,Vamos mi león❤️,0,0,2018,1898,0,0.0,15
319,pasa el barça por autogoles de visita 🤷🏻‍♂️,0,0,2018,1898,0,0.0,43
320,se imaginan la gritada de Guardiola al medio tiempo(🤬),0,0,2018,1898,0,0.0,54
321,"Después de tres torneos secos, dos cambios de entrenador, muchos empates, multas, estadios vacíos, etc... El Olimpia podría encontrar finalmente la brújula venciendo a un HdelP que se juega la vida. Santo, jueves Santo!",5,2,2018,1898,7,0.37,219
322,El fútbolista hondureño nunca va a llegar a su potencial gracias al exagerado agrando de algunos medios. El otro extremo es la falta de apoyo de una afición que se mal-acostumbró a ganar siempre (aunque ganando al pelotazo).,2,0,2018,1898,2,0.11,224
323,"Pocos le darán a Restrepo el mérito que merece. La idea de ganar jugando bien le terminó costando en juegos importantes, pero su trabajo en lo interno de la institución lo vamos a apreciar en unos años.",2,0,2018,1898,2,0.11,202
324,El león de tus amores te convoca.,0,0,2018,1898,0,0.0,33
325,103 años Olimpia Rey De Copas💗⚽🏆👑  #Inmortales #EsDeGrandes #olimpia https://t.co/OvKePDxrt7,0,0,2015,1898,0,0.0,92
326,Palo palo bonito palo es! Eeeeeee! SOMOS CAMPEONES OTRAVES💗⚽🏆. Grande @romellq31. #La29 #activado https://t.co/UyFruMuh4I,7,2,2015,1898,9,0.47,121
327,"Benedetto 4-0 Herediano, '30. #VamosAmerica http://t.co/UQokhMi2wk",0,0,2015,1898,0,0.0,66
328,Grande Elis! #sub20 #olimpia,0,0,2015,1898,0,0.0,28
329,Presiento un milagro en el 2015. #concachampions @mmvilleda @R_Villeda @rafapf11 @NacionOlimpista,1,1,2015,1898,2,0.11,97
330,unbelievable. #arsenal2015,0,0,2015,1898,0,0.0,26
331,Bienvenido Estupiñan al mejor equipo de Centro Ámerica. #concachampions @mmvilleda,0,1,2014,1898,1,0.05,82
332,Que lindo que te envidien todos! Gracias por regalarnos el primer puesto mediocres. #cantaynollores,0,0,2014,1898,0,0.0,99
333,"Resulta ser que le tienen envidia a Televisa, pues hablan mas de Aacarraga y el América que de su selección. @Faitelson_ESPN @joserra_espn",0,0,2014,1898,0,0.0,138
334,what the?,0,0,2014,1898,0,0.0,9
335,come on WIGAN!,0,0,2014,1898,0,0.0,14
336,then why the FUCK is Podolski not playing every match?,0,0,2014,1898,0,0.0,54
337,"and Oxlade, is a legendddd!",0,0,2014,1898,0,0.0,27
338,"what a start, what a goal",0,0,2014,1898,0,0.0,25
339,podolskii,0,0,2014,1898,0,0.0,9
340,"There is only one Arsène #Wenger. 
#PSG #snubbed",0,0,2013,1898,0,0.0,49
341,#DiCanio #Giaccherini take a bow son. WOW. shocker....,0,0,2013,1898,0,0.0,54
342,"Please Sir #Wenger, sign #Benteke",0,0,2013,1898,0,0.0,33
343,"noo!! wtf?? #quesequedeelchepo, porlomenos contra Honduras",0,2,2013,1898,2,0.11,58
344,ghanaaaa!,0,0,2013,1898,0,0.0,9
345,"un domingo sin poder ir a la cancha, un estadio sin poder gritar un gol. y la noche en el cafe, no tenemos de que hablar...",0,1,2013,1898,1,0.05,123
346,"Welcome Higuain, to the classiest football team on the planet! #afc",0,0,2013,1898,0,0.0,67
347,Fellaini+Rooney+Williams=#invinsibles. Please #Gazidis,0,0,2013,1898,0,0.0,54
348,FORZA AZURRI!,0,0,2013,1898,0,0.0,13
349,"#invincibles, Gazidis, please make it happen again. #higuain #rooney #fellaini",0,0,2013,1898,0,0.0,78
350,Vamo con huevo uruguasho. Hagamos a la nacion urugasha orgushosa de ser uruguasha,0,0,2013,1898,0,0.0,81
351,Gana mi patria la mera mera H! 3-1! Si señor! @UnivisionSports,0,0,2013,1898,0,0.0,62
352,Arsenal has same ammount of goals as the #invincibles had at this point......,0,0,2013,1898,0,0.0,77
353,"Sony, why u no show console?!?!?!? #ps4 #sony",0,0,2013,1898,0,0.0,45
354,As punishment #Pistorius should have his legs shot. Oh wait........ Too soon?,0,0,2013,1898,0,0.0,77
355,GAMECHANGING #playstation2013,0,0,2013,1898,0,0.0,29
356,Golazoooo perrosssssssssssssssssssssssss. Viva el Leon!,0,0,2012,1898,0,0.0,55
357,Gooooooooool,0,0,2012,1898,0,0.0,12
358,"Pongan huevos, hoy no podes perder. Te llevamos con el corazon, Olimpia Honduras mi campeooon",0,0,2012,1898,0,0.0,93
359,"Volveremo ser campeones, de la champions otraves. #olimpia",0,0,2012,1898,0,0.0,58
360,#rm hasta el final,0,1,2012,1898,1,0.05,18
361,#arsenal #afc by far the greatest❤,0,0,2012,1898,0,0.0,34
362,JuanRamonn!!,0,0,2012,1898,0,0.0,12
363,Tottenham Hotspuuuuuur!!!!!!! A llorar van persieee sos un duroo,0,0,2012,1898,0,0.0,64
364,Wtfffff,0,0,2012,1898,0,0.0,7
365,#dempsey goooooooooooooooooooooooooooooooooooooooooooooooooooooool!!!!!!,0,0,2012,1898,0,0.0,72
366,"Giroud al banco, walcott al campo.",0,0,2012,1898,0,0.0,34
367,"When life hits you, you get back up and hit it harder @mmvilleda #RVE",0,0,2012,1898,0,0.0,69
368,Hey @GIRLSGONEGAMER pick me for your 100K Giveaway because I want the #psnpoints,0,0,2012,1898,0,0.0,80
369,Hey @GIRLSGONEGAMER pick me for your 100K Giveaway because I want the #micosoftpoints,0,0,2012,1898,0,0.0,85
370,Hey @GIRLSGONEGAMER pick me for your 100K Giveaway because I want the #roxiogamecapture,0,0,2012,1898,0,0.0,87
371,Hey @GIRLSGONEGAMER pick me for your 100K Giveaway because I want the #wii,0,0,2012,1898,0,0.0,74
372,Hey @GIRLSGONEGAMER pick me for your 100K Giveaway because I want the #xbox,0,0,2012,1898,0,0.0,75
373,Gran dia deja gran cansancio. Muy bien la seleccion y muy bien el Olimpia,0,0,2012,1898,0,0.0,73
374,"Bueno... Mucho respeto, no pense que llegariamos tan lejos #honduras",0,1,2012,1898,1,0.05,68
375,Rogeeeeerrrrrrrrr te amooo,0,0,2012,1898,0,0.0,26
376,Entre el gol y la expulsion de crisanto ya estoy afonico... Ojala me queden ganas para el Olimpia @mmvilleda,0,0,2012,1898,0,0.0,108
377,Bien mendozaa,0,0,2012,1898,0,0.0,13
378,"Honduras es una mierda dijeron, brasil los va a pijiar dijeron....",0,0,2012,1898,0,0.0,66
379,Vamoss,0,0,2012,1898,0,0.0,6
380,Vamosss,0,0,2012,1898,0,0.0,7
381,Gooooool,0,0,2012,1898,0,0.0,8
382,#pistorious,0,0,2012,1898,0,0.0,11
383,"Vamos Honduras a sudar la camiseta, hoy hacemos historia",0,2,2012,1898,2,0.11,56
384,#senegal vamos senegaaaaal,0,0,2012,1898,0,0.0,26
385,"Señores yo soy OLIMPIA! Y llevo la camiseta, la ultra canta con wevo. Y quiere dar otra vuelta @mmvilleda @mariormaldonado",0,0,2012,1898,0,0.0,122
386,"Para salir campeones, saltemos los tabloones oooneeees. Cantemos con mas fuerza seremos los mejoores ooress",0,0,2012,1898,0,0.0,107
387,Ro-Ro mance con la copa,0,0,2012,1898,0,0.0,23
388,Jc garciaaaaaaa!!!!,0,0,2012,1898,0,0.0,19
389,Rey Luciano esta de vuelta @mariormaldonado,0,1,2012,1898,1,0.05,43
390,OLIMPIA-Fas! A por los 3 puntos!,0,0,2012,1898,0,0.0,32
391,"“@mariajosealas: A veces es mejor perder a alguien, que perder el tiempo.” @valeriagodoy98",0,0,2012,1898,0,0.0,90
392,Somos 1! Viva Honduras perros,0,0,2012,1898,0,0.0,29
393,Cuando sacas la pelota en la raya sobre la hora te sentis el rey del mundo @MotivacionesF,0,0,2012,1898,0,0.0,89
394,@UnboxTherapydesire,0,0,2012,1898,0,0.0,19
395,@uboxtherapy @younow -,0,0,2012,1898,0,0.0,22
396,Cuando te saca tarjeta roja un referí localista,0,0,2012,1898,0,0.0,47
397,"Cuando estas a 11 pasos de uno que te quiere fucilar, y terminar con tus esperanzas❤❤❤❤ @MotivacionesF",0,0,2012,1898,0,0.0,102
398,Dar la vuelta olimpica de visitante❤❤,0,0,2012,1898,0,0.0,37
399,Como vas a saber lo que es el infierno si nunca metistes un gol encontra @MotivacionesF,0,0,2012,1898,0,0.0,87
400,Como vas a saber lo que es la musica? Si nunca cantastes desde la popular ❤❤@MotivacionesF,0,0,2012,1898,0,0.0,90
401,RUEDA! RUEDA! RUEDAAAA!!! #Ecuador,0,0,2012,1898,0,0.0,34
402,Vaaamoos!! Vaaamooos Leoooooneeees! Que esta nocheee! La vuelta vamoa daaaar!!!! @mariormaldonado,0,0,2012,1898,0,0.0,97
403,"People tell me slow my role, im screamkng out F*CK THAT!",0,0,2012,1898,0,0.0,56
404,Madrid o Bayern? Barca o Chealsea @GusMenFox,0,0,2012,1898,0,0.0,44
405,Benson!!!! He will make this team next nba champs,0,0,2012,1898,0,0.0,49
406,Only one Arsene Wenger #ArsenalLive,0,0,2012,1898,0,0.0,35
407,Mark Zuckerberg bought instagram for 1 Billion. Bitch i just downloaded it for free XD,0,0,2012,1898,0,0.0,86
408,Im on a pursuit of happiness and i know everything that shines aint always gonna be gold,0,0,2012,1898,0,0.0,88
409,Chocooooooooooo!!!! Tenia que ser Olimpistaaaa!!!!!!!,0,1,2012,1898,1,0.05,53
410,Arsenal :(((,0,0,2012,1898,0,0.0,12
411,Chocoo!!!!!!!! Tenia que ser del Olimpiaaa &lt;3,0,0,2012,1898,0,0.0,48
412,Eddy Hernandez!!!! H&lt;3,0,0,2012,1898,0,0.0,25
413,Mira mira mira! Sacale una foto! Los gringos a las duchas con el culo roto! #ElSalvador @GusMenFox,0,0,2012,1898,0,0.0,98
414,#ElSalvador i like how gringos think they're good at football (your soccer) arriba El Salvador arriba Honduras suerte!,0,0,2012,1898,0,0.0,118
415,"When the sun goes up, it calling, i want another day with you",0,0,2012,1898,0,0.0,61
416,"#PremierLeague the Premiere League, where anyone beats anyone",0,0,2012,1898,0,0.0,61
417,#wigan 2-1 simply epic! Go Figueroa,0,0,2012,1898,0,0.0,35
418,No champions esta semana /:... Con-de-na-do-teeeeeeeeeeeeeeeeeeee @GusMenFox,0,0,2012,1898,0,0.0,76
419,6-2 me parece que somos imparables,0,0,2012,1898,0,0.0,34
420,Juanramon!!!!!! @CDOlimpia,0,0,2012,1898,0,0.0,26
421,Animo Portillo!!!!!!,0,0,2012,1898,0,0.0,20
422,Gracias @GusMenFox !!!!!!!  Me mandastes saludossssss!!!!!!!!!!!!!!,0,0,2012,1898,0,0.0,67
423,Gunners!!!!!! #ArsenalLive,0,0,2012,1898,0,0.0,26
424,Wtff!!!!!!! #Payton for a year??!?!!!?!,0,1,2012,1898,1,0.05,39
425,:(,0,0,2012,1898,0,0.0,2
426,Tell Congress: Don’t censor the web! http://t.co/ABpEwbiw,0,0,2012,1898,0,0.0,57
427,Please tell my dad please!!! - ##jakeandamir live on http://t.co/3Hv6eRC1,0,0,2011,1898,0,0.0,73
428,first to buy it at Honduras! - ##jakeandamir live on http://t.co/3Hv6eRC1,0,0,2011,1898,0,0.0,73
429,bitches!!! I am awake and its late at london you suck - ##jakeandamir live on http://t.co/3Hv6eRC1,0,0,2011,1898,0,0.0,98
430,"10 viewers
 - ##jakeandamir live on http://t.co/3Hv6eRC1",0,0,2011,1898,0,0.0,57
431,"30 more viewers
 - ##jakeandamir live on http://t.co/3Hv6eRC1",0,0,2011,1898,0,0.0,62
432,#jakeandamir What is your bb pin? - ##jakeandamir live on http://t.co/3Hv6eRC1,0,0,2011,1898,0,0.0,78
433,"do 3,000 BITCH! - ##jakeandamir live on http://t.co/3Hv6eRC1",0,0,2011,1898,0,0.0,60
434,what is your fake puke made of? #JakeAndAmir - ##jakeandamir live on http://t.co/3Hv6eRC1,0,0,2011,1898,0,0.0,89
435,What is puke made of on your episodes? - ##jakeandamir live on http://t.co/3Hv6eRC1,0,0,2011,1898,0,0.0,83
436,How do you fake puke?  - ##jakeandamir live on http://t.co/3Hv6eRC1,0,0,2011,1898,0,0.0,67
437,"have you thought of a movie?
 - ##jakeandamir live on http://t.co/3Hv6eRC1",0,0,2011,1898,0,0.0,75
438,"Sam, havent i seen you before? #jakeandamir
 - ##jakeandamir live on http://t.co/3Hv6eRC1",0,0,2011,1898,0,0.0,90
439,"are you going to be on the tonight show??? #jakeandamir
 - ##jakeandamir live on http://t.co/3Hv6eRC1",0,0,2011,1898,0,0.0,102
440,A MOVIE!!!!!! - ##jakeandamir live on http://t.co/3Hv6eRC1,0,0,2011,1898,0,0.0,58
441,can you speak hebrew for the next 30 sec?? #JakeandAmir - ##jakeandamir live on http://t.co/3Hv6eRC1,0,0,2011,1898,0,0.0,100
442,#jakeandamir who else is with you at this moment? - ##jakeandamir live on http://t.co/3Hv6eRC1,0,0,2011,1898,0,0.0,94
443,"Love comes from the heart not from the head, that's why may appear like it makes no sense♥",0,0,2011,1898,0,0.0,90
444,Felizidades Olimpia ya son 99 años te tu gloria!!! Dalee leoon yo te tengooen mi corazooon &lt;3,0,0,2011,1898,0,0.0,96
445,Happy birthday to @valeriagodoy98 tkm cuidate,0,0,2011,1898,0,0.0,45
446,follow @FunWithFacts  best tweets ever!!!!,0,0,2011,1898,0,0.0,42
447,Bye Honduras ill miss you :'(,0,0,2011,1898,0,0.0,29
448,;),0,0,2011,1898,0,0.0,2
449,"Javier ""El Chicharito"" Hernandez",0,0,2011,1898,0,0.0,32
450,Wants to be in South Africa again,0,0,2011,1898,0,0.0,33
451,off to play fifa :),0,0,2011,1898,0,0.0,19
452,ummm i believe we were promised an apocalypse,0,0,2011,1898,0,0.0,45
453,DJ BL3ND,0,0,2011,1898,0,0.0,8
454,En las malas te JURO que nunca te voy a dejar!!,0,0,2011,1898,0,0.0,47
455,Psn!!!,0,0,2011,1898,0,0.0,6
456,"Que lo llevan adentrooo, como lo llevo yoooo! DALE LEON",0,0,2011,1898,0,0.0,55
457,"i love
",0,0,2011,1898,0,0.0,9
458,Canopyyy!!!,0,0,2011,1898,0,0.0,11
459,Olvide mi wax en tegus :(,0,0,2011,1898,0,0.0,25
460,O eme je,0,0,2011,1898,0,0.0,8
461,Dale leon,0,0,2011,1898,0,0.0,9
462,0oooooooo dale leoooon,0,0,2011,1898,0,0.0,22
463,"Cocoteros te quiero, antes que el motagua yo me muero",0,0,2011,1898,0,0.0,53
464,Porque?- Jose Mourinho,0,0,2011,1898,0,0.0,22
465,Vamos olimpia!!!!,0,0,2011,1898,0,0.0,17
466,ODIO A ARSENE WENGER,0,0,2011,1898,0,0.0,20
467,"barca no juega cmo hombre,  http://www.youtube.com/watch?v=V7D9J8lTFGs&feature=feedu",0,0,2011,1898,0,0.0,84
468,Happy bday!!!! DIIIIII!!!!,0,0,2011,1898,0,0.0,26
469,Vamos Monterrey!!!,0,0,2011,1898,0,0.0,18
470,done with mix!!!!!!  PArY RoCK THaT boDY,0,0,2011,1898,0,0.0,40
471,New mix Party Rock Anthem vs Rock That Body,0,0,2011,1898,0,0.0,43
472,Done with essay!!!!!!,0,0,2011,1898,0,0.0,21
473,HAVE TO WORK ON FIVE PARAGRAPH ESSAY FOR TOMOROW! TWITTER DON'T DISTRACT ME!!!!!!!,0,0,2011,1898,0,0.0,82
474,Madrid!!! Yo te quiero antes de los culés yo me muero!!!,0,0,2011,1898,0,0.0,56
475,done with remix BoomBoomPow vs Get Fu**** Loose,0,0,2011,1898,0,0.0,47
476,"pichetio culero, antes que jueges limpio yo me muero!!!!!!!!!!",0,0,2011,1898,0,0.0,62
477,Tomorrow; operation wake up at 6am :'(,0,0,2011,1898,0,0.0,38
